"Score","Weight_class","Age","Stance","Wins","Losses","Draws","Total_Fights","Win_Percentage"
10,"welterweight",30,"right-handed",11,6,0,17,0.647058824
10,"super lightweight",26,"right-handed",6,1,0,7,0.857142857
10,"super welterweight",31,"right-handed",5,7,1,13,0.423076923
10,"super welterweight",25,"right-handed",5,0,0,5,1
10,"welterweight",29,"right-handed",17,12,1,30,0.583333333
10,"lightweight",33,"right-handed",29,9,0,38,0.763157895
10,"super middleweight",27,"right-handed",5,1,0,6,0.833333333
10,"bantamweight",27,"right-handed",5,3,0,8,0.625
10,"super middleweight",37,"right-handed",25,8,1,34,0.75
10,"welterweight",28,"right-handed",8,2,1,11,0.772727273
10,"super lightweight",32,"right-handed",15,17,0,32,0.46875
10,"heavyweight",38,"right-handed",34,10,2,46,0.760869565
10,"featherweight",24,"right-handed",9,4,1,14,0.678571429
10,"super flyweight",31,"right-handed",5,2,2,9,0.666666667
10,"welterweight",34,"right-handed",5,2,0,7,0.714285714
10,"super bantamweight",NA,"right-handed",5,3,0,8,0.625
10,"super bantamweight",27,"right-handed",4,1,0,5,0.8
10,"flyweight",21,"right-handed",6,5,0,11,0.545454545
10,"super lightweight",22,"right-handed",4,1,0,5,0.8
10,"super lightweight",26,"right-handed",26,6,0,32,0.8125
10,"super welterweight",29,"right-handed",32,31,1,64,0.5078125
10,"super welterweight",35,"right-handed",5,2,0,7,0.714285714
10,"super lightweight",42,"right-handed",29,12,2,43,0.697674419
10,"bantamweight",25,"right-handed",5,4,4,13,0.538461538
10,"super lightweight",29,"right-handed",23,4,0,27,0.851851852
10,"super featherweight",36,"right-handed",26,12,5,43,0.662790698
10,"super lightweight",22,"right-handed",5,0,0,5,1
10,"heavyweight",28,"right-handed",2,0,0,2,1
10,"super lightweight",25,"right-handed",32,26,1,59,0.550847458
10,"lightweight",23,"right-handed",7,1,0,8,0.875
10,"heavyweight",31,"right-handed",14,9,3,26,0.596153846
10,"super middleweight",34,"right-handed",18,6,0,24,0.75
10,"super featherweight",26,"right-handed",5,2,0,7,0.714285714
10,"bantamweight",34,"right-handed",11,14,1,26,0.442307692
10,"super middleweight",33,"right-handed",24,9,1,34,0.720588235
10,"featherweight",22,"right-handed",3,0,0,3,1
10,"super featherweight",23,"right-handed",6,3,1,10,0.65
10,"lightweight",25,"right-handed",13,3,2,18,0.777777778
10,"super lightweight",25,"right-handed",10,6,0,16,0.625
10,"super welterweight",33,"right-handed",11,9,0,20,0.55
10,"super bantamweight",22,"right-handed",5,3,2,10,0.6
10,"super welterweight",32,"right-handed",20,5,3,28,0.767857143
10,"flyweight",23,"right-handed",5,3,0,8,0.625
10,"super lightweight",25,"right-handed",6,0,0,6,1
10,"super featherweight",24,"right-handed",9,8,0,17,0.529411765
10,"welterweight",34,"right-handed",21,10,1,32,0.671875
10,"super middleweight",27,"right-handed",4,1,1,6,0.75
10,"lightweight",24,"right-handed",5,6,1,12,0.458333333
10,"cruiserweight",38,"right-handed",12,3,1,16,0.78125
10,"middleweight",29,"right-handed",5,0,0,5,1
10,"heavyweight",38,"right-handed",5,0,2,7,0.857142857
10,"super welterweight",36,"right-handed",5,0,0,5,1
10,"light heavyweight",33,"right-handed",5,4,0,9,0.555555556
10,"super welterweight",27,"right-handed",7,1,0,8,0.875
10,"super flyweight",27,"right-handed",4,2,1,7,0.642857143
10,"light heavyweight",35,"right-handed",9,3,0,12,0.75
10,"super featherweight",37,"right-handed",8,3,0,11,0.727272727
10,"lightweight",24,"right-handed",4,2,2,8,0.625
10,"super featherweight",38,"right-handed",23,6,1,30,0.783333333
10,"welterweight",35,"right-handed",9,15,3,27,0.388888889
10,"super lightweight",29,"right-handed",8,5,0,13,0.615384615
10,"super middleweight",27,"right-handed",8,0,0,8,1
10,"middleweight",21,"right-handed",4,0,0,4,1
10,"lightweight",23,"right-handed",4,1,2,7,0.714285714
10,"light heavyweight",22,"right-handed",4,5,0,9,0.444444444
10,"lightweight",23,"right-handed",11,1,0,12,0.916666667
10,"super lightweight",27,"right-handed",4,1,0,5,0.8
10,"heavyweight",26,"right-handed",3,0,0,3,1
10,"featherweight",28,"right-handed",11,5,1,17,0.676470588
10,"welterweight",29,"right-handed",9,9,0,18,0.5
10,"featherweight",22,"right-handed",9,3,0,12,0.75
10,"bantamweight",21,"right-handed",11,8,1,20,0.575
10,"featherweight",38,"right-handed",33,15,0,48,0.6875
10,"super featherweight",30,"right-handed",5,0,0,5,1
10,"super bantamweight",24,"right-handed",9,6,2,17,0.588235294
10,"light heavyweight",34,"right-handed",20,16,1,37,0.554054054
10,"super flyweight",26,"right-handed",8,0,1,9,0.944444444
10,"middleweight",33,"right-handed",11,25,5,41,0.329268293
10,"super middleweight",35,"right-handed",5,4,0,9,0.555555556
10,"super welterweight",27,"right-handed",3,0,0,3,1
10,"super middleweight",36,"right-handed",4,2,0,6,0.666666667
10,"welterweight",32,"right-handed",15,12,1,28,0.553571429
10,"featherweight",25,"right-handed",7,4,1,12,0.625
10,"middleweight",NA,"right-handed",4,3,1,8,0.5625
10,"super lightweight",29,"right-handed",7,12,1,20,0.375
10,"welterweight",32,"right-handed",10,3,0,13,0.769230769
10,"cruiserweight",30,"right-handed",9,0,0,9,1
10,"super welterweight",30,"right-handed",13,4,0,17,0.764705882
10,"middleweight",30,"right-handed",5,0,0,5,1
10,"super flyweight",24,"right-handed",7,1,2,10,0.8
10,"super middleweight",22,"right-handed",7,0,0,7,1
10,"welterweight",27,"right-handed",8,3,0,11,0.727272727
10,"super lightweight",29,"right-handed",14,3,1,18,0.805555556
10,"lightweight",37,"right-handed",38,55,7,100,0.415
10,"middleweight",24,"right-handed",4,1,1,6,0.75
10,"middleweight",43,"right-handed",5,7,1,13,0.423076923
10,"lightweight",32,"right-handed",32,10,0,42,0.761904762
10,"super middleweight",41,"right-handed",32,13,0,45,0.711111111
10,"cruiserweight",27,"right-handed",7,1,0,8,0.875
10,"super featherweight",27,"right-handed",5,0,1,6,0.916666667
10,"lightweight",26,"right-handed",5,0,0,5,1
10,"heavyweight",35,"right-handed",10,2,1,13,0.807692308
10,"featherweight",21,"right-handed",6,0,0,6,1
10,"super featherweight",26,"right-handed",6,2,3,11,0.681818182
10,"super lightweight",29,"right-handed",3,0,0,3,1
10,"super middleweight",27,"right-handed",16,8,1,25,0.66
10,"super welterweight",31,"right-handed",20,11,2,33,0.636363636
10,"welterweight",25,"right-handed",10,2,0,12,0.833333333
10,"light flyweight",25,"right-handed",6,5,0,11,0.545454545
10,"cruiserweight",35,"right-handed",7,2,0,9,0.777777778
10,"welterweight",27,"right-handed",6,3,4,13,0.615384615
10,"middleweight",NA,"right-handed",4,0,0,4,1
10,"featherweight",27,"right-handed",5,2,1,8,0.6875
10,"bantamweight",23,"right-handed",4,1,2,7,0.714285714
10,"heavyweight",41,"right-handed",40,8,1,49,0.826530612
10,"cruiserweight",30,"right-handed",17,5,0,22,0.772727273
10,"light heavyweight",30,"right-handed",12,1,2,15,0.866666667
10,"flyweight",33,"right-handed",4,1,0,5,0.8
10,"featherweight",40,"right-handed",19,26,2,47,0.425531915
10,"heavyweight",33,"right-handed",28,6,0,34,0.823529412
10,"super lightweight",30,"right-handed",8,6,0,14,0.571428571
10,"flyweight",37,"right-handed",60,10,2,72,0.847222222
10,"super welterweight",36,"right-handed",12,45,1,58,0.215517241
10,"super welterweight",23,"right-handed",3,0,0,3,1
10,"cruiserweight",23,"right-handed",4,0,0,4,1
10,"super featherweight",26,"right-handed",10,5,2,17,0.647058824
10,"welterweight",32,"right-handed",17,10,2,29,0.620689655
10,"heavyweight",43,"right-handed",19,17,2,38,0.526315789
10,"heavyweight",33,"right-handed",12,1,0,13,0.923076923
10,"super welterweight",20,"right-handed",3,0,0,3,1
10,"super lightweight",25,"right-handed",10,1,0,11,0.909090909
10,"heavyweight",26,"right-handed",7,0,0,7,1
10,"super flyweight",27,"right-handed",6,3,0,9,0.666666667
10,"super welterweight",31,"right-handed",22,12,2,36,0.638888889
10,"welterweight",NA,"right-handed",6,4,2,12,0.583333333
10,"light flyweight",30,"right-handed",7,3,3,13,0.653846154
10,"bantamweight",26,"right-handed",16,8,0,24,0.666666667
10,"super lightweight",34,"right-handed",22,14,1,37,0.608108108
10,"welterweight",24,"right-handed",6,0,0,6,1
10,"cruiserweight",27,"right-handed",5,1,0,6,0.833333333
10,"super welterweight",36,"right-handed",14,3,0,17,0.823529412
10,"super middleweight",32,"right-handed",7,8,4,19,0.473684211
10,"super bantamweight",27,"right-handed",16,8,1,25,0.66
10,"middleweight",26,"right-handed",4,1,2,7,0.714285714
10,"super lightweight",34,"right-handed",24,15,1,40,0.6125
10,"bantamweight",36,"right-handed",13,14,3,30,0.483333333
10,"featherweight",21,"right-handed",9,0,2,11,0.909090909
10,"super flyweight",23,"right-handed",8,6,0,14,0.571428571
10,"super lightweight",26,"right-handed",5,0,0,5,1
10,"lightweight",32,"right-handed",16,3,0,19,0.842105263
10,"super lightweight",43,"right-handed",19,2,0,21,0.904761905
10,"super featherweight",23,"right-handed",3,1,3,7,0.642857143
10,"welterweight",31,"right-handed",3,5,3,11,0.409090909
10,"featherweight",25,"right-handed",7,2,0,9,0.777777778
10,"super bantamweight",27,"right-handed",12,3,0,15,0.8
10,"middleweight",30,"right-handed",7,0,0,7,1
10,"lightweight",26,"right-handed",6,4,0,10,0.6
10,"super middleweight",39,"right-handed",45,22,4,71,0.661971831
10,"lightweight",29,"right-handed",11,3,0,14,0.785714286
10,"light flyweight",21,"right-handed",13,4,0,17,0.764705882
10,"middleweight",29,"right-handed",4,7,1,12,0.375
10,"super middleweight",44,"right-handed",13,1,1,15,0.9
10,"cruiserweight",22,"right-handed",4,0,0,4,1
10,"flyweight",19,"right-handed",10,1,1,12,0.875
10,"flyweight",30,"right-handed",25,7,0,32,0.78125
10,"light heavyweight",24,"right-handed",3,0,0,3,1
10,"super lightweight",24,"right-handed",25,15,0,40,0.625
10,"light heavyweight",36,"right-handed",23,29,3,55,0.445454545
10,"lightweight",33,"right-handed",12,2,1,15,0.833333333
10,"welterweight",25,"right-handed",4,1,1,6,0.75
10,"super lightweight",26,"right-handed",7,1,1,9,0.833333333
10,"light heavyweight",38,"right-handed",13,8,0,21,0.619047619
10,"super bantamweight",24,"right-handed",5,2,1,8,0.6875
10,"super bantamweight",20,"right-handed",5,1,1,7,0.785714286
11,"featherweight",27,"right-handed",3,0,0,3,1
11,"welterweight",25,"right-handed",4,3,1,8,0.5625
11,"featherweight",27,"right-handed",6,4,2,12,0.583333333
10,"super featherweight",24,"right-handed",7,1,0,8,0.875
10,"bantamweight",23,"right-handed",5,0,0,5,1
10,"light heavyweight",28,"right-handed",4,0,0,4,1
10,"super flyweight",28,"right-handed",19,18,1,38,0.513157895
10,"flyweight",29,"right-handed",5,1,1,7,0.785714286
10,"lightweight",22,"right-handed",6,3,1,10,0.65
10,"bantamweight",30,"right-handed",5,7,3,15,0.433333333
10,"heavyweight",44,"right-handed",23,7,1,31,0.758064516
10,"lightweight",19,"right-handed",5,0,0,5,1
10,"welterweight",30,"right-handed",7,6,1,14,0.535714286
10,"heavyweight",35,"right-handed",67,23,3,93,0.73655914
10,"featherweight",27,"right-handed",11,3,0,14,0.785714286
10,"middleweight",36,"right-handed",11,9,0,20,0.55
10,"cruiserweight",39,"right-handed",25,13,4,42,0.642857143
10,"featherweight",38,"right-handed",9,3,2,14,0.714285714
10,"featherweight",28,"right-handed",9,8,0,17,0.529411765
10,"welterweight",27,"right-handed",11,8,2,21,0.571428571
10,"cruiserweight",20,"right-handed",5,0,0,5,1
10,"welterweight",26,"right-handed",4,2,0,6,0.666666667
10,"welterweight",21,"right-handed",5,0,1,6,0.916666667
10,"welterweight",25,"right-handed",8,2,1,11,0.772727273
10,"lightweight",30,"right-handed",7,2,0,9,0.777777778
10,"bantamweight",36,"right-handed",10,14,2,26,0.423076923
10,"heavyweight",33,"right-handed",14,3,2,19,0.789473684
10,"super lightweight",25,"right-handed",25,23,1,49,0.520408163
10,"super welterweight",28,"right-handed",6,0,0,6,1
10,"light flyweight",24,"right-handed",18,5,0,23,0.782608696
10,"super welterweight",34,"right-handed",7,1,0,8,0.875
10,"lightweight",25,"right-handed",8,6,0,14,0.571428571
10,"super bantamweight",27,"right-handed",6,1,1,8,0.8125
10,"super lightweight",19,"right-handed",7,0,0,7,1
10,"super featherweight",21,"right-handed",7,0,0,7,1
10,"super lightweight",24,"right-handed",9,4,1,14,0.678571429
10,"super welterweight",20,"right-handed",8,0,0,8,1
10,"welterweight",35,"right-handed",9,14,1,24,0.395833333
10,"welterweight",28,"right-handed",14,3,0,17,0.823529412
10,"super featherweight",28,"right-handed",10,1,0,11,0.909090909
10,"bantamweight",44,"right-handed",17,3,1,21,0.833333333
10,"welterweight",31,"right-handed",6,0,0,6,1
10,"super middleweight",27,"right-handed",4,0,0,4,1
10,"featherweight",23,"right-handed",4,0,0,4,1
10,"heavyweight",36,"right-handed",12,23,1,36,0.347222222
10,"super lightweight",NA,"right-handed",7,4,0,11,0.636363636
10,"featherweight",NA,"right-handed",4,1,1,6,0.75
10,"welterweight",32,"right-handed",6,21,4,31,0.258064516
10,"lightweight",27,"right-handed",6,6,4,16,0.5
10,"heavyweight",40,"right-handed",15,12,3,30,0.55
11,"super bantamweight",30,"right-handed",4,0,2,6,0.833333333
11,"light flyweight",25,"right-handed",18,10,1,29,0.637931034
11,"bantamweight",25,"right-handed",6,1,2,9,0.777777778
11,"featherweight",27,"right-handed",5,3,0,8,0.625
11,"featherweight",30,"right-handed",8,5,1,14,0.607142857
11,"lightweight",27,"right-handed",9,3,0,12,0.75
11,"super bantamweight",NA,"right-handed",5,1,0,6,0.833333333
11,"lightweight",20,"right-handed",5,0,0,5,1
11,"lightweight",25,"right-handed",4,0,1,5,0.9
11,"featherweight",23,"right-handed",5,2,0,7,0.714285714
11,"super lightweight",23,"right-handed",1,0,0,1,1
11,"welterweight",24,"right-handed",7,3,0,10,0.7
11,"featherweight",18,"right-handed",16,1,2,19,0.894736842
11,"super bantamweight",27,"right-handed",11,6,0,17,0.647058824
11,"super lightweight",19,"right-handed",6,0,0,6,1
11,"super lightweight",30,"right-handed",7,4,2,13,0.615384615
11,"welterweight",35,"right-handed",27,5,0,32,0.84375
11,"welterweight",25,"right-handed",8,3,1,12,0.708333333
11,"middleweight",25,"right-handed",6,0,0,6,1
11,"featherweight",23,"right-handed",22,4,0,26,0.846153846
11,"flyweight",24,"right-handed",4,3,0,7,0.571428571
11,"super welterweight",31,"right-handed",14,5,0,19,0.736842105
11,"light heavyweight",NA,"right-handed",2,0,0,2,1
11,"super lightweight",43,"right-handed",21,6,2,29,0.75862069
11,"super lightweight",21,"right-handed",7,0,0,7,1
11,"welterweight",36,"right-handed",6,2,1,9,0.722222222
11,"light heavyweight",25,"right-handed",5,2,0,7,0.714285714
11,"super lightweight",25,"right-handed",7,1,0,8,0.875
11,"welterweight",29,"right-handed",5,1,3,9,0.722222222
11,"light flyweight",27,"right-handed",13,9,10,32,0.5625
11,"light flyweight",NA,"right-handed",9,17,1,27,0.351851852
11,"lightweight",28,"right-handed",5,1,2,8,0.75
11,"heavyweight",33,"right-handed",8,0,0,8,1
11,"welterweight",NA,"right-handed",5,0,0,5,1
11,"super lightweight",25,"right-handed",10,7,2,19,0.578947368
11,"super lightweight",29,"right-handed",6,7,2,15,0.466666667
11,"light heavyweight",32,"right-handed",8,2,2,12,0.75
11,"super featherweight",18,"right-handed",5,2,1,8,0.6875
11,"welterweight",19,"right-handed",6,0,0,6,1
11,"super middleweight",NA,"right-handed",8,3,0,11,0.727272727
11,"super welterweight",31,"right-handed",15,6,2,23,0.695652174
11,"middleweight",22,"right-handed",4,0,0,4,1
11,"super welterweight",34,"right-handed",5,8,3,16,0.40625
11,"flyweight",23,"right-handed",4,1,0,5,0.8
11,"lightweight",36,"right-handed",29,21,0,50,0.58
11,"light heavyweight",35,"right-handed",22,13,1,36,0.625
11,"lightweight",29,"right-handed",7,1,0,8,0.875
11,"featherweight",28,"right-handed",21,6,2,29,0.75862069
11,"featherweight",26,"right-handed",9,2,2,13,0.769230769
11,"minimumweight",21,"right-handed",5,2,0,7,0.714285714
11,"super bantamweight",30,"right-handed",4,0,2,6,0.833333333
11,"light flyweight",25,"right-handed",18,10,1,29,0.637931034
11,"bantamweight",25,"right-handed",6,1,2,9,0.777777778
11,"featherweight",27,"right-handed",5,3,0,8,0.625
11,"featherweight",30,"right-handed",8,5,1,14,0.607142857
11,"lightweight",27,"right-handed",9,3,0,12,0.75
11,"super bantamweight",NA,"right-handed",5,1,0,6,0.833333333
11,"lightweight",20,"right-handed",5,0,0,5,1
11,"lightweight",25,"right-handed",4,0,1,5,0.9
11,"featherweight",23,"right-handed",5,2,0,7,0.714285714
11,"super lightweight",23,"right-handed",1,0,0,1,1
11,"welterweight",24,"right-handed",7,3,0,10,0.7
11,"featherweight",18,"right-handed",16,1,2,19,0.894736842
11,"super bantamweight",27,"right-handed",11,6,0,17,0.647058824
11,"super lightweight",19,"right-handed",6,0,0,6,1
11,"super lightweight",30,"right-handed",7,4,2,13,0.615384615
11,"welterweight",35,"right-handed",27,5,0,32,0.84375
11,"welterweight",25,"right-handed",8,3,1,12,0.708333333
11,"middleweight",25,"right-handed",6,0,0,6,1
11,"featherweight",23,"right-handed",22,4,0,26,0.846153846
11,"flyweight",24,"right-handed",4,3,0,7,0.571428571
11,"super welterweight",31,"right-handed",14,5,0,19,0.736842105
11,"light heavyweight",NA,"right-handed",2,0,0,2,1
11,"super lightweight",43,"right-handed",21,6,2,29,0.75862069
11,"super lightweight",21,"right-handed",7,0,0,7,1
11,"welterweight",36,"right-handed",6,2,1,9,0.722222222
11,"light heavyweight",25,"right-handed",5,2,0,7,0.714285714
11,"super lightweight",25,"right-handed",7,1,0,8,0.875
11,"welterweight",29,"right-handed",5,1,3,9,0.722222222
11,"light flyweight",27,"right-handed",13,9,10,32,0.5625
11,"light flyweight",NA,"right-handed",9,17,1,27,0.351851852
11,"lightweight",28,"right-handed",5,1,2,8,0.75
11,"heavyweight",33,"right-handed",8,0,0,8,1
11,"welterweight",NA,"right-handed",5,0,0,5,1
11,"super lightweight",25,"right-handed",10,7,2,19,0.578947368
11,"super lightweight",29,"right-handed",6,7,2,15,0.466666667
11,"light heavyweight",32,"right-handed",8,2,2,12,0.75
11,"super featherweight",18,"right-handed",5,2,1,8,0.6875
11,"welterweight",19,"right-handed",6,0,0,6,1
11,"super middleweight",NA,"right-handed",8,3,0,11,0.727272727
11,"super welterweight",31,"right-handed",15,6,2,23,0.695652174
11,"middleweight",22,"right-handed",4,0,0,4,1
11,"super welterweight",34,"right-handed",5,8,3,16,0.40625
11,"flyweight",23,"right-handed",4,1,0,5,0.8
11,"lightweight",36,"right-handed",29,21,0,50,0.58
11,"light heavyweight",35,"right-handed",22,13,1,36,0.625
11,"lightweight",29,"right-handed",7,1,0,8,0.875
11,"featherweight",28,"right-handed",21,6,2,29,0.75862069
11,"featherweight",26,"right-handed",9,2,2,13,0.769230769
11,"minimumweight",21,"right-handed",5,2,0,7,0.714285714
11,"heavyweight",40,"right-handed",15,2,0,17,0.882352941
11,"middleweight",22,"right-handed",4,0,1,5,0.9
11,"heavyweight",41,"right-handed",32,4,1,37,0.878378378
11,"super bantamweight",32,"right-handed",3,1,2,6,0.666666667
11,"featherweight",23,"right-handed",5,6,0,11,0.454545455
11,"middleweight",31,"right-handed",11,21,4,36,0.361111111
11,"heavyweight",40,"right-handed",23,11,2,36,0.666666667
11,"super middleweight",29,"right-handed",7,2,1,10,0.75
11,"super middleweight",33,"right-handed",16,2,0,18,0.888888889
11,"featherweight",38,"right-handed",19,9,1,29,0.672413793
11,"welterweight",31,"right-handed",11,4,0,15,0.733333333
11,"super middleweight",30,"right-handed",22,5,1,28,0.803571429
11,"super lightweight",20,"right-handed",5,0,0,5,1
11,"light heavyweight",29,"right-handed",7,3,1,11,0.681818182
11,"super featherweight",29,"right-handed",5,5,2,12,0.5
11,"super featherweight",29,"right-handed",27,10,3,40,0.7125
11,"lightweight",21,"right-handed",5,0,0,5,1
11,"welterweight",NA,"right-handed",5,6,0,11,0.454545455
11,"super welterweight",31,"right-handed",3,0,0,3,1
11,"lightweight",24,"right-handed",16,6,2,24,0.708333333
11,"welterweight",26,"right-handed",3,9,1,13,0.269230769
11,"welterweight",32,"right-handed",9,12,1,22,0.431818182
11,"middleweight",28,"right-handed",7,1,1,9,0.833333333
11,"super featherweight",27,"right-handed",11,4,0,15,0.733333333
11,"super lightweight",28,"right-handed",18,7,1,26,0.711538462
11,"welterweight",27,"right-handed",14,12,2,28,0.535714286
11,"super lightweight",23,"right-handed",18,8,0,26,0.692307692
11,"super welterweight",28,"right-handed",6,5,0,11,0.545454545
11,"super middleweight",28,"right-handed",10,4,1,15,0.7
11,"super middleweight",30,"right-handed",6,2,1,9,0.722222222
11,"super lightweight",22,"right-handed",5,0,0,5,1
11,"super bantamweight",32,"right-handed",14,7,0,21,0.666666667
11,"bantamweight",19,"right-handed",2,0,0,2,1
11,"heavyweight",38,"right-handed",17,3,2,22,0.818181818
11,"light heavyweight",41,"right-handed",19,14,1,34,0.573529412
11,"middleweight",33,"right-handed",15,7,2,24,0.666666667
11,"super bantamweight",22,"right-handed",5,2,0,7,0.714285714
11,"heavyweight",32,"right-handed",5,0,0,5,1
11,"bantamweight",26,"right-handed",14,11,1,26,0.557692308
11,"super middleweight",26,"right-handed",15,8,2,25,0.64
11,"heavyweight",36,"right-handed",6,0,0,6,1
11,"super welterweight",24,"right-handed",5,0,0,5,1
11,"lightweight",25,"right-handed",6,0,0,6,1
11,"lightweight",29,"right-handed",25,7,2,34,0.764705882
11,"super middleweight",30,"right-handed",15,10,1,26,0.596153846
11,"super lightweight",22,"right-handed",5,0,0,5,1
11,"lightweight",28,"right-handed",6,0,2,8,0.875
11,"middleweight",36,"right-handed",37,13,0,50,0.74
11,"featherweight",30,"right-handed",16,4,2,22,0.772727273
11,"light heavyweight",21,"right-handed",5,0,0,5,1
11,"lightweight",27,"right-handed",7,1,0,8,0.875
11,"super featherweight",29,"right-handed",13,7,1,21,0.642857143
11,"super flyweight",26,"right-handed",6,1,0,7,0.857142857
11,"super welterweight",23,"right-handed",13,0,1,14,0.964285714
11,"super featherweight",26,"right-handed",10,3,1,14,0.75
11,"lightweight",26,"right-handed",8,1,1,10,0.85
11,"super featherweight",28,"right-handed",10,4,1,15,0.7
11,"super featherweight",29,"right-handed",9,3,0,12,0.75
11,"featherweight",27,"right-handed",14,7,0,21,0.666666667
11,"light heavyweight",31,"right-handed",18,15,0,33,0.545454545
11,"bantamweight",28,"right-handed",9,2,0,11,0.818181818
11,"super featherweight",28,"right-handed",7,0,0,7,1
11,"super bantamweight",23,"right-handed",12,0,2,14,0.928571429
11,"welterweight",29,"right-handed",7,18,2,27,0.296296296
11,"welterweight",24,"right-handed",6,0,0,6,1
11,"middleweight",35,"right-handed",7,5,1,13,0.576923077
11,"cruiserweight",31,"right-handed",7,0,1,8,0.9375
11,"super welterweight",29,"right-handed",12,9,1,22,0.568181818
11,"super lightweight",23,"right-handed",7,0,0,7,1
11,"bantamweight",33,"right-handed",5,1,2,8,0.75
11,"super bantamweight",35,"right-handed",9,11,6,26,0.461538462
11,"super welterweight",29,"right-handed",9,9,2,20,0.5
11,"super bantamweight",25,"right-handed",6,1,0,7,0.857142857
11,"super middleweight",27,"right-handed",5,0,0,5,1
11,"cruiserweight",31,"right-handed",13,8,1,22,0.613636364
11,"super bantamweight",25,"right-handed",10,9,1,20,0.525
11,"super welterweight",27,"right-handed",9,1,0,10,0.9
11,"welterweight",30,"right-handed",12,13,1,26,0.480769231
11,"minimumweight",23,"right-handed",6,5,0,11,0.545454545
11,"middleweight",31,"right-handed",15,5,0,20,0.75
11,"super lightweight",22,"right-handed",5,0,0,5,1
11,"featherweight",24,"right-handed",8,0,0,8,1
11,"middleweight",35,"right-handed",28,15,2,45,0.644444444
11,"featherweight",21,"right-handed",6,3,1,10,0.65
11,"super bantamweight",34,"right-handed",11,5,0,16,0.6875
11,"middleweight",38,"right-handed",19,4,0,23,0.826086957
11,"light heavyweight",36,"right-handed",14,4,2,20,0.75
11,"bantamweight",22,"right-handed",10,2,0,12,0.833333333
11,"super bantamweight",28,"right-handed",8,0,0,8,1
11,"bantamweight",27,"right-handed",6,27,3,36,0.208333333
11,"super middleweight",28,"right-handed",5,0,0,5,1
11,"lightweight",26,"right-handed",5,2,1,8,0.6875
11,"super lightweight",34,"right-handed",9,9,1,19,0.5
11,"welterweight",33,"right-handed",8,2,0,10,0.8
11,"light flyweight",35,"right-handed",20,10,1,31,0.661290323
11,"super featherweight",30,"right-handed",9,5,3,17,0.617647059
11,"lightweight",19,"right-handed",12,3,1,16,0.78125
11,"super lightweight",37,"right-handed",5,0,0,5,1
11,"heavyweight",28,"right-handed",3,0,0,3,1
11,"super lightweight",30,"right-handed",7,7,1,15,0.5
11,"heavyweight",32,"right-handed",6,0,0,6,1
11,"super bantamweight",30,"right-handed",8,1,0,9,0.888888889
11,"light heavyweight",31,"right-handed",15,11,1,27,0.574074074
11,"super middleweight",33,"right-handed",22,2,1,25,0.9
11,"flyweight",31,"right-handed",23,8,0,31,0.741935484
11,"super bantamweight",23,"right-handed",7,5,1,13,0.576923077
11,"lightweight",35,"right-handed",25,19,2,46,0.565217391
11,"super bantamweight",24,"right-handed",7,1,0,8,0.875
11,"cruiserweight",31,"right-handed",13,2,0,15,0.866666667
11,"super welterweight",NA,"right-handed",7,0,0,7,1
11,"super flyweight",28,"right-handed",7,5,3,15,0.566666667
11,"light heavyweight",32,"right-handed",10,6,0,16,0.625
11,"light flyweight",22,"right-handed",6,0,0,6,1
11,"flyweight",22,"right-handed",9,0,0,9,1
11,"super bantamweight",29,"right-handed",14,8,5,27,0.611111111
11,"lightweight",27,"right-handed",4,1,0,5,0.8
11,"super featherweight",24,"right-handed",8,3,1,12,0.708333333
11,"super middleweight",24,"right-handed",7,11,1,19,0.394736842
11,"super flyweight",22,"right-handed",9,3,0,12,0.75
11,"lightweight",25,"right-handed",6,1,0,7,0.857142857
11,"middleweight",25,"right-handed",9,4,2,15,0.666666667
11,"bantamweight",25,"right-handed",9,5,2,16,0.625
11,"welterweight",26,"right-handed",9,1,1,11,0.863636364
11,"light heavyweight",26,"right-handed",6,0,0,6,1
11,"heavyweight",30,"right-handed",13,6,0,19,0.684210526
11,"super welterweight",35,"right-handed",36,9,1,46,0.793478261
11,"heavyweight",36,"right-handed",9,1,1,11,0.863636364
11,"middleweight",22,"right-handed",5,2,0,7,0.714285714
11,"minimumweight",34,"right-handed",33,8,1,42,0.797619048
11,"welterweight",26,"right-handed",6,1,0,7,0.857142857
11,"lightweight",23,"right-handed",18,6,0,24,0.75
11,"middleweight",23,"right-handed",9,2,0,11,0.818181818
11,"super middleweight",20,"right-handed",4,0,0,4,1
11,"cruiserweight",34,"right-handed",5,0,0,5,1
11,"super featherweight",26,"right-handed",5,1,0,6,0.833333333
11,"super lightweight",31,"right-handed",7,4,0,11,0.636363636
11,"lightweight",36,"right-handed",12,1,0,13,0.923076923
11,"super middleweight",44,"right-handed",8,8,1,17,0.5
11,"super middleweight",32,"right-handed",15,4,4,23,0.739130435
11,"cruiserweight",38,"right-handed",8,4,1,13,0.653846154
11,"welterweight",19,"right-handed",6,0,0,6,1
11,"cruiserweight",38,"right-handed",30,1,0,31,0.967741935
11,"featherweight",25,"right-handed",4,1,0,5,0.8
11,"super lightweight",26,"right-handed",6,3,0,9,0.666666667
11,"light heavyweight",26,"right-handed",3,0,0,3,1
11,"lightweight",22,"right-handed",7,3,0,10,0.7
11,"super middleweight",NA,"right-handed",5,1,0,6,0.833333333
11,"heavyweight",44,"right-handed",26,34,0,60,0.433333333
11,"light flyweight",23,"right-handed",1,1,0,2,0.5
11,"super welterweight",21,"right-handed",4,0,0,4,1
12,"super flyweight",24,"right-handed",8,2,0,10,0.8
12,"super bantamweight",28,"right-handed",14,8,1,23,0.630434783
12,"cruiserweight",37,"right-handed",17,27,0,44,0.386363636
12,"super bantamweight",34,"right-handed",16,8,1,25,0.66
12,"super middleweight",NA,"right-handed",7,2,1,10,0.75
12,"light heavyweight",27,"right-handed",5,1,0,6,0.833333333
12,"super welterweight",28,"right-handed",22,2,0,24,0.916666667
12,"welterweight",39,"right-handed",42,14,3,59,0.737288136
12,"super bantamweight",25,"right-handed",15,5,0,20,0.75
12,"super featherweight",26,"right-handed",5,0,0,5,1
12,"cruiserweight",35,"right-handed",23,9,2,34,0.705882353
12,"featherweight",34,"right-handed",22,8,1,31,0.725806452
12,"cruiserweight",29,"right-handed",4,3,0,7,0.571428571
12,"welterweight",26,"right-handed",5,0,0,5,1
12,"featherweight",20,"right-handed",11,1,0,12,0.916666667
12,"middleweight",24,"right-handed",6,3,1,10,0.65
12,"super bantamweight",30,"right-handed",7,0,1,8,0.9375
12,"super featherweight",22,"right-handed",7,0,0,7,1
12,"welterweight",32,"right-handed",16,6,0,22,0.727272727
12,"lightweight",22,"right-handed",4,0,2,6,0.833333333
12,"super welterweight",21,"right-handed",9,1,0,10,0.9
12,"super featherweight",24,"right-handed",11,1,1,13,0.884615385
12,"super featherweight",27,"right-handed",4,0,0,4,1
12,"super bantamweight",24,"right-handed",7,0,3,10,0.85
12,"welterweight",26,"right-handed",13,1,1,15,0.9
12,"middleweight",32,"right-handed",8,0,0,8,1
12,"cruiserweight",41,"right-handed",28,9,0,37,0.756756757
12,"super welterweight",32,"right-handed",21,9,0,30,0.7
12,"super welterweight",30,"right-handed",15,20,1,36,0.430555556
12,"flyweight",23,"right-handed",15,12,4,31,0.548387097
12,"super middleweight",27,"right-handed",4,0,0,4,1
12,"super lightweight",33,"right-handed",20,17,2,39,0.538461538
12,"super bantamweight",29,"right-handed",14,1,0,15,0.933333333
12,"light flyweight",27,"right-handed",8,8,1,17,0.5
12,"welterweight",31,"right-handed",11,0,1,12,0.958333333
12,"lightweight",23,"right-handed",12,2,0,14,0.857142857
12,"welterweight",21,"right-handed",4,0,0,4,1
12,"welterweight",39,"right-handed",4,3,2,9,0.555555556
12,"super flyweight",19,"right-handed",7,4,1,12,0.625
12,"welterweight",39,"right-handed",26,12,2,40,0.675
12,"bantamweight",21,"right-handed",5,1,0,6,0.833333333
12,"minimumweight",29,"right-handed",19,8,0,27,0.703703704
11,"super lightweight",34,"right-handed",18,6,2,26,0.730769231
11,"super lightweight",24,"right-handed",8,3,2,13,0.692307692
11,"minimumweight",22,"right-handed",6,8,2,16,0.4375
11,"super lightweight",36,"right-handed",10,3,0,13,0.769230769
11,"heavyweight",29,"right-handed",6,0,1,7,0.928571429
11,"lightweight",24,"right-handed",6,3,0,9,0.666666667
11,"cruiserweight",32,"right-handed",9,2,1,12,0.791666667
11,"welterweight",24,"right-handed",3,1,3,7,0.642857143
12,"welterweight",29,"right-handed",10,8,1,19,0.552631579
12,"heavyweight",36,"right-handed",26,6,0,32,0.8125
12,"middleweight",33,"right-handed",18,6,1,25,0.74
12,"cruiserweight",39,"right-handed",11,0,1,12,0.958333333
12,"middleweight",36,"right-handed",19,9,1,29,0.672413793
12,"super lightweight",33,"right-handed",16,3,2,21,0.80952381
12,"super flyweight",24,"right-handed",18,7,0,25,0.72
12,"heavyweight",35,"right-handed",9,2,1,12,0.791666667
12,"welterweight",26,"right-handed",29,30,0,59,0.491525424
12,"lightweight",24,"right-handed",6,4,0,10,0.6
12,"featherweight",22,"right-handed",7,1,0,8,0.875
12,"welterweight",25,"right-handed",20,8,2,30,0.7
12,"featherweight",26,"right-handed",6,2,0,8,0.75
12,"welterweight",26,"right-handed",17,16,1,34,0.514705882
12,"lightweight",23,"right-handed",4,0,0,4,1
12,"super welterweight",20,"right-handed",6,0,1,7,0.928571429
12,"lightweight",33,"right-handed",13,1,0,14,0.928571429
12,"flyweight",23,"right-handed",16,3,2,21,0.80952381
12,"lightweight",23,"right-handed",10,1,1,12,0.875
12,"super middleweight",35,"right-handed",27,3,0,30,0.9
12,"cruiserweight",24,"right-handed",9,2,1,12,0.791666667
12,"featherweight",25,"right-handed",5,0,0,5,1
12,"middleweight",30,"right-handed",15,4,0,19,0.789473684
12,"cruiserweight",42,"right-handed",32,6,0,38,0.842105263
12,"super welterweight",37,"right-handed",14,2,0,16,0.875
12,"super welterweight",31,"right-handed",26,14,0,40,0.65
12,"super featherweight",22,"right-handed",4,2,0,6,0.666666667
12,"bantamweight",22,"right-handed",9,4,1,14,0.678571429
12,"super featherweight",28,"right-handed",11,3,0,14,0.785714286
12,"lightweight",21,"right-handed",5,2,0,7,0.714285714
12,"middleweight",25,"right-handed",8,1,0,9,0.888888889
12,"heavyweight",29,"right-handed",6,0,1,7,0.928571429
12,"cruiserweight",NA,"right-handed",2,0,1,3,0.833333333
12,"super welterweight",31,"right-handed",8,2,3,13,0.730769231
12,"middleweight",31,"right-handed",14,2,0,16,0.875
12,"heavyweight",35,"right-handed",57,12,5,74,0.804054054
12,"welterweight",18,"right-handed",9,0,0,9,1
12,"cruiserweight",46,"right-handed",30,5,1,36,0.847222222
12,"super welterweight",21,"right-handed",5,0,0,5,1
12,"super featherweight",NA,"right-handed",5,5,5,15,0.5
12,"flyweight",21,"right-handed",7,4,2,13,0.615384615
12,"welterweight",24,"right-handed",7,0,0,7,1
12,"cruiserweight",23,"right-handed",7,0,1,8,0.9375
12,"welterweight",27,"right-handed",15,8,3,26,0.634615385
12,"super middleweight",21,"right-handed",7,0,0,7,1
12,"heavyweight",38,"right-handed",26,1,0,27,0.962962963
12,"heavyweight",26,"right-handed",5,0,0,5,1
12,"super middleweight",34,"right-handed",9,3,0,12,0.75
12,"super middleweight",29,"right-handed",4,0,0,4,1
12,"super welterweight",30,"right-handed",13,2,0,15,0.866666667
12,"bantamweight",26,"right-handed",11,3,0,14,0.785714286
12,"welterweight",32,"right-handed",20,7,1,28,0.732142857
12,"super lightweight",25,"right-handed",6,0,0,6,1
12,"super middleweight",28,"right-handed",7,0,0,7,1
12,"super middleweight",31,"right-handed",27,9,3,39,0.730769231
12,"light heavyweight",29,"right-handed",22,10,1,33,0.681818182
12,"welterweight",29,"right-handed",12,11,0,23,0.52173913
12,"super welterweight",36,"right-handed",27,11,0,38,0.710526316
12,"super bantamweight",21,"right-handed",5,3,0,8,0.625
12,"super flyweight",27,"right-handed",12,12,2,26,0.5
12,"featherweight",25,"right-handed",8,2,0,10,0.8
12,"heavyweight",32,"right-handed",4,0,0,4,1
12,"lightweight",32,"right-handed",4,0,1,5,0.9
12,"middleweight",27,"right-handed",8,7,1,16,0.53125
12,"welterweight",25,"right-handed",4,1,0,5,0.8
12,"light flyweight",19,"right-handed",5,0,0,5,1
12,"cruiserweight",36,"right-handed",22,16,0,38,0.578947368
12,"welterweight",35,"right-handed",31,7,1,39,0.807692308
12,"super featherweight",32,"right-handed",11,7,3,21,0.595238095
12,"lightweight",26,"right-handed",9,0,1,10,0.95
12,"featherweight",32,"right-handed",14,7,2,23,0.652173913
12,"super middleweight",27,"right-handed",10,1,0,11,0.909090909
12,"super welterweight",40,"right-handed",41,13,2,56,0.75
12,"super flyweight",21,"right-handed",5,0,1,6,0.916666667
12,"super lightweight",29,"right-handed",7,0,0,7,1
12,"super middleweight",35,"right-handed",27,13,2,42,0.666666667
12,"cruiserweight",27,"right-handed",3,0,0,3,1
12,"light flyweight",23,"right-handed",5,3,0,8,0.625
12,"middleweight",33,"right-handed",9,0,1,10,0.95
12,"lightweight",25,"right-handed",8,1,1,10,0.85
12,"super welterweight",30,"right-handed",31,18,3,52,0.625
12,"super middleweight",28,"right-handed",4,0,0,4,1
12,"heavyweight",37,"right-handed",7,1,2,10,0.8
12,"super featherweight",26,"right-handed",16,10,2,28,0.607142857
12,"super welterweight",36,"right-handed",25,11,1,37,0.689189189
12,"super featherweight",30,"right-handed",7,0,0,7,1
12,"welterweight",27,"right-handed",8,2,0,10,0.8
12,"super flyweight",23,"right-handed",12,3,2,17,0.764705882
12,"lightweight",23,"right-handed",6,0,0,6,1
12,"super lightweight",35,"right-handed",3,0,3,6,0.75
12,"super middleweight",40,"right-handed",45,27,5,77,0.616883117
12,"light heavyweight",27,"right-handed",8,0,0,8,1
12,"light flyweight",NA,"right-handed",8,5,0,13,0.615384615
12,"lightweight",35,"right-handed",28,7,3,38,0.776315789
12,"super welterweight",24,"right-handed",6,0,1,7,0.928571429
12,"super bantamweight",27,"right-handed",9,1,0,10,0.9
12,"bantamweight",25,"right-handed",7,2,0,9,0.777777778
12,"heavyweight",27,"right-handed",9,0,0,9,1
12,"super flyweight",29,"right-handed",32,8,0,40,0.8
12,"lightweight",28,"right-handed",19,6,1,26,0.75
13,"super featherweight",24,"right-handed",5,0,0,5,1
13,"middleweight",32,"right-handed",7,2,1,10,0.75
13,"welterweight",30,"right-handed",39,19,1,59,0.669491525
12,"featherweight",27,"right-handed",10,0,0,10,1
12,"cruiserweight",25,"right-handed",13,1,1,15,0.9
12,"flyweight",36,"right-handed",8,2,0,10,0.8
12,"cruiserweight",35,"right-handed",9,6,5,20,0.575
12,"super lightweight",21,"right-handed",13,4,1,18,0.75
12,"light heavyweight",30,"right-handed",11,1,0,12,0.916666667
12,"super welterweight",18,"right-handed",5,0,0,5,1
12,"cruiserweight",38,"right-handed",23,8,0,31,0.741935484
12,"super middleweight",25,"right-handed",7,1,0,8,0.875
12,"cruiserweight",31,"right-handed",9,2,0,11,0.818181818
12,"super lightweight",33,"right-handed",20,5,0,25,0.8
12,"super featherweight",32,"right-handed",11,2,1,14,0.821428571
12,"super welterweight",24,"right-handed",7,0,1,8,0.9375
12,"super lightweight",23,"right-handed",4,0,0,4,1
12,"super lightweight",33,"right-handed",6,0,0,6,1
12,"cruiserweight",37,"right-handed",32,3,1,36,0.902777778
12,"welterweight",30,"right-handed",11,9,3,23,0.543478261
12,"super flyweight",26,"right-handed",10,6,3,19,0.605263158
12,"super bantamweight",NA,"right-handed",14,4,0,18,0.777777778
12,"super lightweight",32,"right-handed",17,4,2,23,0.782608696
12,"bantamweight",26,"right-handed",9,2,0,11,0.818181818
12,"lightweight",32,"right-handed",11,5,1,17,0.676470588
12,"light flyweight",26,"right-handed",7,3,4,14,0.642857143
12,"super welterweight",34,"right-handed",16,6,1,23,0.717391304
12,"super featherweight",25,"right-handed",8,1,0,9,0.888888889
12,"super bantamweight",25,"right-handed",11,0,0,11,1
12,"middleweight",45,"right-handed",42,6,1,49,0.867346939
12,"heavyweight",43,"right-handed",35,12,1,48,0.739583333
12,"lightweight",26,"right-handed",13,5,0,18,0.722222222
12,"flyweight",19,"right-handed",5,1,0,6,0.833333333
12,"heavyweight",37,"right-handed",12,7,1,20,0.625
12,"featherweight",27,"right-handed",11,3,0,14,0.785714286
12,"super flyweight",20,"right-handed",7,0,0,7,1
12,"light heavyweight",24,"right-handed",10,0,0,10,1
12,"heavyweight",27,"right-handed",6,0,0,6,1
12,"super bantamweight",29,"right-handed",13,0,0,13,1
12,"light flyweight",20,"right-handed",7,1,1,9,0.833333333
12,"middleweight",36,"right-handed",14,10,1,25,0.58
12,"cruiserweight",32,"right-handed",16,7,0,23,0.695652174
12,"super lightweight",23,"right-handed",10,5,0,15,0.666666667
12,"super welterweight",32,"right-handed",11,3,0,14,0.785714286
12,"minimumweight",19,"right-handed",5,2,2,9,0.666666667
12,"lightweight",38,"right-handed",16,16,0,32,0.5
12,"super welterweight",31,"right-handed",13,12,1,26,0.519230769
12,"super featherweight",22,"right-handed",7,1,2,10,0.8
12,"heavyweight",37,"right-handed",13,12,1,26,0.519230769
12,"super bantamweight",26,"right-handed",10,1,3,14,0.821428571
13,"lightweight",32,"right-handed",17,26,2,45,0.4
13,"super bantamweight",20,"right-handed",3,0,0,3,1
13,"bantamweight",32,"right-handed",11,12,1,24,0.479166667
13,"super flyweight",32,"right-handed",3,1,1,5,0.7
13,"cruiserweight",31,"right-handed",32,13,1,46,0.706521739
13,"middleweight",26,"right-handed",5,0,1,6,0.916666667
13,"light heavyweight",27,"right-handed",14,7,1,22,0.659090909
13,"middleweight",21,"right-handed",7,0,0,7,1
13,"bantamweight",31,"right-handed",9,8,0,17,0.529411765
13,"super bantamweight",27,"right-handed",8,0,1,9,0.944444444
13,"bantamweight",24,"right-handed",11,8,2,21,0.571428571
13,"featherweight",25,"right-handed",9,21,0,30,0.3
13,"bantamweight",26,"right-handed",5,2,3,10,0.65
13,"heavyweight",32,"right-handed",5,14,2,21,0.285714286
13,"super lightweight",25,"right-handed",10,1,1,12,0.875
13,"middleweight",29,"right-handed",15,3,0,18,0.833333333
13,"super featherweight",24,"right-handed",10,3,1,14,0.75
13,"super bantamweight",28,"right-handed",6,2,2,10,0.7
13,"super lightweight",21,"right-handed",4,0,0,4,1
13,"featherweight",29,"right-handed",5,3,2,10,0.6
13,"welterweight",31,"right-handed",23,2,0,25,0.92
13,"light heavyweight",31,"right-handed",30,9,1,40,0.7625
13,"super featherweight",22,"right-handed",6,1,0,7,0.857142857
13,"lightweight",34,"right-handed",7,11,1,19,0.394736842
13,"super welterweight",21,"right-handed",6,1,0,7,0.857142857
13,"super flyweight",32,"right-handed",9,1,1,11,0.863636364
13,"super middleweight",24,"right-handed",7,4,0,11,0.636363636
13,"featherweight",24,"right-handed",10,1,0,11,0.909090909
13,"super lightweight",33,"right-handed",23,6,0,29,0.793103448
13,"lightweight",22,"right-handed",9,2,0,11,0.818181818
13,"middleweight",35,"right-handed",12,0,0,12,1
13,"light flyweight",37,"right-handed",23,18,0,41,0.56097561
13,"featherweight",27,"right-handed",19,14,0,33,0.575757576
13,"super lightweight",36,"right-handed",12,12,3,27,0.5
13,"super bantamweight",33,"right-handed",30,12,1,43,0.709302326
13,"lightweight",21,"right-handed",6,0,0,6,1
13,"super welterweight",19,"right-handed",5,0,0,5,1
13,"super lightweight",21,"right-handed",6,3,0,9,0.666666667
13,"welterweight",19,"right-handed",8,0,0,8,1
13,"super featherweight",19,"right-handed",12,0,0,12,1
13,"super welterweight",25,"right-handed",9,0,0,9,1
13,"super lightweight",30,"right-handed",11,8,1,20,0.575
13,"flyweight",22,"right-handed",11,3,2,16,0.75
13,"super middleweight",24,"right-handed",7,0,0,7,1
13,"featherweight",21,"right-handed",4,0,0,4,1
13,"middleweight",25,"right-handed",5,0,0,5,1
13,"light flyweight",27,"right-handed",5,2,1,8,0.6875
13,"flyweight",NA,"right-handed",4,1,2,7,0.714285714
13,"super lightweight",29,"right-handed",9,7,0,16,0.5625
13,"super middleweight",28,"right-handed",3,0,0,3,1
13,"super middleweight",30,"right-handed",19,5,0,24,0.791666667
13,"super middleweight",28,"right-handed",10,0,0,10,1
13,"featherweight",28,"right-handed",15,7,0,22,0.681818182
13,"super lightweight",30,"right-handed",20,16,3,39,0.551282051
13,"super bantamweight",29,"right-handed",5,2,0,7,0.714285714
13,"featherweight",22,"right-handed",6,1,0,7,0.857142857
13,"minimumweight",19,"right-handed",7,1,1,9,0.833333333
13,"super bantamweight",22,"right-handed",7,1,0,8,0.875
13,"flyweight",25,"right-handed",6,4,0,10,0.6
13,"heavyweight",38,"right-handed",19,4,1,24,0.8125
13,"light heavyweight",44,"right-handed",44,10,1,55,0.809090909
13,"flyweight",23,"right-handed",7,5,0,12,0.583333333
13,"super lightweight",26,"right-handed",10,1,0,11,0.909090909
13,"welterweight",32,"right-handed",24,9,1,34,0.720588235
13,"super flyweight",36,"right-handed",17,15,0,32,0.53125
13,"bantamweight",26,"right-handed",16,13,3,32,0.546875
13,"super lightweight",23,"right-handed",5,0,0,5,1
13,"heavyweight",35,"right-handed",7,0,0,7,1
13,"heavyweight",31,"right-handed",10,6,0,16,0.625
13,"cruiserweight",25,"right-handed",7,0,0,7,1
13,"super middleweight",41,"right-handed",22,5,0,27,0.814814815
13,"super middleweight",20,"right-handed",8,1,1,10,0.85
13,"welterweight",24,"right-handed",9,1,1,11,0.863636364
13,"cruiserweight",NA,"right-handed",5,1,2,8,0.75
13,"lightweight",29,"right-handed",6,0,0,6,1
13,"lightweight",28,"right-handed",9,2,0,11,0.818181818
13,"welterweight",19,"right-handed",12,2,0,14,0.857142857
13,"super welterweight",31,"right-handed",5,0,0,5,1
13,"super featherweight",24,"right-handed",8,6,2,16,0.5625
13,"light flyweight",23,"right-handed",8,1,1,10,0.85
13,"light flyweight",27,"right-handed",16,1,1,18,0.916666667
13,"lightweight",26,"right-handed",13,11,0,24,0.541666667
13,"middleweight",31,"right-handed",19,15,0,34,0.558823529
13,"super lightweight",22,"right-handed",4,0,0,4,1
13,"super flyweight",26,"right-handed",9,1,1,11,0.863636364
13,"featherweight",21,"right-handed",7,0,0,7,1
13,"flyweight",22,"right-handed",7,3,0,10,0.7
13,"super bantamweight",27,"right-handed",6,0,0,6,1
13,"cruiserweight",25,"right-handed",6,0,0,6,1
13,"welterweight",27,"right-handed",8,4,1,13,0.653846154
13,"light heavyweight",38,"right-handed",27,17,2,46,0.608695652
13,"lightweight",21,"right-handed",9,0,0,9,1
13,"super welterweight",29,"right-handed",9,3,0,12,0.75
13,"featherweight",22,"right-handed",8,4,3,15,0.633333333
13,"bantamweight",26,"right-handed",11,5,0,16,0.6875
13,"super middleweight",31,"right-handed",12,1,0,13,0.923076923
13,"lightweight",37,"right-handed",40,19,3,62,0.669354839
13,"lightweight",20,"right-handed",9,0,0,9,1
13,"super featherweight",29,"right-handed",23,8,5,36,0.708333333
13,"minimumweight",20,"right-handed",6,3,1,10,0.65
13,"minimumweight",30,"right-handed",12,27,5,44,0.329545455
13,"featherweight",32,"right-handed",11,2,0,13,0.846153846
13,"super bantamweight",35,"right-handed",9,2,1,12,0.791666667
13,"lightweight",31,"right-handed",22,10,0,32,0.6875
13,"super bantamweight",26,"right-handed",8,1,0,9,0.888888889
13,"welterweight",NA,"right-handed",11,2,0,13,0.846153846
13,"super lightweight",28,"right-handed",11,5,2,18,0.666666667
13,"super flyweight",23,"right-handed",9,3,3,15,0.7
13,"super flyweight",28,"right-handed",5,3,0,8,0.625
13,"cruiserweight",38,"right-handed",10,7,0,17,0.588235294
13,"super welterweight",33,"right-handed",10,5,1,16,0.65625
13,"super welterweight",25,"right-handed",9,1,0,10,0.9
13,"middleweight",23,"right-handed",6,0,0,6,1
13,"welterweight",26,"right-handed",6,1,0,7,0.857142857
13,"lightweight",32,"right-handed",22,12,1,35,0.642857143
13,"super middleweight",21,"right-handed",7,0,0,7,1
13,"super featherweight",32,"right-handed",20,15,3,38,0.565789474
13,"super welterweight",38,"right-handed",22,13,2,37,0.621621622
13,"middleweight",32,"right-handed",10,1,1,12,0.875
13,"super welterweight",27,"right-handed",8,1,0,9,0.888888889
13,"super welterweight",NA,"right-handed",4,0,1,5,0.9
13,"super featherweight",24,"right-handed",5,2,0,7,0.714285714
13,"featherweight",21,"right-handed",8,2,0,10,0.8
13,"super featherweight",29,"right-handed",8,0,0,8,1
13,"super welterweight",43,"right-handed",10,2,1,13,0.807692308
13,"middleweight",20,"right-handed",12,1,0,13,0.923076923
13,"super middleweight",36,"right-handed",30,14,5,49,0.663265306
13,"light heavyweight",28,"right-handed",19,4,0,23,0.826086957
13,"lightweight",20,"right-handed",5,0,0,5,1
13,"super middleweight",26,"right-handed",13,5,0,18,0.722222222
13,"super bantamweight",23,"right-handed",12,4,2,18,0.722222222
13,"super flyweight",21,"right-handed",12,6,1,19,0.657894737
13,"flyweight",22,"right-handed",13,5,0,18,0.722222222
13,"heavyweight",23,"right-handed",4,0,0,4,1
13,"super bantamweight",29,"right-handed",12,7,2,21,0.619047619
13,"featherweight",23,"right-handed",8,0,0,8,1
13,"super flyweight",29,"right-handed",12,7,1,20,0.625
13,"super featherweight",27,"right-handed",9,1,1,11,0.863636364
13,"super lightweight",24,"right-handed",9,0,0,9,1
13,"featherweight",33,"right-handed",15,10,0,25,0.6
13,"super welterweight",23,"right-handed",5,0,0,5,1
13,"flyweight",25,"right-handed",11,10,1,22,0.522727273
13,"super welterweight",34,"right-handed",25,5,0,30,0.833333333
13,"super middleweight",26,"right-handed",11,2,0,13,0.846153846
13,"welterweight",27,"right-handed",11,3,3,17,0.735294118
13,"lightweight",24,"right-handed",13,9,0,22,0.590909091
13,"featherweight",32,"right-handed",13,2,0,15,0.866666667
13,"welterweight",30,"right-handed",21,7,2,30,0.733333333
13,"super lightweight",23,"right-handed",8,0,1,9,0.944444444
13,"super featherweight",22,"right-handed",5,0,0,5,1
14,"super lightweight",28,"right-handed",6,0,1,7,0.928571429
14,"super welterweight",26,"right-handed",15,5,2,22,0.727272727
14,"welterweight",30,"right-handed",9,7,1,17,0.558823529
14,"super middleweight",29,"right-handed",8,2,1,11,0.772727273
14,"super featherweight",33,"right-handed",14,11,0,25,0.56
14,"super flyweight",22,"right-handed",6,1,0,7,0.857142857
14,"super welterweight",30,"right-handed",12,0,1,13,0.961538462
14,"super middleweight",47,"right-handed",30,10,0,40,0.75
14,"middleweight",34,"right-handed",6,0,1,7,0.928571429
14,"welterweight",27,"right-handed",5,8,0,13,0.384615385
14,"welterweight",25,"right-handed",5,0,0,5,1
14,"featherweight",31,"right-handed",20,7,0,27,0.740740741
14,"super lightweight",28,"right-handed",9,5,0,14,0.642857143
14,"super flyweight",22,"right-handed",12,4,0,16,0.75
14,"middleweight",34,"right-handed",6,14,2,22,0.318181818
14,"light flyweight",25,"right-handed",13,8,2,23,0.608695652
14,"lightweight",29,"right-handed",11,10,4,25,0.52
14,"flyweight",29,"right-handed",10,1,1,12,0.875
14,"lightweight",29,"right-handed",5,0,0,5,1
14,"lightweight",29,"right-handed",5,2,1,8,0.6875
14,"light heavyweight",28,"right-handed",6,0,0,6,1
14,"featherweight",26,"right-handed",6,0,0,6,1
14,"middleweight",24,"right-handed",15,3,0,18,0.833333333
14,"middleweight",20,"right-handed",6,0,0,6,1
14,"flyweight",32,"right-handed",6,2,2,10,0.7
14,"light heavyweight",25,"right-handed",5,0,1,6,0.916666667
14,"bantamweight",24,"right-handed",7,5,0,12,0.583333333
14,"flyweight",30,"right-handed",24,4,0,28,0.857142857
14,"lightweight",27,"right-handed",9,1,0,10,0.9
14,"middleweight",27,"right-handed",6,0,0,6,1
14,"welterweight",25,"right-handed",3,4,1,8,0.4375
14,"welterweight",28,"right-handed",16,3,1,20,0.825
14,"heavyweight",33,"right-handed",17,6,0,23,0.739130435
14,"heavyweight",30,"right-handed",16,4,0,20,0.8
14,"light flyweight",23,"right-handed",12,2,0,14,0.857142857
13,"light heavyweight",24,"right-handed",7,0,0,7,1
13,"super flyweight",19,"right-handed",11,0,0,11,1
13,"welterweight",31,"right-handed",9,5,1,15,0.633333333
13,"cruiserweight",29,"right-handed",6,0,0,6,1
13,"super lightweight",20,"right-handed",6,0,0,6,1
13,"welterweight",25,"right-handed",7,1,0,8,0.875
13,"light flyweight",19,"right-handed",12,0,1,13,0.961538462
13,"super middleweight",38,"right-handed",23,21,4,48,0.520833333
13,"super welterweight",32,"right-handed",7,5,0,12,0.583333333
13,"welterweight",32,"right-handed",24,3,1,28,0.875
13,"super lightweight",22,"right-handed",6,0,0,6,1
13,"cruiserweight",40,"right-handed",39,19,0,58,0.672413793
13,"lightweight",31,"right-handed",15,10,0,25,0.6
13,"welterweight",35,"right-handed",32,5,2,39,0.846153846
13,"light flyweight",27,"right-handed",9,16,1,26,0.365384615
14,"super welterweight",25,"right-handed",5,2,0,7,0.714285714
14,"super lightweight",30,"right-handed",12,1,1,14,0.892857143
14,"light heavyweight",29,"right-handed",7,0,0,7,1
14,"featherweight",27,"right-handed",6,0,0,6,1
14,"super lightweight",25,"right-handed",10,0,0,10,1
14,"super welterweight",26,"right-handed",9,9,2,20,0.5
14,"middleweight",24,"right-handed",9,15,1,25,0.38
14,"super flyweight",20,"right-handed",6,0,0,6,1
14,"bantamweight",24,"right-handed",5,0,0,5,1
14,"super featherweight",29,"right-handed",17,11,1,29,0.603448276
14,"heavyweight",34,"right-handed",10,0,0,10,1
14,"super welterweight",27,"right-handed",4,1,1,6,0.75
14,"featherweight",22,"right-handed",7,0,2,9,0.888888889
14,"super welterweight",33,"right-handed",17,2,0,19,0.894736842
14,"featherweight",30,"right-handed",14,7,2,23,0.652173913
14,"middleweight",37,"right-handed",27,9,0,36,0.75
14,"featherweight",29,"right-handed",12,11,1,24,0.520833333
14,"featherweight",32,"right-handed",13,9,7,29,0.568965517
14,"lightweight",40,"right-handed",12,7,2,21,0.619047619
14,"welterweight",24,"right-handed",6,1,0,7,0.857142857
14,"cruiserweight",NA,"right-handed",15,2,1,18,0.861111111
14,"heavyweight",33,"right-handed",29,7,0,36,0.805555556
14,"lightweight",31,"right-handed",9,10,2,21,0.476190476
14,"super featherweight",31,"right-handed",11,4,1,16,0.71875
14,"welterweight",35,"right-handed",7,0,1,8,0.9375
14,"lightweight",30,"right-handed",8,2,3,13,0.730769231
14,"lightweight",25,"right-handed",7,0,0,7,1
14,"cruiserweight",33,"right-handed",12,1,0,13,0.923076923
14,"middleweight",32,"right-handed",12,2,3,17,0.794117647
14,"welterweight",27,"right-handed",28,13,0,41,0.682926829
14,"super featherweight",23,"right-handed",9,1,0,10,0.9
14,"light heavyweight",41,"right-handed",96,4,0,100,0.96
14,"super bantamweight",35,"right-handed",25,17,1,43,0.593023256
14,"super welterweight",25,"right-handed",8,1,0,9,0.888888889
14,"heavyweight",41,"right-handed",18,21,0,39,0.461538462
14,"super welterweight",26,"right-handed",6,0,0,6,1
14,"minimumweight",29,"right-handed",6,4,1,11,0.590909091
14,"super bantamweight",26,"right-handed",8,1,0,9,0.888888889
14,"cruiserweight",26,"right-handed",11,3,0,14,0.785714286
14,"welterweight",28,"right-handed",5,0,0,5,1
14,"super welterweight",22,"right-handed",7,0,0,7,1
14,"light heavyweight",33,"right-handed",13,0,0,13,1
14,"middleweight",30,"right-handed",12,2,1,15,0.833333333
14,"featherweight",26,"right-handed",14,9,1,24,0.604166667
14,"lightweight",27,"right-handed",5,0,0,5,1
14,"bantamweight",22,"right-handed",8,1,1,10,0.85
14,"featherweight",25,"right-handed",8,0,1,9,0.944444444
14,"super lightweight",25,"right-handed",13,3,0,16,0.8125
14,"super middleweight",27,"right-handed",6,0,0,6,1
14,"featherweight",28,"right-handed",12,17,1,30,0.416666667
14,"super welterweight",39,"right-handed",11,2,0,13,0.846153846
14,"super welterweight",NA,"right-handed",7,0,0,7,1
14,"featherweight",NA,"right-handed",10,1,0,11,0.909090909
14,"flyweight",26,"right-handed",10,1,0,11,0.909090909
14,"super lightweight",27,"right-handed",5,1,0,6,0.833333333
14,"light heavyweight",36,"right-handed",5,11,2,18,0.333333333
14,"middleweight",25,"right-handed",5,0,1,6,0.916666667
14,"super bantamweight",26,"right-handed",9,1,0,10,0.9
14,"welterweight",24,"right-handed",6,0,0,6,1
14,"super featherweight",29,"right-handed",4,1,2,7,0.714285714
14,"super lightweight",31,"right-handed",6,0,0,6,1
14,"light heavyweight",31,"right-handed",10,11,0,21,0.476190476
14,"lightweight",35,"right-handed",15,4,0,19,0.789473684
14,"cruiserweight",37,"right-handed",7,4,0,11,0.636363636
14,"super featherweight",34,"right-handed",6,1,0,7,0.857142857
14,"welterweight",32,"right-handed",6,6,3,15,0.5
14,"super middleweight",29,"right-handed",27,21,3,51,0.558823529
14,"lightweight",30,"right-handed",11,2,0,13,0.846153846
14,"heavyweight",25,"right-handed",8,2,0,10,0.8
14,"featherweight",30,"right-handed",14,4,1,19,0.763157895
14,"welterweight",24,"right-handed",13,7,0,20,0.65
14,"super bantamweight",24,"right-handed",23,6,0,29,0.793103448
14,"light heavyweight",36,"right-handed",7,4,0,11,0.636363636
14,"lightweight",31,"right-handed",11,2,2,15,0.8
14,"super bantamweight",35,"right-handed",8,20,1,29,0.293103448
14,"welterweight",22,"right-handed",8,0,0,8,1
14,"super middleweight",NA,"right-handed",8,0,1,9,0.944444444
14,"featherweight",18,"right-handed",10,4,0,14,0.714285714
14,"super lightweight",29,"right-handed",22,6,1,29,0.775862069
14,"minimumweight",23,"right-handed",9,5,0,14,0.642857143
14,"super lightweight",25,"right-handed",3,0,3,6,0.75
14,"light heavyweight",26,"right-handed",10,6,0,16,0.625
14,"heavyweight",28,"right-handed",6,3,2,11,0.636363636
14,"super flyweight",29,"right-handed",23,15,1,39,0.602564103
14,"lightweight",43,"right-handed",32,17,3,52,0.644230769
14,"lightweight",24,"right-handed",10,1,1,12,0.875
14,"welterweight",29,"right-handed",10,8,3,21,0.547619048
14,"welterweight",23,"right-handed",12,1,1,14,0.892857143
14,"light flyweight",23,"right-handed",14,0,1,15,0.966666667
14,"super welterweight",31,"right-handed",6,0,0,6,1
14,"bantamweight",NA,"right-handed",9,0,1,10,0.95
14,"super featherweight",26,"right-handed",17,7,0,24,0.708333333
14,"super lightweight",34,"right-handed",15,5,2,22,0.727272727
14,"featherweight",26,"right-handed",8,0,0,8,1
14,"light flyweight",23,"right-handed",6,2,1,9,0.722222222
14,"light flyweight",21,"right-handed",6,0,0,6,1
14,"super flyweight",33,"right-handed",15,1,1,17,0.911764706
14,"middleweight",23,"right-handed",7,0,0,7,1
14,"featherweight",23,"right-handed",6,2,0,8,0.75
14,"lightweight",31,"right-handed",12,10,2,24,0.541666667
15,"super featherweight",21,"right-handed",4,1,1,6,0.75
15,"featherweight",25,"right-handed",11,5,1,17,0.676470588
15,"super lightweight",31,"right-handed",7,2,2,11,0.727272727
15,"welterweight",30,"right-handed",16,15,3,34,0.514705882
15,"lightweight",22,"right-handed",9,0,0,9,1
15,"super featherweight",23,"right-handed",8,0,1,9,0.944444444
15,"super lightweight",38,"right-handed",8,4,1,13,0.653846154
15,"featherweight",31,"right-handed",10,4,0,14,0.714285714
15,"heavyweight",27,"right-handed",8,0,0,8,1
15,"cruiserweight",24,"right-handed",7,0,0,7,1
15,"cruiserweight",29,"right-handed",13,2,1,16,0.84375
15,"welterweight",30,"right-handed",10,4,2,16,0.6875
15,"super middleweight",25,"right-handed",6,0,0,6,1
15,"light flyweight",32,"right-handed",11,4,2,17,0.705882353
15,"super welterweight",37,"right-handed",21,8,2,31,0.709677419
15,"super welterweight",27,"right-handed",8,2,1,11,0.772727273
15,"super lightweight",28,"right-handed",13,1,0,14,0.928571429
15,"super bantamweight",29,"right-handed",12,1,0,13,0.923076923
15,"heavyweight",34,"right-handed",14,3,1,18,0.805555556
15,"super bantamweight",30,"right-handed",13,4,1,18,0.75
15,"welterweight",22,"right-handed",4,0,0,4,1
15,"super featherweight",24,"right-handed",8,0,0,8,1
15,"bantamweight",NA,"right-handed",8,1,0,9,0.888888889
15,"featherweight",27,"right-handed",23,11,1,35,0.671428571
15,"super lightweight",23,"right-handed",6,3,0,9,0.666666667
15,"heavyweight",35,"right-handed",15,0,0,15,1
15,"super flyweight",25,"right-handed",7,2,0,9,0.777777778
14,"super flyweight",24,"right-handed",7,0,0,7,1
14,"cruiserweight",32,"right-handed",8,2,1,11,0.772727273
14,"super welterweight",27,"right-handed",6,3,0,9,0.666666667
14,"bantamweight",27,"right-handed",13,9,1,23,0.586956522
14,"super lightweight",24,"right-handed",8,2,1,11,0.772727273
14,"super lightweight",22,"right-handed",8,3,0,11,0.727272727
14,"middleweight",22,"right-handed",7,0,0,7,1
14,"super welterweight",25,"right-handed",6,0,0,6,1
14,"middleweight",33,"right-handed",16,5,1,22,0.75
14,"featherweight",32,"right-handed",31,11,3,45,0.722222222
14,"super lightweight",NA,"right-handed",9,5,3,17,0.617647059
14,"super featherweight",NA,"right-handed",6,1,1,8,0.8125
14,"light heavyweight",36,"right-handed",9,0,0,9,1
14,"welterweight",26,"right-handed",16,6,1,23,0.717391304
14,"super lightweight",21,"right-handed",8,0,0,8,1
14,"super flyweight",25,"right-handed",5,0,0,5,1
14,"middleweight",29,"right-handed",9,0,0,9,1
14,"super middleweight",20,"right-handed",8,0,0,8,1
14,"welterweight",23,"right-handed",10,1,0,11,0.909090909
14,"heavyweight",41,"right-handed",19,2,0,21,0.904761905
14,"lightweight",31,"right-handed",6,0,0,6,1
14,"bantamweight",NA,"right-handed",17,3,0,20,0.85
14,"middleweight",22,"right-handed",17,5,2,24,0.75
15,"welterweight",22,"right-handed",1,0,0,1,1
15,"super middleweight",27,"right-handed",20,2,0,22,0.909090909
15,"heavyweight",31,"right-handed",3,0,0,3,1
15,"super featherweight",21,"right-handed",7,1,0,8,0.875
15,"lightweight",25,"right-handed",4,1,0,5,0.8
15,"middleweight",28,"right-handed",12,3,0,15,0.8
15,"welterweight",30,"right-handed",8,3,0,11,0.727272727
15,"super welterweight",34,"right-handed",15,4,1,20,0.775
15,"light flyweight",21,"right-handed",6,2,1,9,0.722222222
15,"super middleweight",30,"right-handed",7,3,1,11,0.681818182
15,"super welterweight",23,"right-handed",8,0,0,8,1
15,"cruiserweight",21,"right-handed",9,3,0,12,0.75
15,"featherweight",23,"right-handed",9,1,0,10,0.9
15,"middleweight",26,"right-handed",11,5,0,16,0.6875
15,"featherweight",27,"right-handed",13,1,1,15,0.9
15,"lightweight",33,"right-handed",16,1,1,18,0.916666667
15,"super middleweight",26,"right-handed",8,0,0,8,1
15,"super lightweight",25,"right-handed",8,1,1,10,0.85
15,"heavyweight",32,"right-handed",9,3,4,16,0.6875
15,"super bantamweight",25,"right-handed",8,0,0,8,1
15,"bantamweight",20,"right-handed",19,1,0,20,0.95
15,"super middleweight",32,"right-handed",23,17,0,40,0.575
15,"super bantamweight",30,"right-handed",10,1,0,11,0.909090909
15,"super flyweight",31,"right-handed",14,23,2,39,0.384615385
15,"super bantamweight",37,"right-handed",25,9,2,36,0.722222222
15,"middleweight",34,"right-handed",13,4,0,17,0.764705882
15,"bantamweight",38,"right-handed",14,9,2,25,0.6
15,"super bantamweight",23,"right-handed",14,3,0,17,0.823529412
15,"super welterweight",41,"right-handed",30,4,0,34,0.882352941
15,"super featherweight",29,"right-handed",10,1,0,11,0.909090909
15,"welterweight",35,"right-handed",31,15,0,46,0.673913043
15,"light heavyweight",37,"right-handed",13,5,1,19,0.710526316
15,"super lightweight",28,"right-handed",10,2,4,16,0.75
15,"featherweight",35,"right-handed",10,2,0,12,0.833333333
15,"lightweight",19,"right-handed",5,1,0,6,0.833333333
15,"super featherweight",23,"right-handed",11,4,0,15,0.733333333
15,"featherweight",39,"right-handed",17,4,1,22,0.795454545
15,"super flyweight",22,"right-handed",9,2,1,12,0.791666667
15,"light heavyweight",33,"right-handed",9,1,0,10,0.9
15,"heavyweight",38,"right-handed",23,3,0,26,0.884615385
15,"heavyweight",53,"right-handed",58,14,0,72,0.805555556
15,"featherweight",33,"right-handed",5,1,0,6,0.833333333
15,"super middleweight",26,"right-handed",8,4,0,12,0.666666667
15,"welterweight",29,"right-handed",13,2,1,16,0.84375
15,"super middleweight",27,"right-handed",8,0,0,8,1
15,"heavyweight",28,"right-handed",5,0,0,5,1
15,"lightweight",25,"right-handed",4,0,1,5,0.9
15,"middleweight",25,"right-handed",9,0,0,9,1
15,"super featherweight",23,"right-handed",9,0,0,9,1
15,"minimumweight",28,"right-handed",17,6,0,23,0.739130435
15,"minimumweight",39,"right-handed",29,6,2,37,0.810810811
15,"super middleweight",NA,"right-handed",6,0,0,6,1
15,"heavyweight",36,"right-handed",20,5,0,25,0.8
15,"super lightweight",31,"right-handed",6,3,1,10,0.65
15,"welterweight",34,"right-handed",10,7,1,18,0.583333333
15,"super featherweight",31,"right-handed",12,8,0,20,0.6
15,"welterweight",27,"right-handed",7,0,0,7,1
15,"cruiserweight",34,"right-handed",11,0,0,11,1
15,"super bantamweight",21,"right-handed",15,7,2,24,0.666666667
15,"middleweight",32,"right-handed",28,12,4,44,0.681818182
15,"super middleweight",35,"right-handed",28,14,2,44,0.659090909
15,"welterweight",23,"right-handed",7,0,1,8,0.9375
15,"super featherweight",28,"right-handed",17,14,1,32,0.546875
15,"welterweight",27,"right-handed",22,2,0,24,0.916666667
15,"super middleweight",41,"right-handed",20,16,1,37,0.554054054
15,"super welterweight",33,"right-handed",8,1,0,9,0.888888889
15,"light heavyweight",37,"right-handed",9,13,2,24,0.416666667
15,"super welterweight",28,"right-handed",6,4,5,15,0.566666667
15,"super lightweight",19,"right-handed",10,1,1,12,0.875
15,"super lightweight",33,"right-handed",27,9,1,37,0.743243243
15,"featherweight",31,"right-handed",11,12,1,24,0.479166667
15,"heavyweight",45,"right-handed",15,12,2,29,0.551724138
15,"heavyweight",32,"right-handed",9,4,0,13,0.692307692
15,"super bantamweight",26,"right-handed",8,0,0,8,1
15,"super lightweight",30,"right-handed",39,11,1,51,0.774509804
15,"super lightweight",30,"right-handed",8,8,1,17,0.5
15,"bantamweight",27,"right-handed",10,3,4,17,0.705882353
15,"welterweight",31,"right-handed",9,23,4,36,0.305555556
15,"welterweight",20,"right-handed",11,1,1,13,0.884615385
15,"super welterweight",25,"right-handed",12,0,0,12,1
15,"cruiserweight",31,"right-handed",5,1,1,7,0.785714286
15,"lightweight",32,"right-handed",11,1,0,12,0.916666667
15,"super bantamweight",22,"right-handed",6,0,0,6,1
15,"welterweight",30,"right-handed",14,7,2,23,0.652173913
15,"lightweight",25,"right-handed",6,1,1,8,0.8125
15,"super welterweight",27,"right-handed",9,1,1,11,0.863636364
15,"cruiserweight",34,"right-handed",10,11,2,23,0.47826087
15,"super welterweight",33,"right-handed",39,4,0,43,0.906976744
15,"super lightweight",25,"right-handed",13,6,0,19,0.684210526
15,"bantamweight",21,"right-handed",7,1,1,9,0.833333333
15,"bantamweight",30,"right-handed",18,5,1,24,0.770833333
15,"super welterweight",40,"right-handed",30,18,2,50,0.62
15,"super welterweight",26,"right-handed",11,1,2,14,0.857142857
15,"lightweight",26,"right-handed",11,4,1,16,0.71875
15,"lightweight",31,"right-handed",10,1,0,11,0.909090909
15,"lightweight",23,"right-handed",8,3,0,11,0.727272727
15,"middleweight",28,"right-handed",10,0,0,10,1
15,"cruiserweight",34,"right-handed",6,3,0,9,0.666666667
15,"featherweight",41,"right-handed",38,9,0,47,0.808510638
15,"middleweight",20,"right-handed",6,0,0,6,1
16,"super welterweight",38,"right-handed",21,4,2,27,0.814814815
16,"light heavyweight",24,"right-handed",8,1,0,9,0.888888889
16,"super featherweight",33,"right-handed",12,0,2,14,0.928571429
16,"welterweight",25,"right-handed",13,0,1,14,0.964285714
16,"lightweight",27,"right-handed",19,13,2,34,0.588235294
16,"lightweight",28,"right-handed",8,0,0,8,1
16,"super lightweight",22,"right-handed",8,1,0,9,0.888888889
16,"bantamweight",26,"right-handed",13,2,1,16,0.84375
16,"super welterweight",27,"right-handed",9,2,0,11,0.818181818
16,"lightweight",31,"right-handed",14,5,0,19,0.736842105
16,"lightweight",33,"right-handed",9,5,1,15,0.633333333
16,"lightweight",32,"right-handed",27,14,2,43,0.651162791
16,"super featherweight",24,"right-handed",6,0,0,6,1
16,"super lightweight",26,"right-handed",9,7,2,18,0.555555556
16,"heavyweight",35,"right-handed",9,7,4,20,0.55
16,"bantamweight",27,"right-handed",17,17,1,35,0.5
16,"super lightweight",31,"right-handed",15,11,3,29,0.568965517
16,"middleweight",27,"right-handed",11,4,1,16,0.71875
16,"super welterweight",24,"right-handed",12,1,0,13,0.923076923
16,"light flyweight",30,"right-handed",8,4,5,17,0.617647059
16,"super featherweight",23,"right-handed",9,5,0,14,0.642857143
16,"super featherweight",31,"right-handed",10,10,0,20,0.5
15,"middleweight",39,"right-handed",24,2,0,26,0.923076923
15,"super welterweight",24,"right-handed",15,2,2,19,0.842105263
15,"super middleweight",34,"right-handed",23,11,0,34,0.676470588
15,"light flyweight",32,"right-handed",7,0,1,8,0.9375
15,"cruiserweight",NA,"right-handed",7,0,0,7,1
15,"featherweight",24,"right-handed",8,0,0,8,1
15,"flyweight",24,"right-handed",5,2,2,9,0.666666667
15,"super middleweight",27,"right-handed",9,0,0,9,1
15,"super welterweight",26,"right-handed",8,0,0,8,1
15,"lightweight",27,"right-handed",9,0,1,10,0.95
15,"middleweight",25,"right-handed",13,16,2,31,0.451612903
15,"middleweight",39,"right-handed",16,4,1,21,0.785714286
15,"super middleweight",31,"right-handed",16,4,1,21,0.785714286
15,"featherweight",31,"right-handed",13,7,0,20,0.65
15,"welterweight",34,"right-handed",21,30,1,52,0.413461538
15,"lightweight",25,"right-handed",11,2,0,13,0.846153846
15,"middleweight",31,"right-handed",12,7,0,19,0.631578947
15,"super lightweight",33,"right-handed",8,2,2,12,0.75
15,"welterweight",28,"right-handed",10,1,1,12,0.875
15,"bantamweight",28,"right-handed",20,12,3,35,0.614285714
15,"middleweight",25,"right-handed",10,1,0,11,0.909090909
15,"featherweight",24,"right-handed",7,3,1,11,0.681818182
15,"cruiserweight",36,"right-handed",18,15,1,34,0.544117647
15,"featherweight",23,"right-handed",3,0,0,3,1
15,"welterweight",36,"right-handed",23,7,1,31,0.758064516
15,"featherweight",20,"right-handed",17,0,1,18,0.972222222
15,"cruiserweight",29,"right-handed",7,0,0,7,1
15,"welterweight",36,"right-handed",22,4,0,26,0.846153846
16,"super lightweight",23,"right-handed",13,0,0,13,1
16,"super welterweight",29,"right-handed",16,3,1,20,0.825
16,"welterweight",25,"right-handed",9,1,0,10,0.9
16,"welterweight",28,"right-handed",22,3,2,27,0.851851852
16,"super middleweight",40,"right-handed",32,3,0,35,0.914285714
16,"middleweight",27,"right-handed",9,2,0,11,0.818181818
16,"light heavyweight",29,"right-handed",14,7,2,23,0.652173913
16,"super flyweight",28,"right-handed",9,7,3,19,0.552631579
16,"super welterweight",24,"right-handed",11,0,1,12,0.958333333
16,"super welterweight",29,"right-handed",8,0,1,9,0.944444444
16,"cruiserweight",36,"right-handed",9,6,0,15,0.6
16,"cruiserweight",28,"right-handed",9,0,0,9,1
16,"welterweight",24,"right-handed",10,2,0,12,0.833333333
16,"heavyweight",28,"right-handed",8,0,0,8,1
16,"heavyweight",30,"right-handed",10,0,0,10,1
16,"super welterweight",38,"right-handed",17,4,2,23,0.782608696
16,"super middleweight",33,"right-handed",12,3,0,15,0.8
16,"super bantamweight",45,"right-handed",32,14,3,49,0.683673469
16,"bantamweight",19,"right-handed",6,0,0,6,1
16,"cruiserweight",42,"right-handed",19,4,0,23,0.826086957
16,"middleweight",37,"right-handed",10,1,0,11,0.909090909
16,"super welterweight",26,"right-handed",12,2,1,15,0.833333333
16,"lightweight",37,"right-handed",24,6,1,31,0.790322581
16,"featherweight",27,"right-handed",10,1,1,12,0.875
16,"welterweight",28,"right-handed",10,1,0,11,0.909090909
16,"lightweight",33,"right-handed",24,5,2,31,0.806451613
16,"bantamweight",32,"right-handed",8,4,1,13,0.653846154
16,"lightweight",26,"right-handed",6,4,1,11,0.590909091
16,"bantamweight",29,"right-handed",11,7,1,19,0.605263158
16,"light flyweight",30,"right-handed",23,16,5,44,0.579545455
16,"minimumweight",19,"right-handed",8,0,0,8,1
16,"super lightweight",26,"right-handed",14,4,2,20,0.75
16,"lightweight",34,"right-handed",15,5,1,21,0.738095238
16,"heavyweight",32,"right-handed",26,4,0,30,0.866666667
16,"lightweight",30,"right-handed",30,16,0,46,0.652173913
16,"super flyweight",25,"right-handed",10,3,2,15,0.733333333
16,"super welterweight",32,"right-handed",10,3,0,13,0.769230769
16,"featherweight",29,"right-handed",13,12,3,28,0.517857143
16,"middleweight",21,"right-handed",8,3,1,12,0.708333333
16,"light heavyweight",28,"right-handed",24,6,2,32,0.78125
16,"super bantamweight",26,"right-handed",6,0,0,6,1
16,"lightweight",31,"right-handed",15,15,4,34,0.5
16,"super middleweight",28,"right-handed",7,1,1,9,0.833333333
16,"bantamweight",28,"right-handed",10,0,0,10,1
16,"super featherweight",31,"right-handed",8,1,0,9,0.888888889
16,"lightweight",37,"right-handed",31,12,2,45,0.711111111
16,"heavyweight",25,"right-handed",12,3,0,15,0.8
16,"super welterweight",43,"right-handed",20,12,1,33,0.621212121
16,"bantamweight",33,"right-handed",21,6,4,31,0.741935484
16,"lightweight",30,"right-handed",22,9,0,31,0.709677419
16,"flyweight",23,"right-handed",13,1,0,14,0.928571429
16,"super welterweight",34,"right-handed",12,3,0,15,0.8
16,"bantamweight",32,"right-handed",11,14,5,30,0.45
16,"super welterweight",24,"right-handed",16,4,2,22,0.772727273
16,"super welterweight",22,"right-handed",7,0,0,7,1
16,"super lightweight",NA,"right-handed",6,0,0,6,1
16,"middleweight",20,"right-handed",8,0,0,8,1
16,"cruiserweight",30,"right-handed",8,1,0,9,0.888888889
16,"cruiserweight",32,"right-handed",10,17,3,30,0.383333333
16,"welterweight",24,"right-handed",7,0,0,7,1
16,"welterweight",26,"right-handed",10,2,0,12,0.833333333
16,"cruiserweight",33,"right-handed",13,2,1,16,0.84375
16,"super lightweight",26,"right-handed",9,1,0,10,0.9
16,"super lightweight",23,"right-handed",7,0,0,7,1
16,"super bantamweight",28,"right-handed",14,3,1,18,0.805555556
16,"cruiserweight",39,"right-handed",7,2,0,9,0.777777778
16,"light heavyweight",23,"right-handed",8,0,0,8,1
16,"super bantamweight",30,"right-handed",28,25,1,54,0.527777778
16,"super lightweight",23,"right-handed",6,4,2,12,0.583333333
16,"welterweight",29,"right-handed",10,3,1,14,0.75
16,"super middleweight",37,"right-handed",33,16,1,50,0.67
16,"super middleweight",23,"right-handed",8,0,0,8,1
16,"super featherweight",29,"right-handed",22,9,4,35,0.685714286
16,"lightweight",23,"right-handed",6,0,2,8,0.875
16,"welterweight",26,"right-handed",8,0,0,8,1
16,"lightweight",26,"right-handed",10,2,2,14,0.785714286
16,"super lightweight",30,"right-handed",19,5,0,24,0.791666667
16,"super featherweight",29,"right-handed",23,11,1,35,0.671428571
16,"cruiserweight",36,"right-handed",24,15,0,39,0.615384615
16,"super welterweight",28,"right-handed",12,2,0,14,0.857142857
16,"super bantamweight",18,"right-handed",13,0,0,13,1
16,"super lightweight",29,"right-handed",11,4,0,15,0.733333333
16,"super featherweight",36,"right-handed",20,16,2,38,0.552631579
16,"super bantamweight",22,"right-handed",9,2,0,11,0.818181818
16,"super featherweight",29,"right-handed",19,1,1,21,0.928571429
16,"super lightweight",24,"right-handed",7,0,2,9,0.888888889
16,"light heavyweight",32,"right-handed",8,2,1,11,0.772727273
16,"super featherweight",20,"right-handed",8,1,0,9,0.888888889
16,"middleweight",37,"right-handed",30,5,0,35,0.857142857
16,"super lightweight",24,"right-handed",7,1,0,8,0.875
16,"super featherweight",33,"right-handed",23,20,2,45,0.533333333
16,"middleweight",29,"right-handed",14,7,1,22,0.659090909
16,"super middleweight",26,"right-handed",11,1,2,14,0.857142857
16,"featherweight",33,"right-handed",29,7,0,36,0.805555556
16,"middleweight",30,"right-handed",22,32,3,57,0.412280702
16,"featherweight",26,"right-handed",11,3,0,14,0.785714286
16,"super middleweight",29,"right-handed",13,6,1,20,0.675
16,"heavyweight",38,"right-handed",29,6,0,35,0.828571429
16,"welterweight",36,"right-handed",24,7,1,32,0.765625
16,"featherweight",25,"right-handed",7,2,1,10,0.75
17,"light heavyweight",37,"right-handed",23,7,0,30,0.766666667
17,"super featherweight",27,"right-handed",11,10,0,21,0.523809524
17,"super bantamweight",22,"right-handed",6,2,4,12,0.666666667
17,"super middleweight",36,"right-handed",32,6,0,38,0.842105263
17,"featherweight",35,"right-handed",21,11,1,33,0.651515152
17,"super bantamweight",39,"right-handed",40,8,0,48,0.833333333
17,"bantamweight",25,"right-handed",10,5,0,15,0.666666667
17,"super welterweight",29,"right-handed",10,1,0,11,0.909090909
17,"bantamweight",35,"right-handed",15,10,2,27,0.592592593
17,"super bantamweight",33,"right-handed",21,1,0,22,0.954545455
17,"bantamweight",35,"right-handed",26,6,0,32,0.8125
17,"flyweight",23,"right-handed",9,8,0,17,0.529411765
17,"lightweight",23,"right-handed",11,19,0,30,0.366666667
17,"bantamweight",27,"right-handed",7,1,0,8,0.875
17,"light heavyweight",30,"right-handed",12,2,1,15,0.833333333
17,"heavyweight",26,"right-handed",10,0,0,10,1
17,"super lightweight",24,"right-handed",7,4,1,12,0.625
17,"super featherweight",32,"right-handed",23,9,2,34,0.705882353
17,"featherweight",24,"right-handed",18,0,0,18,1
17,"welterweight",27,"right-handed",9,1,0,10,0.9
17,"heavyweight",31,"right-handed",16,4,0,20,0.8
17,"welterweight",25,"right-handed",7,1,0,8,0.875
17,"light heavyweight",30,"right-handed",18,4,0,22,0.818181818
17,"heavyweight",24,"right-handed",9,0,1,10,0.95
17,"super bantamweight",29,"right-handed",21,4,1,26,0.826923077
17,"super lightweight",28,"right-handed",7,4,0,11,0.636363636
17,"super welterweight",23,"right-handed",8,0,0,8,1
17,"super welterweight",32,"right-handed",14,2,0,16,0.875
16,"cruiserweight",30,"right-handed",25,1,1,27,0.944444444
16,"lightweight",26,"right-handed",17,2,0,19,0.894736842
16,"super flyweight",26,"right-handed",11,5,2,18,0.666666667
16,"cruiserweight",30,"right-handed",10,0,0,10,1
16,"super bantamweight",28,"right-handed",14,2,0,16,0.875
16,"cruiserweight",26,"right-handed",7,1,0,8,0.875
16,"lightweight",21,"right-handed",5,1,1,7,0.785714286
16,"heavyweight",28,"right-handed",17,1,1,19,0.921052632
16,"middleweight",29,"right-handed",10,1,1,12,0.875
16,"cruiserweight",31,"right-handed",8,1,0,9,0.888888889
16,"super lightweight",25,"right-handed",5,3,1,9,0.611111111
16,"flyweight",30,"right-handed",10,10,0,20,0.5
16,"super featherweight",21,"right-handed",8,2,2,12,0.75
16,"middleweight",24,"right-handed",9,1,0,10,0.9
16,"super lightweight",28,"right-handed",13,6,2,21,0.666666667
16,"cruiserweight",35,"right-handed",25,10,0,35,0.714285714
16,"super lightweight",28,"right-handed",16,1,0,17,0.941176471
16,"super welterweight",26,"right-handed",10,3,2,15,0.733333333
16,"super featherweight",20,"right-handed",9,4,0,13,0.692307692
16,"super lightweight",21,"right-handed",7,0,0,7,1
16,"cruiserweight",35,"right-handed",21,4,0,25,0.84
16,"super bantamweight",27,"right-handed",13,48,5,66,0.234848485
17,"super lightweight",25,"right-handed",14,1,0,15,0.933333333
17,"welterweight",NA,"right-handed",6,1,0,7,0.857142857
17,"super featherweight",24,"right-handed",13,4,0,17,0.764705882
17,"welterweight",34,"right-handed",13,7,1,21,0.642857143
17,"super featherweight",23,"right-handed",22,2,1,25,0.9
17,"featherweight",41,"right-handed",22,19,5,46,0.532608696
17,"super middleweight",24,"right-handed",10,0,0,10,1
17,"super featherweight",31,"right-handed",28,6,0,34,0.823529412
17,"bantamweight",21,"right-handed",8,5,0,13,0.615384615
17,"super flyweight",26,"right-handed",15,12,2,29,0.551724138
17,"super lightweight",22,"right-handed",6,0,1,7,0.928571429
17,"middleweight",25,"right-handed",18,3,0,21,0.857142857
17,"super middleweight",39,"right-handed",22,15,4,41,0.585365854
17,"super lightweight",23,"right-handed",8,0,0,8,1
17,"bantamweight",30,"right-handed",9,6,2,17,0.588235294
17,"super bantamweight",34,"right-handed",7,5,1,13,0.576923077
17,"middleweight",26,"right-handed",6,1,0,7,0.857142857
17,"heavyweight",29,"right-handed",9,0,1,10,0.95
17,"middleweight",28,"right-handed",10,6,0,16,0.625
17,"middleweight",38,"right-handed",30,28,2,60,0.516666667
17,"middleweight",41,"right-handed",50,20,2,72,0.708333333
17,"super middleweight",29,"right-handed",10,3,0,13,0.769230769
17,"super middleweight",27,"right-handed",8,1,1,10,0.85
17,"super welterweight",29,"right-handed",5,1,1,7,0.785714286
17,"welterweight",32,"right-handed",16,9,2,27,0.62962963
17,"super flyweight",22,"right-handed",10,0,0,10,1
17,"lightweight",23,"right-handed",13,4,1,18,0.75
17,"featherweight",26,"right-handed",6,5,1,12,0.541666667
17,"welterweight",24,"right-handed",8,0,0,8,1
17,"super middleweight",31,"right-handed",13,2,1,16,0.84375
17,"super lightweight",34,"right-handed",31,9,0,40,0.775
17,"featherweight",23,"right-handed",10,0,0,10,1
17,"super flyweight",29,"right-handed",11,6,2,19,0.631578947
17,"super featherweight",20,"right-handed",7,0,0,7,1
17,"middleweight",33,"right-handed",10,0,1,11,0.954545455
17,"flyweight",29,"right-handed",12,5,3,20,0.675
17,"welterweight",25,"right-handed",10,2,1,13,0.807692308
17,"welterweight",27,"right-handed",8,2,1,11,0.772727273
17,"super lightweight",22,"right-handed",9,0,0,9,1
17,"super featherweight",25,"right-handed",13,7,3,23,0.630434783
17,"bantamweight",28,"right-handed",12,2,0,14,0.857142857
17,"light heavyweight",37,"right-handed",18,1,0,19,0.947368421
17,"cruiserweight",29,"right-handed",7,0,0,7,1
17,"heavyweight",33,"right-handed",15,2,0,17,0.882352941
17,"super welterweight",36,"right-handed",25,5,0,30,0.833333333
17,"super flyweight",NA,"right-handed",16,4,0,20,0.8
17,"super flyweight",24,"right-handed",4,0,0,4,1
17,"welterweight",23,"right-handed",5,0,0,5,1
17,"welterweight",23,"right-handed",9,0,0,9,1
17,"light heavyweight",NA,"right-handed",8,2,0,10,0.8
18,"middleweight",34,"right-handed",26,9,0,35,0.742857143
17,"super featherweight",24,"right-handed",7,0,1,8,0.9375
17,"super bantamweight",30,"right-handed",4,0,0,4,1
17,"middleweight",23,"right-handed",6,1,0,7,0.857142857
17,"super middleweight",31,"right-handed",6,0,0,6,1
17,"cruiserweight",NA,"right-handed",9,0,1,10,0.95
17,"featherweight",27,"right-handed",17,6,2,25,0.72
17,"super middleweight",37,"right-handed",24,10,1,35,0.7
17,"heavyweight",31,"right-handed",13,1,0,14,0.928571429
17,"super lightweight",29,"right-handed",11,1,0,12,0.916666667
17,"super welterweight",29,"right-handed",13,1,0,14,0.928571429
17,"super middleweight",28,"right-handed",22,6,3,31,0.758064516
17,"super lightweight",31,"right-handed",13,6,0,19,0.684210526
17,"bantamweight",21,"right-handed",12,2,0,14,0.857142857
17,"super lightweight",25,"right-handed",17,5,1,23,0.760869565
17,"heavyweight",40,"right-handed",19,5,0,24,0.791666667
17,"cruiserweight",30,"right-handed",8,2,2,12,0.75
17,"middleweight",27,"right-handed",9,3,0,12,0.75
17,"cruiserweight",52,"right-handed",56,24,0,80,0.7
17,"welterweight",35,"right-handed",18,7,3,28,0.696428571
17,"lightweight",27,"right-handed",8,0,0,8,1
17,"minimumweight",23,"right-handed",10,1,1,12,0.875
17,"lightweight",29,"right-handed",14,2,0,16,0.875
17,"cruiserweight",24,"right-handed",6,0,0,6,1
17,"super featherweight",22,"right-handed",19,3,0,22,0.863636364
17,"middleweight",29,"right-handed",8,0,0,8,1
17,"welterweight",26,"right-handed",20,2,0,22,0.909090909
17,"lightweight",31,"right-handed",12,5,1,18,0.694444444
17,"cruiserweight",31,"right-handed",12,3,0,15,0.8
17,"super middleweight",34,"right-handed",9,12,3,24,0.4375
17,"super flyweight",NA,"right-handed",16,5,0,21,0.761904762
17,"welterweight",23,"right-handed",11,2,1,14,0.821428571
17,"super welterweight",24,"right-handed",8,2,0,10,0.8
17,"welterweight",25,"right-handed",10,0,2,12,0.916666667
17,"super middleweight",37,"right-handed",42,17,1,60,0.708333333
17,"welterweight",27,"right-handed",13,8,1,22,0.613636364
17,"welterweight",30,"right-handed",18,5,0,23,0.782608696
17,"welterweight",31,"right-handed",20,4,1,25,0.82
17,"super lightweight",NA,"right-handed",9,0,0,9,1
17,"heavyweight",39,"right-handed",18,8,1,27,0.685185185
17,"middleweight",38,"right-handed",43,13,0,56,0.767857143
17,"bantamweight",33,"right-handed",20,5,0,25,0.8
17,"super bantamweight",23,"right-handed",16,1,1,18,0.916666667
17,"light flyweight",22,"right-handed",6,1,0,7,0.857142857
17,"featherweight",19,"right-handed",8,1,0,9,0.888888889
17,"flyweight",22,"right-handed",12,3,1,16,0.78125
17,"lightweight",26,"right-handed",9,0,1,10,0.95
17,"bantamweight",26,"right-handed",18,4,0,22,0.818181818
17,"welterweight",33,"right-handed",25,5,2,32,0.8125
17,"super lightweight",25,"right-handed",13,1,0,14,0.928571429
18,"super lightweight",22,"right-handed",9,0,0,9,1
18,"featherweight",22,"right-handed",7,1,0,8,0.875
18,"super middleweight",36,"right-handed",8,4,1,13,0.653846154
18,"super lightweight",38,"right-handed",33,13,1,47,0.712765957
18,"lightweight",29,"right-handed",6,0,0,6,1
18,"minimumweight",20,"right-handed",8,0,0,8,1
18,"super bantamweight",23,"right-handed",14,4,1,19,0.763157895
18,"welterweight",26,"right-handed",13,1,1,15,0.9
18,"super middleweight",29,"right-handed",10,2,1,13,0.807692308
18,"middleweight",33,"right-handed",16,12,1,29,0.568965517
18,"super welterweight",39,"right-handed",33,8,1,42,0.797619048
18,"welterweight",26,"right-handed",24,0,0,24,1
18,"super bantamweight",24,"right-handed",8,1,1,10,0.85
18,"super welterweight",26,"right-handed",4,0,0,4,1
18,"super middleweight",21,"right-handed",5,0,0,5,1
18,"super featherweight",24,"right-handed",29,8,6,43,0.744186047
18,"super middleweight",27,"right-handed",20,3,1,24,0.854166667
18,"super lightweight",30,"right-handed",8,1,1,10,0.85
18,"super middleweight",27,"right-handed",18,1,2,21,0.904761905
18,"super bantamweight",24,"right-handed",9,5,0,14,0.642857143
18,"super middleweight",41,"right-handed",19,5,1,25,0.78
18,"welterweight",23,"right-handed",5,0,0,5,1
18,"super middleweight",39,"right-handed",25,8,0,33,0.757575758
18,"light heavyweight",33,"right-handed",24,11,0,35,0.685714286
18,"super middleweight",22,"right-handed",11,2,0,13,0.846153846
18,"cruiserweight",32,"right-handed",8,1,2,11,0.818181818
18,"lightweight",35,"right-handed",10,7,1,18,0.583333333
18,"heavyweight",25,"right-handed",11,1,0,12,0.916666667
18,"super lightweight",31,"right-handed",18,6,2,26,0.730769231
18,"super middleweight",31,"right-handed",7,2,0,9,0.777777778
18,"super middleweight",27,"right-handed",16,3,0,19,0.842105263
18,"heavyweight",30,"right-handed",8,2,0,10,0.8
18,"cruiserweight",23,"right-handed",3,0,1,4,0.875
18,"super featherweight",23,"right-handed",6,0,1,7,0.928571429
18,"super lightweight",28,"right-handed",7,1,2,10,0.8
18,"heavyweight",33,"right-handed",13,8,0,21,0.619047619
18,"flyweight",20,"right-handed",7,1,0,8,0.875
18,"featherweight",31,"right-handed",24,3,0,27,0.888888889
18,"lightweight",22,"right-handed",5,0,0,5,1
18,"flyweight",24,"right-handed",10,2,1,13,0.807692308
18,"super bantamweight",NA,"right-handed",22,11,1,34,0.661764706
18,"middleweight",32,"right-handed",16,8,0,24,0.666666667
18,"lightweight",28,"right-handed",24,7,1,32,0.765625
18,"super middleweight",29,"right-handed",11,0,0,11,1
18,"cruiserweight",28,"right-handed",10,3,0,13,0.769230769
18,"super welterweight",29,"right-handed",10,0,1,11,0.954545455
18,"super lightweight",25,"right-handed",12,0,0,12,1
18,"lightweight",23,"right-handed",12,2,1,15,0.833333333
18,"super middleweight",26,"right-handed",17,4,0,21,0.80952381
18,"super welterweight",33,"right-handed",22,7,1,30,0.75
18,"lightweight",27,"right-handed",10,5,0,15,0.666666667
18,"super welterweight",24,"right-handed",9,0,0,9,1
18,"super middleweight",25,"right-handed",8,0,0,8,1
18,"welterweight",27,"right-handed",10,3,2,15,0.733333333
18,"super bantamweight",23,"right-handed",8,1,0,9,0.888888889
18,"bantamweight",28,"right-handed",9,5,2,16,0.625
18,"super featherweight",27,"right-handed",19,5,0,24,0.791666667
18,"featherweight",NA,"right-handed",10,0,0,10,1
18,"welterweight",24,"right-handed",7,1,0,8,0.875
18,"super featherweight",22,"right-handed",8,0,0,8,1
18,"super lightweight",27,"right-handed",13,4,0,17,0.764705882
18,"heavyweight",31,"right-handed",8,0,0,8,1
18,"super flyweight",23,"right-handed",11,3,0,14,0.785714286
18,"super featherweight",22,"right-handed",12,1,0,13,0.923076923
18,"lightweight",35,"right-handed",17,10,2,29,0.620689655
18,"lightweight",34,"right-handed",13,1,2,16,0.875
18,"super middleweight",27,"right-handed",10,7,0,17,0.588235294
18,"super featherweight",27,"right-handed",6,1,1,8,0.8125
18,"super bantamweight",19,"right-handed",5,0,1,6,0.916666667
18,"super flyweight",28,"right-handed",11,2,0,13,0.846153846
18,"super lightweight",27,"right-handed",10,4,1,15,0.7
18,"super featherweight",21,"right-handed",6,0,0,6,1
18,"super bantamweight",24,"right-handed",7,0,3,10,0.85
18,"bantamweight",20,"right-handed",5,1,0,6,0.833333333
18,"super lightweight",33,"right-handed",18,14,0,32,0.5625
18,"lightweight",34,"right-handed",6,0,0,6,1
18,"bantamweight",26,"right-handed",5,0,0,5,1
18,"super middleweight",25,"right-handed",10,0,0,10,1
18,"super welterweight",26,"right-handed",7,2,1,10,0.75
18,"lightweight",38,"right-handed",36,19,1,56,0.651785714
18,"super welterweight",35,"right-handed",56,17,0,73,0.767123288
18,"super welterweight",35,"right-handed",37,23,0,60,0.616666667
18,"super bantamweight",32,"right-handed",9,8,0,17,0.529411765
18,"welterweight",41,"right-handed",24,8,1,33,0.742424242
18,"heavyweight",42,"right-handed",24,0,0,24,1
18,"bantamweight",27,"right-handed",10,6,5,21,0.595238095
18,"welterweight",26,"right-handed",9,1,0,10,0.9
18,"middleweight",32,"right-handed",18,6,2,26,0.730769231
18,"super middleweight",20,"right-handed",8,0,0,8,1
18,"lightweight",23,"right-handed",7,2,3,12,0.708333333
18,"featherweight",33,"right-handed",9,11,2,22,0.454545455
18,"welterweight",24,"right-handed",7,0,0,7,1
18,"welterweight",24,"right-handed",9,0,0,9,1
18,"cruiserweight",42,"right-handed",38,6,0,44,0.863636364
18,"lightweight",27,"right-handed",9,0,0,9,1
18,"featherweight",26,"right-handed",6,2,1,9,0.722222222
18,"middleweight",20,"right-handed",11,0,1,12,0.958333333
18,"featherweight",29,"right-handed",20,15,1,36,0.569444444
18,"welterweight",41,"right-handed",29,8,3,40,0.7625
18,"heavyweight",35,"right-handed",23,3,0,26,0.884615385
19,"lightweight",23,"right-handed",20,3,1,24,0.854166667
19,"lightweight",31,"right-handed",13,7,2,22,0.636363636
19,"super bantamweight",27,"right-handed",14,1,0,15,0.933333333
19,"super middleweight",27,"right-handed",11,1,0,12,0.916666667
19,"lightweight",26,"right-handed",8,0,0,8,1
19,"light heavyweight",29,"right-handed",6,0,0,6,1
19,"super featherweight",30,"right-handed",9,2,0,11,0.818181818
19,"super middleweight",26,"right-handed",11,3,2,16,0.75
19,"super lightweight",32,"right-handed",21,2,1,24,0.895833333
19,"super featherweight",24,"right-handed",9,0,1,10,0.95
19,"bantamweight",28,"right-handed",23,8,1,32,0.734375
19,"middleweight",NA,"right-handed",21,8,2,31,0.709677419
19,"welterweight",33,"right-handed",21,7,1,29,0.74137931
19,"super featherweight",30,"right-handed",8,2,0,10,0.8
19,"super bantamweight",25,"right-handed",8,3,2,13,0.692307692
19,"super bantamweight",28,"right-handed",9,3,0,12,0.75
19,"middleweight",29,"right-handed",16,0,0,16,1
19,"light heavyweight",31,"right-handed",10,0,0,10,1
19,"super featherweight",24,"right-handed",24,12,0,36,0.666666667
19,"cruiserweight",30,"right-handed",30,4,0,34,0.882352941
19,"welterweight",24,"right-handed",8,0,0,8,1
19,"super featherweight",22,"right-handed",10,1,0,11,0.909090909
19,"bantamweight",29,"right-handed",11,5,1,17,0.676470588
19,"light heavyweight",37,"right-handed",10,0,0,10,1
19,"light flyweight",23,"right-handed",7,2,0,9,0.777777778
19,"super middleweight",28,"right-handed",12,1,0,13,0.923076923
19,"heavyweight",28,"right-handed",8,1,2,11,0.818181818
19,"super welterweight",29,"right-handed",21,17,3,41,0.548780488
19,"welterweight",21,"right-handed",7,0,0,7,1
19,"super flyweight",20,"right-handed",8,1,1,10,0.85
19,"lightweight",25,"right-handed",15,3,0,18,0.833333333
19,"flyweight",23,"right-handed",6,3,2,11,0.636363636
19,"bantamweight",25,"right-handed",9,1,0,10,0.9
19,"super middleweight",38,"right-handed",21,1,1,23,0.934782609
19,"super middleweight",37,"right-handed",31,18,1,50,0.63
19,"middleweight",25,"right-handed",13,3,1,17,0.794117647
19,"lightweight",28,"right-handed",19,8,2,29,0.689655172
18,"super bantamweight",22,"right-handed",9,0,0,9,1
18,"heavyweight",39,"right-handed",33,12,1,46,0.72826087
18,"super middleweight",30,"right-handed",11,0,0,11,1
18,"super bantamweight",29,"right-handed",10,0,1,11,0.954545455
18,"welterweight",26,"right-handed",15,2,0,17,0.882352941
18,"featherweight",23,"right-handed",6,3,4,13,0.615384615
18,"lightweight",21,"right-handed",18,2,1,21,0.880952381
18,"middleweight",32,"right-handed",40,15,3,58,0.715517241
18,"light heavyweight",28,"right-handed",6,1,0,7,0.857142857
18,"featherweight",24,"right-handed",13,7,1,21,0.642857143
18,"super middleweight",44,"right-handed",32,16,3,51,0.656862745
18,"super lightweight",26,"right-handed",8,0,0,8,1
18,"middleweight",23,"right-handed",11,1,0,12,0.916666667
19,"heavyweight",28,"right-handed",19,6,4,29,0.724137931
19,"light flyweight",24,"right-handed",14,1,3,18,0.861111111
19,"cruiserweight",23,"right-handed",8,0,0,8,1
19,"cruiserweight",30,"right-handed",11,6,0,17,0.647058824
19,"super lightweight",28,"right-handed",25,3,2,30,0.866666667
19,"lightweight",40,"right-handed",36,32,6,74,0.527027027
19,"super lightweight",26,"right-handed",7,3,1,11,0.681818182
19,"bantamweight",26,"right-handed",9,3,1,13,0.730769231
19,"welterweight",24,"right-handed",6,0,0,6,1
19,"lightweight",26,"right-handed",16,3,3,22,0.795454545
19,"lightweight",23,"right-handed",18,2,2,22,0.863636364
19,"bantamweight",27,"right-handed",7,0,0,7,1
19,"super middleweight",26,"right-handed",23,18,4,45,0.555555556
19,"lightweight",23,"right-handed",19,3,0,22,0.863636364
19,"featherweight",26,"right-handed",26,15,2,43,0.627906977
19,"light flyweight",21,"right-handed",6,2,2,10,0.7
19,"super bantamweight",24,"right-handed",8,0,0,8,1
19,"super lightweight",27,"right-handed",11,0,0,11,1
19,"light heavyweight",30,"right-handed",17,2,0,19,0.894736842
19,"super featherweight",31,"right-handed",16,2,0,18,0.888888889
19,"super lightweight",32,"right-handed",11,1,1,13,0.884615385
19,"super lightweight",29,"right-handed",7,0,0,7,1
19,"super middleweight",33,"right-handed",10,1,1,12,0.875
19,"welterweight",26,"right-handed",10,1,0,11,0.909090909
19,"welterweight",22,"right-handed",10,1,1,12,0.875
19,"lightweight",28,"right-handed",10,3,0,13,0.769230769
19,"super featherweight",27,"right-handed",8,0,0,8,1
19,"flyweight",26,"right-handed",8,4,2,14,0.642857143
19,"middleweight",31,"right-handed",21,9,1,31,0.693548387
19,"super middleweight",24,"right-handed",10,4,1,15,0.7
19,"welterweight",25,"right-handed",7,0,0,7,1
19,"super welterweight",37,"right-handed",36,3,1,40,0.9125
19,"super featherweight",22,"right-handed",8,1,0,9,0.888888889
19,"cruiserweight",NA,"right-handed",7,0,0,7,1
19,"cruiserweight",36,"right-handed",16,7,1,24,0.6875
19,"super bantamweight",20,"right-handed",7,0,0,7,1
19,"light flyweight",24,"right-handed",12,4,1,17,0.735294118
19,"lightweight",25,"right-handed",10,0,2,12,0.916666667
19,"cruiserweight",33,"right-handed",11,2,3,16,0.78125
19,"flyweight",26,"right-handed",12,3,2,17,0.764705882
19,"featherweight",24,"right-handed",16,2,3,21,0.833333333
19,"super lightweight",19,"right-handed",18,3,0,21,0.857142857
19,"light heavyweight",31,"right-handed",13,3,2,18,0.777777778
19,"super welterweight",21,"right-handed",8,0,0,8,1
19,"featherweight",NA,"right-handed",7,2,2,11,0.727272727
19,"super lightweight",25,"right-handed",6,0,1,7,0.928571429
19,"middleweight",22,"right-handed",5,2,1,8,0.6875
19,"lightweight",28,"right-handed",18,4,2,24,0.791666667
19,"super welterweight",25,"right-handed",8,0,0,8,1
19,"super bantamweight",19,"right-handed",10,1,0,11,0.909090909
20,"cruiserweight",25,"right-handed",9,0,0,9,1
20,"bantamweight",28,"right-handed",12,2,0,14,0.857142857
20,"welterweight",26,"right-handed",9,0,0,9,1
20,"lightweight",25,"right-handed",6,3,1,10,0.65
20,"featherweight",33,"right-handed",34,17,5,56,0.651785714
20,"super middleweight",23,"right-handed",6,12,4,22,0.363636364
20,"lightweight",26,"right-handed",13,0,0,13,1
20,"super lightweight",30,"right-handed",14,5,0,19,0.736842105
20,"flyweight",20,"right-handed",7,0,0,7,1
20,"bantamweight",27,"right-handed",22,22,4,48,0.5
20,"featherweight",20,"right-handed",10,5,3,18,0.638888889
20,"welterweight",31,"right-handed",17,4,0,21,0.80952381
20,"super lightweight",32,"right-handed",27,4,0,31,0.870967742
20,"lightweight",23,"right-handed",9,2,0,11,0.818181818
20,"lightweight",28,"right-handed",8,0,0,8,1
20,"welterweight",32,"right-handed",9,1,1,11,0.863636364
20,"welterweight",33,"right-handed",18,2,0,20,0.9
20,"lightweight",28,"right-handed",10,0,0,10,1
20,"cruiserweight",31,"right-handed",9,0,0,9,1
20,"middleweight",27,"right-handed",7,0,2,9,0.888888889
20,"super featherweight",30,"right-handed",11,3,0,14,0.785714286
20,"super featherweight",29,"right-handed",11,5,1,17,0.676470588
20,"lightweight",22,"right-handed",10,2,1,13,0.807692308
20,"super lightweight",30,"right-handed",15,3,0,18,0.833333333
19,"middleweight",31,"right-handed",10,1,0,11,0.909090909
19,"featherweight",25,"right-handed",11,4,0,15,0.733333333
19,"super bantamweight",22,"right-handed",9,0,0,9,1
19,"lightweight",26,"right-handed",17,5,0,22,0.772727273
19,"super bantamweight",32,"right-handed",23,7,0,30,0.766666667
19,"featherweight",28,"right-handed",17,2,2,21,0.857142857
19,"light heavyweight",23,"right-handed",7,3,0,10,0.7
19,"featherweight",NA,"right-handed",8,2,0,10,0.8
19,"super lightweight",22,"right-handed",7,1,0,8,0.875
19,"super lightweight",26,"right-handed",7,15,3,25,0.34
19,"super lightweight",19,"right-handed",12,0,0,12,1
19,"featherweight",22,"right-handed",13,3,0,16,0.8125
19,"super featherweight",24,"right-handed",13,7,2,22,0.636363636
19,"light heavyweight",28,"right-handed",11,2,0,13,0.846153846
19,"lightweight",24,"right-handed",7,0,1,8,0.9375
19,"cruiserweight",32,"right-handed",8,0,0,8,1
19,"light heavyweight",31,"right-handed",8,0,0,8,1
19,"super lightweight",31,"right-handed",14,5,0,19,0.736842105
19,"super lightweight",25,"right-handed",18,10,1,29,0.637931034
19,"heavyweight",29,"right-handed",5,0,0,5,1
19,"super featherweight",28,"right-handed",17,1,1,19,0.921052632
19,"heavyweight",32,"right-handed",5,0,1,6,0.916666667
19,"middleweight",37,"right-handed",29,12,1,42,0.702380952
19,"middleweight",NA,"right-handed",9,0,0,9,1
19,"featherweight",25,"right-handed",9,0,1,10,0.95
19,"middleweight",40,"right-handed",23,4,0,27,0.851851852
20,"middleweight",34,"right-handed",23,5,1,29,0.810344828
20,"super middleweight",35,"right-handed",22,2,2,26,0.884615385
20,"featherweight",20,"right-handed",9,2,0,11,0.818181818
20,"featherweight",21,"right-handed",7,1,1,9,0.833333333
20,"super welterweight",28,"right-handed",23,9,0,32,0.71875
20,"light heavyweight",NA,"right-handed",6,0,0,6,1
20,"cruiserweight",29,"right-handed",10,0,1,11,0.954545455
20,"super bantamweight",25,"right-handed",13,6,2,21,0.666666667
20,"super featherweight",26,"right-handed",14,2,1,17,0.852941176
20,"cruiserweight",39,"right-handed",32,6,0,38,0.842105263
20,"welterweight",24,"right-handed",6,2,1,9,0.722222222
20,"super flyweight",30,"right-handed",20,5,1,26,0.788461538
20,"welterweight",24,"right-handed",10,1,2,13,0.846153846
20,"bantamweight",34,"right-handed",15,9,3,27,0.611111111
20,"welterweight",27,"right-handed",9,0,0,9,1
20,"flyweight",28,"right-handed",25,5,1,31,0.822580645
20,"super middleweight",22,"right-handed",18,0,0,18,1
20,"lightweight",29,"right-handed",27,4,1,32,0.859375
20,"light heavyweight",27,"right-handed",14,1,1,16,0.90625
20,"lightweight",26,"right-handed",6,1,0,7,0.857142857
20,"super featherweight",23,"right-handed",16,5,0,21,0.761904762
20,"welterweight",28,"right-handed",28,4,0,32,0.875
20,"light flyweight",NA,"right-handed",9,3,0,12,0.75
20,"heavyweight",27,"right-handed",18,0,0,18,1
20,"super flyweight",22,"right-handed",15,0,0,15,1
20,"super welterweight",28,"right-handed",11,2,2,15,0.8
20,"lightweight",29,"right-handed",33,7,0,40,0.825
20,"bantamweight",30,"right-handed",19,11,0,30,0.633333333
20,"welterweight",20,"right-handed",12,2,0,14,0.857142857
20,"super middleweight",36,"right-handed",24,7,0,31,0.774193548
20,"lightweight",35,"right-handed",12,23,3,38,0.355263158
20,"welterweight",29,"right-handed",35,9,1,45,0.788888889
20,"cruiserweight",34,"right-handed",18,3,0,21,0.857142857
20,"super featherweight",28,"right-handed",13,1,2,16,0.875
20,"light heavyweight",24,"right-handed",16,0,0,16,1
20,"lightweight",37,"right-handed",18,4,3,25,0.78
20,"featherweight",24,"right-handed",10,3,1,14,0.75
20,"light heavyweight",29,"right-handed",18,15,1,34,0.544117647
20,"super middleweight",30,"right-handed",11,2,0,13,0.846153846
20,"middleweight",33,"right-handed",21,3,0,24,0.875
20,"super lightweight",22,"right-handed",12,2,0,14,0.857142857
20,"heavyweight",30,"right-handed",13,2,0,15,0.866666667
20,"super welterweight",29,"right-handed",6,2,0,8,0.75
20,"middleweight",30,"right-handed",10,0,0,10,1
20,"featherweight",31,"right-handed",28,8,0,36,0.777777778
20,"middleweight",38,"right-handed",18,11,1,30,0.616666667
20,"super featherweight",28,"right-handed",13,3,1,17,0.794117647
20,"middleweight",28,"right-handed",8,0,0,8,1
20,"welterweight",24,"right-handed",8,0,0,8,1
20,"super flyweight",33,"right-handed",12,17,2,31,0.419354839
21,"welterweight",26,"right-handed",15,2,0,17,0.882352941
21,"super lightweight",22,"right-handed",14,0,0,14,1
21,"lightweight",28,"right-handed",6,1,0,7,0.857142857
21,"super flyweight",30,"right-handed",19,4,0,23,0.826086957
21,"super bantamweight",18,"right-handed",21,1,0,22,0.954545455
21,"welterweight",22,"right-handed",9,1,0,10,0.9
21,"super lightweight",33,"right-handed",11,12,3,26,0.480769231
21,"light flyweight",26,"right-handed",10,0,1,11,0.954545455
21,"lightweight",23,"right-handed",14,0,1,15,0.966666667
21,"light heavyweight",36,"right-handed",19,5,1,25,0.78
21,"cruiserweight",33,"right-handed",4,0,0,4,1
21,"middleweight",38,"right-handed",37,4,1,42,0.892857143
21,"super lightweight",32,"right-handed",13,1,1,15,0.9
21,"super lightweight",38,"right-handed",32,17,0,49,0.653061224
21,"super welterweight",25,"right-handed",11,0,0,11,1
21,"super lightweight",38,"right-handed",26,33,2,61,0.442622951
21,"cruiserweight",24,"right-handed",4,0,0,4,1
21,"light flyweight",21,"right-handed",11,1,0,12,0.916666667
21,"super bantamweight",27,"right-handed",11,1,0,12,0.916666667
21,"welterweight",31,"right-handed",14,6,0,20,0.7
20,"super welterweight",31,"right-handed",15,1,0,16,0.9375
20,"welterweight",31,"right-handed",10,13,2,25,0.44
20,"super bantamweight",24,"right-handed",13,2,0,15,0.866666667
20,"light heavyweight",26,"right-handed",19,5,0,24,0.791666667
20,"super lightweight",30,"right-handed",9,1,0,10,0.9
20,"flyweight",39,"right-handed",30,7,2,39,0.794871795
20,"super welterweight",25,"right-handed",8,0,0,8,1
20,"lightweight",23,"right-handed",7,0,0,7,1
20,"heavyweight",27,"right-handed",15,1,0,16,0.9375
20,"middleweight",NA,"right-handed",9,1,0,10,0.9
20,"flyweight",25,"right-handed",7,0,0,7,1
20,"super featherweight",24,"right-handed",12,3,0,15,0.8
20,"super lightweight",24,"right-handed",19,2,0,21,0.904761905
20,"super lightweight",25,"right-handed",14,2,0,16,0.875
20,"middleweight",20,"right-handed",9,0,2,11,0.909090909
20,"welterweight",32,"right-handed",8,8,3,19,0.5
20,"minimumweight",27,"right-handed",12,7,1,20,0.625
20,"super featherweight",22,"right-handed",7,0,1,8,0.9375
20,"super lightweight",37,"right-handed",35,19,0,54,0.648148148
20,"middleweight",29,"right-handed",26,12,0,38,0.684210526
20,"welterweight",28,"right-handed",16,5,1,22,0.75
20,"super flyweight",27,"right-handed",15,8,2,25,0.64
20,"lightweight",27,"right-handed",41,12,1,54,0.768518519
20,"featherweight",20,"right-handed",7,2,0,9,0.777777778
20,"flyweight",23,"right-handed",8,4,1,13,0.653846154
20,"lightweight",25,"right-handed",11,4,2,17,0.705882353
20,"flyweight",27,"right-handed",22,8,3,33,0.712121212
20,"super middleweight",33,"right-handed",9,1,2,12,0.833333333
20,"super welterweight",23,"right-handed",8,1,0,9,0.888888889
20,"super bantamweight",28,"right-handed",21,7,1,29,0.74137931
21,"super lightweight",19,"right-handed",13,1,0,14,0.928571429
21,"super featherweight",24,"right-handed",11,0,0,11,1
21,"welterweight",23,"right-handed",11,0,0,11,1
21,"featherweight",NA,"right-handed",8,0,0,8,1
21,"super lightweight",24,"right-handed",8,0,0,8,1
21,"super featherweight",33,"right-handed",30,13,0,43,0.697674419
21,"super lightweight",36,"right-handed",13,2,0,15,0.866666667
21,"light heavyweight",28,"right-handed",9,0,0,9,1
21,"cruiserweight",30,"right-handed",31,3,0,34,0.911764706
21,"middleweight",30,"right-handed",26,4,0,30,0.866666667
21,"cruiserweight",29,"right-handed",19,11,2,32,0.625
21,"super featherweight",25,"right-handed",9,0,0,9,1
21,"super welterweight",39,"right-handed",24,10,2,36,0.694444444
21,"super lightweight",33,"right-handed",35,4,2,41,0.87804878
21,"welterweight",40,"right-handed",39,10,3,52,0.778846154
21,"featherweight",23,"right-handed",9,0,0,9,1
21,"light heavyweight",32,"right-handed",13,2,1,16,0.84375
21,"middleweight",24,"right-handed",12,1,0,13,0.923076923
21,"featherweight",36,"right-handed",14,8,2,24,0.625
21,"super featherweight",25,"right-handed",16,5,1,22,0.75
21,"welterweight",32,"right-handed",12,4,1,17,0.735294118
21,"cruiserweight",38,"right-handed",24,24,5,53,0.5
21,"super bantamweight",23,"right-handed",7,0,0,7,1
21,"featherweight",26,"right-handed",7,0,0,7,1
21,"super welterweight",31,"right-handed",40,12,2,54,0.759259259
21,"light heavyweight",36,"right-handed",21,7,1,29,0.74137931
21,"heavyweight",35,"right-handed",15,10,3,28,0.589285714
21,"middleweight",20,"right-handed",5,0,0,5,1
21,"super welterweight",37,"right-handed",32,7,0,39,0.820512821
21,"welterweight",42,"right-handed",42,25,3,70,0.621428571
21,"heavyweight",29,"right-handed",18,3,0,21,0.857142857
21,"middleweight",29,"right-handed",2,0,1,3,0.833333333
21,"minimumweight",35,"right-handed",16,16,2,34,0.5
21,"heavyweight",28,"right-handed",14,0,2,16,0.9375
21,"super lightweight",22,"right-handed",10,2,1,13,0.807692308
21,"super welterweight",27,"right-handed",15,6,1,22,0.704545455
21,"light heavyweight",31,"right-handed",7,0,0,7,1
21,"cruiserweight",23,"right-handed",11,2,1,14,0.821428571
21,"lightweight",22,"right-handed",6,0,0,6,1
21,"super lightweight",32,"right-handed",15,3,0,18,0.833333333
21,"featherweight",25,"right-handed",19,3,0,22,0.863636364
21,"welterweight",31,"right-handed",28,11,2,41,0.707317073
21,"lightweight",22,"right-handed",7,0,0,7,1
21,"super lightweight",26,"right-handed",12,3,0,15,0.8
21,"super featherweight",28,"right-handed",7,1,0,8,0.875
21,"middleweight",28,"right-handed",8,3,1,12,0.708333333
21,"light flyweight",32,"right-handed",11,3,1,15,0.766666667
21,"cruiserweight",31,"right-handed",11,0,0,11,1
21,"featherweight",18,"right-handed",13,0,0,13,1
21,"super welterweight",22,"right-handed",13,3,0,16,0.8125
22,"super featherweight",21,"right-handed",7,0,0,7,1
22,"welterweight",27,"right-handed",18,1,1,20,0.925
22,"super welterweight",24,"right-handed",10,0,0,10,1
22,"flyweight",19,"right-handed",7,1,0,8,0.875
22,"bantamweight",24,"right-handed",4,1,1,6,0.75
22,"lightweight",26,"right-handed",14,0,1,15,0.966666667
22,"middleweight",25,"right-handed",9,0,0,9,1
22,"super welterweight",23,"right-handed",8,0,0,8,1
22,"flyweight",26,"right-handed",11,5,0,16,0.6875
22,"heavyweight",30,"right-handed",17,2,0,19,0.894736842
22,"heavyweight",34,"right-handed",8,5,2,15,0.6
22,"welterweight",23,"right-handed",6,1,0,7,0.857142857
22,"bantamweight",23,"right-handed",17,1,0,18,0.944444444
22,"light heavyweight",29,"right-handed",15,2,0,17,0.882352941
22,"super lightweight",35,"right-handed",33,8,2,43,0.790697674
22,"super flyweight",25,"right-handed",9,0,0,9,1
22,"super bantamweight",31,"right-handed",19,6,1,26,0.75
22,"welterweight",27,"right-handed",8,1,0,9,0.888888889
22,"featherweight",25,"right-handed",15,2,2,19,0.842105263
22,"heavyweight",29,"right-handed",15,0,1,16,0.96875
22,"super welterweight",33,"right-handed",24,11,2,37,0.675675676
22,"minimumweight",27,"right-handed",10,6,1,17,0.617647059
22,"light heavyweight",26,"right-handed",18,4,0,22,0.818181818
22,"lightweight",35,"right-handed",23,21,3,47,0.521276596
22,"lightweight",29,"right-handed",13,0,0,13,1
22,"super flyweight",27,"right-handed",21,9,1,31,0.693548387
22,"minimumweight",23,"right-handed",14,2,0,16,0.875
22,"lightweight",18,"right-handed",10,0,0,10,1
22,"super featherweight",23,"right-handed",12,2,0,14,0.857142857
22,"super featherweight",23,"right-handed",8,2,1,11,0.772727273
22,"super bantamweight",27,"right-handed",16,3,2,21,0.80952381
22,"super welterweight",28,"right-handed",11,4,0,15,0.733333333
22,"welterweight",30,"right-handed",17,1,1,19,0.921052632
22,"heavyweight",41,"right-handed",41,5,0,46,0.891304348
21,"welterweight",24,"right-handed",7,1,0,8,0.875
21,"heavyweight",29,"right-handed",12,0,2,14,0.928571429
21,"heavyweight",36,"right-handed",10,1,0,11,0.909090909
21,"heavyweight",26,"right-handed",29,3,0,32,0.90625
21,"light flyweight",23,"right-handed",8,5,0,13,0.615384615
21,"cruiserweight",25,"right-handed",11,3,1,15,0.766666667
21,"cruiserweight",38,"right-handed",11,2,0,13,0.846153846
21,"super flyweight",20,"right-handed",8,2,2,12,0.75
21,"welterweight",27,"right-handed",9,3,1,13,0.730769231
21,"cruiserweight",31,"right-handed",5,0,0,5,1
21,"heavyweight",46,"right-handed",40,15,2,57,0.719298246
21,"super welterweight",33,"right-handed",41,6,1,48,0.864583333
21,"cruiserweight",36,"right-handed",22,1,1,24,0.9375
21,"middleweight",31,"right-handed",34,3,1,38,0.907894737
21,"lightweight",30,"right-handed",12,4,0,16,0.75
21,"super bantamweight",23,"right-handed",15,0,0,15,1
23,"light heavyweight",28,"right-handed",9,0,0,9,1
23,"middleweight",28,"right-handed",20,1,1,22,0.931818182
23,"cruiserweight",36,"right-handed",31,14,1,46,0.684782609
23,"welterweight",30,"right-handed",17,1,1,19,0.921052632
23,"flyweight",22,"right-handed",7,0,1,8,0.9375
23,"lightweight",30,"right-handed",10,4,0,14,0.714285714
23,"lightweight",31,"right-handed",10,6,1,17,0.617647059
23,"super bantamweight",26,"right-handed",11,0,0,11,1
22,"super lightweight",27,"right-handed",22,4,0,26,0.846153846
22,"lightweight",34,"right-handed",23,8,0,31,0.741935484
22,"super middleweight",NA,"right-handed",9,8,1,18,0.527777778
22,"welterweight",28,"right-handed",11,5,1,17,0.676470588
22,"cruiserweight",36,"right-handed",20,3,0,23,0.869565217
22,"heavyweight",27,"right-handed",12,3,0,15,0.8
22,"super bantamweight",24,"right-handed",9,2,0,11,0.818181818
22,"super welterweight",25,"right-handed",18,2,0,20,0.9
22,"middleweight",25,"right-handed",11,0,0,11,1
22,"middleweight",27,"right-handed",7,1,1,9,0.833333333
22,"lightweight",31,"right-handed",14,14,6,34,0.5
22,"middleweight",37,"right-handed",18,13,1,32,0.578125
22,"heavyweight",31,"right-handed",20,0,0,20,1
22,"lightweight",30,"right-handed",34,14,3,51,0.696078431
22,"super welterweight",29,"right-handed",6,0,0,6,1
22,"lightweight",33,"right-handed",15,13,6,34,0.529411765
22,"super bantamweight",25,"right-handed",11,1,0,12,0.916666667
22,"super welterweight",30,"right-handed",12,4,2,18,0.722222222
22,"cruiserweight",28,"right-handed",8,0,0,8,1
22,"cruiserweight",41,"right-handed",39,9,0,48,0.8125
22,"super welterweight",30,"right-handed",15,1,0,16,0.9375
22,"flyweight",23,"right-handed",15,5,0,20,0.75
22,"welterweight",30,"right-handed",32,14,2,48,0.6875
22,"super welterweight",23,"right-handed",6,2,4,12,0.666666667
22,"super bantamweight",31,"right-handed",5,0,0,5,1
22,"middleweight",30,"right-handed",21,5,1,27,0.796296296
22,"lightweight",33,"right-handed",19,1,0,20,0.95
22,"super bantamweight",31,"right-handed",42,5,1,48,0.885416667
22,"heavyweight",28,"right-handed",18,6,1,25,0.74
22,"light heavyweight",34,"right-handed",30,24,1,55,0.554545455
22,"featherweight",24,"right-handed",8,0,0,8,1
22,"lightweight",26,"right-handed",7,2,1,10,0.75
22,"heavyweight",23,"right-handed",9,0,0,9,1
22,"welterweight",32,"right-handed",25,3,0,28,0.892857143
22,"super flyweight",20,"right-handed",16,0,0,16,1
22,"heavyweight",29,"right-handed",14,3,2,19,0.789473684
22,"flyweight",21,"right-handed",8,0,1,9,0.944444444
22,"lightweight",26,"right-handed",19,13,1,33,0.590909091
22,"super bantamweight",22,"right-handed",14,2,0,16,0.875
22,"middleweight",31,"right-handed",17,3,0,20,0.85
22,"super featherweight",22,"right-handed",11,0,0,11,1
22,"featherweight",27,"right-handed",14,0,0,14,1
23,"welterweight",31,"right-handed",23,5,1,29,0.810344828
23,"super lightweight",27,"right-handed",15,2,0,17,0.882352941
23,"bantamweight",27,"right-handed",10,9,1,20,0.525
23,"super lightweight",30,"right-handed",20,1,0,21,0.952380952
23,"heavyweight",26,"right-handed",14,0,0,14,1
23,"super bantamweight",24,"right-handed",13,0,0,13,1
23,"welterweight",24,"right-handed",18,3,0,21,0.857142857
23,"bantamweight",30,"right-handed",18,6,2,26,0.730769231
23,"welterweight",23,"right-handed",13,0,0,13,1
23,"welterweight",32,"right-handed",21,3,0,24,0.875
23,"super bantamweight",27,"right-handed",13,6,3,22,0.659090909
23,"lightweight",35,"right-handed",22,14,1,37,0.608108108
23,"super middleweight",25,"right-handed",10,0,0,10,1
23,"super lightweight",36,"right-handed",20,5,0,25,0.8
23,"light heavyweight",36,"right-handed",13,10,3,26,0.557692308
23,"super featherweight",31,"right-handed",12,7,1,20,0.625
23,"super lightweight",23,"right-handed",10,0,1,11,0.954545455
23,"super flyweight",26,"right-handed",11,0,0,11,1
23,"featherweight",21,"right-handed",10,0,1,11,0.954545455
23,"super welterweight",27,"right-handed",23,15,1,39,0.602564103
23,"super lightweight",23,"right-handed",14,5,2,21,0.714285714
23,"super featherweight",24,"right-handed",19,2,0,21,0.904761905
23,"super welterweight",35,"right-handed",11,3,0,14,0.785714286
23,"heavyweight",39,"right-handed",34,4,1,39,0.884615385
23,"welterweight",25,"right-handed",13,3,0,16,0.8125
23,"super featherweight",21,"right-handed",10,2,0,12,0.833333333
23,"light heavyweight",35,"right-handed",11,4,0,15,0.733333333
23,"lightweight",26,"right-handed",12,1,1,14,0.892857143
23,"flyweight",34,"right-handed",24,6,1,31,0.790322581
23,"heavyweight",32,"right-handed",12,3,0,15,0.8
23,"light heavyweight",39,"right-handed",19,14,1,34,0.573529412
23,"lightweight",27,"right-handed",10,1,0,11,0.909090909
23,"middleweight",35,"right-handed",18,3,1,22,0.840909091
23,"bantamweight",29,"right-handed",7,3,2,12,0.666666667
23,"light heavyweight",29,"right-handed",13,0,2,15,0.933333333
23,"super lightweight",27,"right-handed",9,1,1,11,0.863636364
23,"super featherweight",23,"right-handed",22,4,0,26,0.846153846
23,"super bantamweight",21,"right-handed",9,0,0,9,1
23,"welterweight",27,"right-handed",24,6,2,32,0.78125
23,"super welterweight",21,"right-handed",6,0,0,6,1
23,"flyweight",24,"right-handed",15,3,2,20,0.8
23,"super welterweight",29,"right-handed",14,2,3,19,0.815789474
23,"super lightweight",22,"right-handed",17,0,0,17,1
23,"featherweight",28,"right-handed",23,7,0,30,0.766666667
23,"middleweight",23,"right-handed",8,0,0,8,1
23,"featherweight",24,"right-handed",8,1,1,10,0.85
23,"super featherweight",28,"right-handed",15,0,0,15,1
23,"super middleweight",31,"right-handed",19,4,1,24,0.8125
23,"featherweight",23,"right-handed",12,1,0,13,0.923076923
23,"super welterweight",37,"right-handed",23,12,0,35,0.657142857
24,"super bantamweight",32,"right-handed",17,6,0,23,0.739130435
24,"welterweight",28,"right-handed",12,2,3,17,0.794117647
24,"super welterweight",25,"right-handed",15,1,0,16,0.9375
24,"featherweight",29,"right-handed",14,0,0,14,1
24,"super welterweight",28,"right-handed",8,3,1,12,0.708333333
24,"flyweight",21,"right-handed",11,0,0,11,1
24,"lightweight",30,"right-handed",43,5,2,50,0.88
24,"super lightweight",26,"right-handed",15,1,1,17,0.911764706
24,"super lightweight",20,"right-handed",11,2,1,14,0.821428571
24,"lightweight",25,"right-handed",8,3,1,12,0.708333333
24,"super lightweight",28,"right-handed",16,4,3,23,0.760869565
24,"middleweight",30,"right-handed",17,7,2,26,0.692307692
24,"super bantamweight",25,"right-handed",11,1,1,13,0.884615385
24,"super featherweight",30,"right-handed",10,1,0,11,0.909090909
24,"bantamweight",28,"right-handed",17,1,0,18,0.944444444
24,"flyweight",24,"right-handed",8,2,4,14,0.714285714
24,"light heavyweight",39,"right-handed",33,5,0,38,0.868421053
24,"cruiserweight",30,"right-handed",8,3,0,11,0.727272727
24,"super featherweight",31,"right-handed",22,3,0,25,0.88
24,"light heavyweight",34,"right-handed",26,11,2,39,0.692307692
24,"heavyweight",37,"right-handed",25,1,0,26,0.961538462
24,"featherweight",30,"right-handed",18,11,1,30,0.616666667
24,"minimumweight",29,"right-handed",15,10,0,25,0.6
24,"welterweight",43,"right-handed",35,13,2,50,0.72
24,"welterweight",33,"right-handed",27,10,2,39,0.717948718
24,"heavyweight",31,"right-handed",17,0,0,17,1
24,"welterweight",35,"right-handed",31,11,1,43,0.73255814
24,"super bantamweight",28,"right-handed",18,4,0,22,0.818181818
24,"minimumweight",27,"right-handed",16,3,3,22,0.795454545
24,"super flyweight",34,"right-handed",21,10,1,32,0.671875
24,"lightweight",24,"right-handed",9,0,1,10,0.95
24,"super middleweight",30,"right-handed",12,1,2,15,0.866666667
24,"super flyweight",28,"right-handed",16,11,0,27,0.592592593
24,"super lightweight",29,"right-handed",29,4,0,33,0.878787879
24,"featherweight",28,"right-handed",37,18,3,58,0.663793103
24,"middleweight",24,"right-handed",11,1,0,12,0.916666667
24,"lightweight",29,"right-handed",18,4,0,22,0.818181818
24,"super middleweight",30,"right-handed",20,2,0,22,0.909090909
24,"super lightweight",30,"right-handed",19,3,2,24,0.833333333
24,"featherweight",32,"right-handed",21,4,0,25,0.84
23,"light flyweight",23,"right-handed",10,5,1,16,0.65625
23,"flyweight",29,"right-handed",9,2,4,15,0.733333333
23,"featherweight",33,"right-handed",12,4,1,17,0.735294118
23,"cruiserweight",27,"right-handed",12,1,1,14,0.892857143
23,"minimumweight",18,"right-handed",7,0,0,7,1
23,"super welterweight",28,"right-handed",7,1,0,8,0.875
23,"bantamweight",27,"right-handed",7,0,0,7,1
23,"welterweight",22,"right-handed",8,5,1,14,0.607142857
23,"super featherweight",25,"right-handed",24,9,2,35,0.714285714
23,"super lightweight",30,"right-handed",34,4,0,38,0.894736842
25,"lightweight",32,"right-handed",26,7,0,33,0.787878788
25,"super lightweight",26,"right-handed",17,2,0,19,0.894736842
25,"cruiserweight",25,"right-handed",14,0,0,14,1
25,"lightweight",29,"right-handed",27,5,1,33,0.833333333
25,"super featherweight",28,"right-handed",13,0,0,13,1
25,"super welterweight",34,"right-handed",25,22,1,48,0.53125
25,"cruiserweight",34,"right-handed",12,4,3,19,0.710526316
25,"flyweight",20,"right-handed",11,0,0,11,1
25,"cruiserweight",33,"right-handed",26,6,0,32,0.8125
25,"light flyweight",27,"right-handed",13,9,3,25,0.58
25,"featherweight",33,"right-handed",28,6,1,35,0.814285714
25,"bantamweight",27,"right-handed",15,2,0,17,0.882352941
25,"super featherweight",31,"right-handed",27,3,1,31,0.887096774
25,"super lightweight",25,"right-handed",10,0,0,10,1
24,"super welterweight",27,"right-handed",11,1,0,12,0.916666667
24,"super welterweight",25,"right-handed",18,2,0,20,0.9
24,"super flyweight",29,"right-handed",17,17,4,38,0.5
24,"super lightweight",33,"right-handed",29,4,0,33,0.878787879
24,"super lightweight",26,"right-handed",28,3,0,31,0.903225806
24,"featherweight",22,"right-handed",5,0,0,5,1
24,"super welterweight",34,"right-handed",46,6,0,52,0.884615385
24,"cruiserweight",20,"right-handed",7,3,0,10,0.7
24,"featherweight",24,"right-handed",10,1,1,12,0.875
24,"heavyweight",29,"right-handed",10,0,0,10,1
24,"super featherweight",25,"right-handed",25,5,2,32,0.8125
24,"minimumweight",25,"right-handed",19,3,1,23,0.847826087
24,"super featherweight",38,"right-handed",14,16,5,35,0.471428571
24,"middleweight",24,"right-handed",12,0,0,12,1
24,"lightweight",31,"right-handed",25,1,2,28,0.928571429
24,"super flyweight",25,"right-handed",13,2,3,18,0.805555556
24,"super lightweight",26,"right-handed",11,1,2,14,0.857142857
24,"lightweight",21,"right-handed",9,0,0,9,1
24,"middleweight",34,"right-handed",23,6,2,31,0.774193548
24,"featherweight",26,"right-handed",11,0,1,12,0.958333333
24,"super bantamweight",29,"right-handed",29,8,5,42,0.75
24,"super middleweight",32,"right-handed",4,0,0,4,1
24,"super flyweight",32,"right-handed",34,7,1,42,0.821428571
24,"super bantamweight",NA,"right-handed",13,10,1,24,0.5625
24,"heavyweight",36,"right-handed",22,0,2,24,0.958333333
24,"super welterweight",21,"right-handed",11,0,0,11,1
24,"super middleweight",25,"right-handed",11,0,0,11,1
24,"light heavyweight",40,"right-handed",36,17,5,58,0.663793103
24,"middleweight",30,"right-handed",12,0,0,12,1
24,"light heavyweight",30,"right-handed",15,4,0,19,0.789473684
24,"super lightweight",34,"right-handed",12,1,0,13,0.923076923
24,"super bantamweight",23,"right-handed",14,4,3,21,0.738095238
24,"light heavyweight",30,"right-handed",10,0,0,10,1
24,"super featherweight",28,"right-handed",12,3,1,16,0.78125
24,"super flyweight",28,"right-handed",21,3,0,24,0.875
24,"featherweight",25,"right-handed",6,2,0,8,0.75
26,"heavyweight",29,"right-handed",6,0,0,6,1
26,"minimumweight",33,"right-handed",17,7,0,24,0.708333333
26,"featherweight",25,"right-handed",24,3,1,28,0.875
26,"middleweight",27,"right-handed",7,0,1,8,0.9375
26,"light heavyweight",26,"right-handed",14,2,0,16,0.875
26,"super featherweight",29,"right-handed",7,1,0,8,0.875
25,"super middleweight",26,"right-handed",22,1,0,23,0.956521739
25,"heavyweight",34,"right-handed",24,4,0,28,0.857142857
25,"welterweight",28,"right-handed",13,2,0,15,0.866666667
25,"light heavyweight",27,"right-handed",12,0,0,12,1
25,"featherweight",25,"right-handed",10,3,0,13,0.769230769
25,"cruiserweight",38,"right-handed",11,1,0,12,0.916666667
25,"super middleweight",24,"right-handed",11,0,0,11,1
25,"middleweight",26,"right-handed",24,9,2,35,0.714285714
25,"featherweight",28,"right-handed",14,2,0,16,0.875
25,"super welterweight",30,"right-handed",9,1,0,10,0.9
25,"super lightweight",29,"right-handed",12,11,1,24,0.520833333
25,"super featherweight",23,"right-handed",17,1,0,18,0.944444444
25,"super middleweight",33,"right-handed",18,3,2,23,0.826086957
25,"heavyweight",23,"right-handed",11,0,0,11,1
25,"lightweight",23,"right-handed",19,1,0,20,0.95
25,"super bantamweight",26,"right-handed",22,2,4,28,0.857142857
25,"heavyweight",39,"right-handed",32,7,4,43,0.790697674
25,"lightweight",29,"right-handed",21,5,0,26,0.807692308
25,"super lightweight",37,"right-handed",43,14,3,60,0.741666667
25,"bantamweight",22,"right-handed",9,0,0,9,1
25,"light heavyweight",26,"right-handed",7,0,0,7,1
25,"welterweight",35,"right-handed",23,6,1,30,0.783333333
25,"welterweight",29,"right-handed",8,0,1,9,0.944444444
25,"cruiserweight",40,"right-handed",23,0,0,23,1
25,"heavyweight",28,"right-handed",11,0,0,11,1
25,"welterweight",24,"right-handed",12,3,0,15,0.8
25,"welterweight",26,"right-handed",8,0,0,8,1
25,"lightweight",19,"right-handed",13,0,0,13,1
25,"light heavyweight",32,"right-handed",21,4,2,27,0.814814815
25,"featherweight",23,"right-handed",10,6,4,20,0.6
25,"cruiserweight",29,"right-handed",13,2,0,15,0.866666667
25,"welterweight",26,"right-handed",8,0,0,8,1
25,"super welterweight",41,"right-handed",26,5,0,31,0.838709677
25,"super middleweight",28,"right-handed",8,1,0,9,0.888888889
25,"super bantamweight",33,"right-handed",15,13,6,34,0.529411765
25,"lightweight",29,"right-handed",10,0,0,10,1
25,"super middleweight",30,"right-handed",16,1,0,17,0.941176471
25,"super bantamweight",21,"right-handed",9,0,1,10,0.95
25,"super lightweight",20,"right-handed",6,0,0,6,1
25,"lightweight",26,"right-handed",13,0,0,13,1
25,"light heavyweight",25,"right-handed",11,0,0,11,1
25,"featherweight",23,"right-handed",18,3,0,21,0.857142857
25,"heavyweight",36,"right-handed",34,2,2,38,0.921052632
25,"middleweight",34,"right-handed",27,1,0,28,0.964285714
26,"super flyweight",31,"right-handed",18,1,0,19,0.947368421
26,"light heavyweight",25,"right-handed",15,0,0,15,1
26,"super welterweight",39,"right-handed",28,9,0,37,0.756756757
26,"heavyweight",31,"right-handed",9,3,1,13,0.730769231
26,"featherweight",31,"right-handed",18,2,1,21,0.880952381
26,"middleweight",38,"right-handed",43,7,0,50,0.86
26,"welterweight",25,"right-handed",7,1,0,8,0.875
26,"lightweight",32,"right-handed",25,12,0,37,0.675675676
26,"cruiserweight",31,"right-handed",7,2,0,9,0.777777778
26,"super middleweight",31,"right-handed",17,7,0,24,0.708333333
26,"welterweight",27,"right-handed",23,9,2,34,0.705882353
26,"bantamweight",24,"right-handed",11,1,1,13,0.884615385
26,"super lightweight",22,"right-handed",8,2,0,10,0.8
26,"super middleweight",30,"right-handed",22,23,3,48,0.489583333
26,"super welterweight",38,"right-handed",28,2,0,30,0.933333333
26,"super lightweight",30,"right-handed",9,0,0,9,1
26,"heavyweight",34,"right-handed",22,4,1,27,0.833333333
26,"middleweight",34,"right-handed",21,4,1,26,0.826923077
26,"super lightweight",23,"right-handed",7,0,0,7,1
26,"middleweight",30,"right-handed",10,3,0,13,0.769230769
26,"featherweight",24,"right-handed",13,1,0,14,0.928571429
26,"bantamweight",21,"right-handed",11,0,0,11,1
26,"light heavyweight",29,"right-handed",11,1,1,13,0.884615385
26,"super featherweight",23,"right-handed",12,8,2,22,0.590909091
26,"lightweight",25,"right-handed",15,2,0,17,0.882352941
26,"super bantamweight",29,"right-handed",21,4,1,26,0.826923077
26,"middleweight",25,"right-handed",9,0,1,10,0.95
26,"middleweight",38,"right-handed",23,2,1,26,0.903846154
26,"featherweight",25,"right-handed",9,2,1,12,0.791666667
26,"super featherweight",26,"right-handed",13,6,0,19,0.684210526
26,"lightweight",20,"right-handed",15,0,0,15,1
26,"featherweight",21,"right-handed",9,1,0,10,0.9
26,"super featherweight",36,"right-handed",29,6,1,36,0.819444444
26,"lightweight",33,"right-handed",25,5,0,30,0.833333333
26,"super featherweight",23,"right-handed",15,3,1,19,0.815789474
26,"cruiserweight",29,"right-handed",13,0,0,13,1
26,"light heavyweight",39,"right-handed",19,4,0,23,0.826086957
26,"heavyweight",28,"right-handed",12,0,0,12,1
26,"light heavyweight",29,"right-handed",22,0,0,22,1
26,"super featherweight",32,"right-handed",23,11,3,37,0.662162162
26,"minimumweight",26,"right-handed",11,12,3,26,0.480769231
26,"middleweight",31,"right-handed",26,13,3,42,0.654761905
26,"super featherweight",27,"right-handed",25,2,0,27,0.925925926
26,"super bantamweight",25,"right-handed",19,7,0,26,0.730769231
26,"cruiserweight",26,"right-handed",17,2,0,19,0.894736842
26,"welterweight",27,"right-handed",10,2,0,12,0.833333333
26,"super lightweight",37,"right-handed",9,3,1,13,0.730769231
26,"featherweight",25,"right-handed",16,5,2,23,0.739130435
26,"flyweight",28,"right-handed",10,6,3,19,0.605263158
26,"middleweight",30,"right-handed",12,1,1,14,0.892857143
27,"welterweight",24,"right-handed",10,0,0,10,1
27,"heavyweight",22,"right-handed",13,0,0,13,1
27,"super middleweight",24,"right-handed",25,3,2,30,0.866666667
27,"super lightweight",26,"right-handed",18,0,0,18,1
27,"cruiserweight",24,"right-handed",10,1,0,11,0.909090909
27,"super lightweight",22,"right-handed",10,0,0,10,1
27,"super lightweight",33,"right-handed",21,4,3,28,0.803571429
27,"middleweight",27,"right-handed",16,2,0,18,0.888888889
27,"welterweight",26,"right-handed",11,2,0,13,0.846153846
27,"bantamweight",28,"right-handed",23,5,0,28,0.821428571
27,"light heavyweight",37,"right-handed",24,3,0,27,0.888888889
27,"light heavyweight",39,"right-handed",22,26,0,48,0.458333333
27,"bantamweight",24,"right-handed",15,6,3,24,0.6875
27,"cruiserweight",36,"right-handed",19,4,1,24,0.8125
27,"cruiserweight",27,"right-handed",6,0,0,6,1
27,"welterweight",29,"right-handed",15,6,1,22,0.704545455
27,"super featherweight",21,"right-handed",5,2,1,8,0.6875
27,"super middleweight",40,"right-handed",21,11,2,34,0.647058824
27,"super lightweight",23,"right-handed",7,0,0,7,1
27,"welterweight",29,"right-handed",24,6,0,30,0.8
27,"featherweight",28,"right-handed",29,9,1,39,0.756410256
27,"welterweight",29,"right-handed",18,1,0,19,0.947368421
27,"super featherweight",23,"right-handed",18,4,3,25,0.78
27,"super welterweight",24,"right-handed",7,2,3,12,0.708333333
27,"super welterweight",40,"right-handed",28,28,2,58,0.5
27,"minimumweight",21,"right-handed",12,1,0,13,0.923076923
27,"welterweight",25,"right-handed",21,2,1,24,0.895833333
27,"lightweight",30,"right-handed",30,18,2,50,0.62
27,"middleweight",26,"right-handed",9,0,0,9,1
27,"super bantamweight",25,"right-handed",24,17,1,42,0.583333333
27,"cruiserweight",31,"right-handed",10,1,2,13,0.846153846
27,"super featherweight",24,"right-handed",14,0,0,14,1
27,"flyweight",25,"right-handed",16,5,1,22,0.75
27,"welterweight",33,"right-handed",14,4,0,18,0.777777778
27,"super bantamweight",32,"right-handed",21,8,0,29,0.724137931
27,"super lightweight",30,"right-handed",19,5,0,24,0.791666667
27,"cruiserweight",23,"right-handed",18,1,0,19,0.947368421
26,"middleweight",32,"right-handed",23,8,0,31,0.741935484
26,"light heavyweight",35,"right-handed",27,5,0,32,0.84375
26,"middleweight",32,"right-handed",20,4,1,25,0.82
26,"bantamweight",26,"right-handed",10,0,0,10,1
26,"super featherweight",28,"right-handed",17,5,4,26,0.730769231
26,"lightweight",31,"right-handed",26,2,0,28,0.928571429
26,"super flyweight",29,"right-handed",10,2,0,12,0.833333333
26,"flyweight",22,"right-handed",18,0,1,19,0.973684211
26,"super middleweight",26,"right-handed",10,0,1,11,0.954545455
26,"lightweight",30,"right-handed",33,3,2,38,0.894736842
26,"super lightweight",28,"right-handed",14,2,0,16,0.875
26,"light flyweight",24,"right-handed",10,0,0,10,1
26,"lightweight",19,"right-handed",11,0,0,11,1
28,"super bantamweight",25,"right-handed",9,2,0,11,0.818181818
28,"minimumweight",25,"right-handed",9,4,0,13,0.692307692
28,"welterweight",36,"right-handed",22,3,1,26,0.865384615
28,"super middleweight",32,"right-handed",20,7,2,29,0.724137931
28,"super bantamweight",23,"right-handed",18,2,0,20,0.9
28,"super lightweight",29,"right-handed",13,7,2,22,0.636363636
28,"welterweight",25,"right-handed",10,0,0,10,1
28,"super featherweight",25,"right-handed",11,1,0,12,0.916666667
28,"middleweight",31,"right-handed",25,6,2,33,0.787878788
28,"heavyweight",34,"right-handed",31,2,0,33,0.939393939
28,"super welterweight",22,"right-handed",9,0,0,9,1
28,"super middleweight",31,"right-handed",22,1,2,25,0.92
28,"super lightweight",28,"right-handed",14,2,1,17,0.852941176
28,"super welterweight",27,"right-handed",13,4,1,18,0.75
28,"lightweight",29,"right-handed",18,3,2,23,0.826086957
28,"super welterweight",26,"right-handed",14,4,0,18,0.777777778
28,"super welterweight",38,"right-handed",26,4,0,30,0.866666667
28,"welterweight",24,"right-handed",12,1,0,13,0.923076923
28,"super middleweight",37,"right-handed",9,11,1,21,0.452380952
28,"lightweight",27,"right-handed",12,0,0,12,1
28,"middleweight",35,"right-handed",12,1,0,13,0.923076923
28,"super featherweight",21,"right-handed",10,0,1,11,0.954545455
28,"light heavyweight",32,"right-handed",24,5,1,30,0.816666667
28,"super lightweight",28,"right-handed",18,2,0,20,0.9
28,"super flyweight",30,"right-handed",29,8,0,37,0.783783784
28,"welterweight",22,"right-handed",10,2,1,13,0.807692308
28,"lightweight",25,"right-handed",17,0,3,20,0.925
28,"middleweight",25,"right-handed",10,1,0,11,0.909090909
28,"super welterweight",27,"right-handed",20,0,0,20,1
28,"welterweight",26,"right-handed",9,0,0,9,1
28,"middleweight",22,"right-handed",11,0,0,11,1
28,"light flyweight",20,"right-handed",13,2,0,15,0.866666667
28,"featherweight",33,"right-handed",27,9,4,40,0.725
28,"heavyweight",33,"right-handed",10,0,0,10,1
28,"super featherweight",30,"right-handed",22,5,1,28,0.803571429
28,"super lightweight",26,"right-handed",12,3,3,18,0.75
28,"flyweight",30,"right-handed",23,7,1,31,0.758064516
28,"middleweight",38,"right-handed",22,6,1,29,0.775862069
28,"super lightweight",31,"right-handed",33,1,0,34,0.970588235
28,"lightweight",30,"right-handed",24,3,1,28,0.875
27,"middleweight",31,"right-handed",34,3,0,37,0.918918919
27,"heavyweight",30,"right-handed",28,2,0,30,0.933333333
27,"welterweight",28,"right-handed",13,4,1,18,0.75
27,"super middleweight",34,"right-handed",33,3,0,36,0.916666667
27,"light flyweight",33,"right-handed",19,7,1,27,0.722222222
27,"welterweight",26,"right-handed",12,3,0,15,0.8
27,"super welterweight",NA,"right-handed",9,0,0,9,1
27,"heavyweight",42,"right-handed",34,3,0,37,0.918918919
27,"super bantamweight",27,"right-handed",13,2,2,17,0.823529412
27,"super featherweight",24,"right-handed",20,2,0,22,0.909090909
29,"super middleweight",38,"right-handed",29,5,2,36,0.833333333
29,"bantamweight",25,"right-handed",23,11,4,38,0.657894737
29,"heavyweight",44,"right-handed",73,12,0,85,0.858823529
29,"heavyweight",31,"right-handed",25,2,0,27,0.925925926
29,"cruiserweight",31,"right-handed",20,4,0,24,0.833333333
29,"super middleweight",NA,"right-handed",10,0,0,10,1
29,"middleweight",24,"right-handed",12,2,1,15,0.833333333
29,"super bantamweight",33,"right-handed",17,5,4,26,0.730769231
29,"super lightweight",30,"right-handed",14,10,1,25,0.58
29,"lightweight",31,"right-handed",15,2,1,18,0.861111111
29,"middleweight",39,"right-handed",34,10,0,44,0.772727273
29,"super welterweight",28,"right-handed",11,2,0,13,0.846153846
29,"light heavyweight",35,"right-handed",12,4,2,18,0.722222222
29,"super middleweight",36,"right-handed",17,3,0,20,0.85
29,"light heavyweight",27,"right-handed",9,0,0,9,1
29,"super featherweight",26,"right-handed",23,2,0,25,0.92
29,"welterweight",22,"right-handed",8,0,1,9,0.944444444
29,"lightweight",30,"right-handed",23,3,0,26,0.884615385
29,"super welterweight",25,"right-handed",9,0,1,10,0.95
29,"super lightweight",21,"right-handed",11,0,0,11,1
29,"welterweight",20,"right-handed",11,1,0,12,0.916666667
29,"super welterweight",35,"right-handed",19,5,1,25,0.78
29,"lightweight",29,"right-handed",22,3,0,25,0.88
29,"welterweight",24,"right-handed",7,0,0,7,1
29,"middleweight",30,"right-handed",13,3,1,17,0.794117647
29,"super featherweight",23,"right-handed",9,2,0,11,0.818181818
29,"cruiserweight",27,"right-handed",21,4,1,26,0.826923077
29,"super bantamweight",38,"right-handed",28,7,0,35,0.8
29,"super welterweight",20,"right-handed",11,0,0,11,1
29,"super welterweight",36,"right-handed",22,1,0,23,0.956521739
29,"welterweight",NA,"right-handed",9,1,0,10,0.9
29,"lightweight",22,"right-handed",11,0,0,11,1
29,"super featherweight",20,"right-handed",9,2,1,12,0.791666667
29,"welterweight",23,"right-handed",18,0,0,18,1
29,"heavyweight",29,"right-handed",12,7,2,21,0.619047619
29,"flyweight",32,"right-handed",15,1,3,19,0.868421053
29,"super featherweight",25,"right-handed",18,4,2,24,0.791666667
28,"bantamweight",24,"right-handed",10,2,0,12,0.833333333
28,"super middleweight",NA,"right-handed",26,1,1,28,0.946428571
28,"flyweight",23,"right-handed",12,2,1,15,0.833333333
28,"super bantamweight",27,"right-handed",17,3,0,20,0.85
28,"lightweight",39,"right-handed",21,9,3,33,0.681818182
28,"super featherweight",39,"right-handed",39,27,4,70,0.585714286
28,"super bantamweight",17,"right-handed",14,0,0,14,1
28,"heavyweight",29,"right-handed",11,0,0,11,1
28,"bantamweight",34,"right-handed",23,5,1,29,0.810344828
28,"light heavyweight",28,"right-handed",9,0,0,9,1
28,"welterweight",26,"right-handed",14,6,3,23,0.673913043
28,"welterweight",30,"right-handed",19,2,0,21,0.904761905
28,"super featherweight",31,"right-handed",6,0,0,6,1
30,"bantamweight",27,"right-handed",10,9,2,21,0.523809524
30,"super bantamweight",28,"right-handed",18,3,0,21,0.857142857
30,"super featherweight",30,"right-handed",19,3,0,22,0.863636364
30,"super bantamweight",26,"right-handed",11,1,0,12,0.916666667
30,"super bantamweight",25,"right-handed",9,6,1,16,0.59375
30,"cruiserweight",34,"right-handed",25,0,0,25,1
30,"bantamweight",21,"right-handed",29,3,0,32,0.90625
30,"super featherweight",32,"right-handed",34,3,0,37,0.918918919
30,"super welterweight",38,"right-handed",15,41,1,57,0.271929825
30,"welterweight",26,"right-handed",17,2,1,20,0.875
30,"super welterweight",24,"right-handed",12,0,1,13,0.961538462
30,"cruiserweight",28,"right-handed",7,0,0,7,1
30,"super lightweight",31,"right-handed",30,3,0,33,0.909090909
30,"super bantamweight",25,"right-handed",28,4,2,34,0.852941176
30,"super lightweight",28,"right-handed",27,9,0,36,0.75
30,"light heavyweight",29,"right-handed",10,0,0,10,1
30,"super flyweight",35,"right-handed",26,9,1,36,0.736111111
30,"super welterweight",23,"right-handed",15,0,0,15,1
30,"light heavyweight",25,"right-handed",12,0,0,12,1
30,"cruiserweight",26,"right-handed",29,1,0,30,0.966666667
30,"welterweight",40,"right-handed",33,12,2,47,0.723404255
30,"super featherweight",24,"right-handed",16,4,1,21,0.785714286
30,"featherweight",28,"right-handed",13,2,0,15,0.866666667
30,"lightweight",26,"right-handed",10,3,1,14,0.75
30,"super featherweight",34,"right-handed",23,15,1,39,0.602564103
30,"heavyweight",31,"right-handed",14,0,0,14,1
30,"middleweight",38,"right-handed",57,14,0,71,0.802816901
30,"heavyweight",33,"right-handed",19,0,0,19,1
30,"super lightweight",27,"right-handed",22,1,0,23,0.956521739
29,"heavyweight",27,"right-handed",15,2,0,17,0.882352941
29,"super lightweight",27,"right-handed",10,1,0,11,0.909090909
29,"cruiserweight",23,"right-handed",12,0,0,12,1
29,"super lightweight",28,"right-handed",7,2,0,9,0.777777778
29,"super flyweight",22,"right-handed",14,3,0,17,0.823529412
29,"super bantamweight",37,"right-handed",8,4,0,12,0.666666667
29,"super flyweight",28,"right-handed",17,1,0,18,0.944444444
29,"super welterweight",28,"right-handed",12,2,0,14,0.857142857
29,"welterweight",22,"right-handed",9,0,0,9,1
29,"welterweight",22,"right-handed",10,0,0,10,1
29,"super welterweight",26,"right-handed",17,2,0,19,0.894736842
29,"super lightweight",31,"right-handed",15,1,2,18,0.888888889
29,"lightweight",27,"right-handed",15,2,1,18,0.861111111
29,"heavyweight",35,"right-handed",22,6,0,28,0.785714286
29,"welterweight",25,"right-handed",12,1,0,13,0.923076923
29,"bantamweight",22,"right-handed",10,0,1,11,0.954545455
29,"super welterweight",20,"right-handed",9,0,0,9,1
29,"super lightweight",25,"right-handed",9,0,0,9,1
29,"middleweight",25,"right-handed",14,1,0,15,0.933333333
29,"super lightweight",36,"right-handed",27,1,0,28,0.964285714
29,"light heavyweight",23,"right-handed",12,0,0,12,1
31,"light flyweight",25,"right-handed",15,6,1,22,0.704545455
31,"super middleweight",25,"right-handed",24,6,1,31,0.790322581
31,"lightweight",23,"right-handed",17,2,3,22,0.840909091
31,"light heavyweight",27,"right-handed",10,0,0,10,1
31,"bantamweight",25,"right-handed",19,23,2,44,0.454545455
31,"super bantamweight",28,"right-handed",13,8,2,23,0.608695652
31,"super middleweight",34,"right-handed",17,3,1,21,0.833333333
31,"cruiserweight",23,"right-handed",10,0,0,10,1
31,"welterweight",24,"right-handed",11,0,1,12,0.958333333
31,"lightweight",22,"right-handed",10,5,0,15,0.666666667
31,"super middleweight",36,"right-handed",19,4,0,23,0.826086957
31,"super middleweight",39,"right-handed",28,8,2,38,0.763157895
31,"lightweight",29,"right-handed",14,1,0,15,0.933333333
31,"middleweight",28,"right-handed",17,4,0,21,0.80952381
31,"middleweight",26,"right-handed",13,1,0,14,0.928571429
31,"super flyweight",25,"right-handed",19,2,0,21,0.904761905
31,"super welterweight",35,"right-handed",29,10,2,41,0.731707317
31,"middleweight",30,"right-handed",41,3,1,45,0.922222222
31,"cruiserweight",38,"right-handed",30,3,0,33,0.909090909
31,"heavyweight",35,"right-handed",13,0,0,13,1
31,"bantamweight",NA,"right-handed",11,1,0,12,0.916666667
31,"super lightweight",24,"right-handed",13,2,1,16,0.84375
31,"super welterweight",29,"right-handed",20,2,1,23,0.891304348
31,"lightweight",30,"right-handed",10,7,1,18,0.583333333
31,"super middleweight",21,"right-handed",12,1,0,13,0.923076923
31,"super featherweight",24,"right-handed",22,2,0,24,0.916666667
31,"super bantamweight",33,"right-handed",15,6,3,24,0.6875
31,"bantamweight",29,"right-handed",13,10,3,26,0.557692308
31,"welterweight",23,"right-handed",15,0,0,15,1
31,"welterweight",25,"right-handed",25,3,1,29,0.879310345
31,"super bantamweight",30,"right-handed",10,1,0,11,0.909090909
31,"cruiserweight",25,"right-handed",14,1,1,16,0.90625
31,"welterweight",26,"right-handed",16,4,0,20,0.8
31,"light heavyweight",28,"right-handed",13,1,0,14,0.928571429
31,"welterweight",31,"right-handed",8,4,2,14,0.642857143
30,"super welterweight",23,"right-handed",10,0,0,10,1
30,"super flyweight",27,"right-handed",16,8,3,27,0.648148148
30,"flyweight",30,"right-handed",18,2,1,21,0.880952381
30,"super middleweight",26,"right-handed",15,0,0,15,1
30,"super middleweight",27,"right-handed",14,6,0,20,0.7
30,"flyweight",32,"right-handed",68,5,0,73,0.931506849
30,"super welterweight",27,"right-handed",15,1,0,16,0.9375
30,"welterweight",27,"right-handed",9,0,0,9,1
30,"light heavyweight",31,"right-handed",15,1,0,16,0.9375
30,"middleweight",27,"right-handed",12,0,0,12,1
30,"heavyweight",26,"right-handed",12,0,0,12,1
30,"lightweight",22,"right-handed",12,1,0,13,0.923076923
30,"heavyweight",37,"right-handed",37,5,1,43,0.872093023
30,"light heavyweight",36,"right-handed",29,3,0,32,0.90625
30,"super featherweight",30,"right-handed",20,1,0,21,0.952380952
33,"minimumweight",28,"right-handed",15,10,4,29,0.586206897
33,"bantamweight",30,"right-handed",27,10,2,39,0.717948718
33,"lightweight",36,"right-handed",62,9,3,74,0.858108108
33,"welterweight",32,"right-handed",23,4,0,27,0.851851852
33,"super lightweight",24,"right-handed",9,0,0,9,1
33,"super flyweight",26,"right-handed",22,2,0,24,0.916666667
33,"super middleweight",34,"right-handed",34,5,1,40,0.8625
33,"welterweight",30,"right-handed",27,9,1,37,0.743243243
33,"lightweight",31,"right-handed",26,5,0,31,0.838709677
33,"featherweight",27,"right-handed",16,2,1,19,0.868421053
32,"lightweight",41,"right-handed",41,63,1,105,0.395238095
32,"welterweight",28,"right-handed",19,6,2,27,0.740740741
32,"middleweight",24,"right-handed",13,2,0,15,0.866666667
32,"featherweight",24,"right-handed",14,5,2,21,0.714285714
32,"welterweight",25,"right-handed",13,0,0,13,1
32,"featherweight",27,"right-handed",7,4,0,11,0.636363636
32,"middleweight",35,"right-handed",16,3,0,19,0.842105263
32,"super lightweight",33,"right-handed",37,1,0,38,0.973684211
32,"light heavyweight",25,"right-handed",15,2,0,17,0.882352941
32,"super welterweight",36,"right-handed",26,3,0,29,0.896551724
32,"super middleweight",27,"right-handed",9,0,0,9,1
32,"super lightweight",26,"right-handed",24,9,4,37,0.702702703
32,"super lightweight",33,"right-handed",26,11,1,38,0.697368421
32,"minimumweight",22,"right-handed",17,0,0,17,1
32,"middleweight",34,"right-handed",25,3,0,28,0.892857143
32,"welterweight",28,"right-handed",18,2,1,21,0.880952381
32,"cruiserweight",29,"right-handed",12,4,0,16,0.75
32,"middleweight",24,"right-handed",8,0,0,8,1
32,"super welterweight",28,"right-handed",39,3,0,42,0.928571429
32,"flyweight",28,"right-handed",22,13,3,38,0.618421053
32,"heavyweight",34,"right-handed",12,0,1,13,0.961538462
32,"super lightweight",33,"right-handed",13,4,0,17,0.764705882
32,"featherweight",24,"right-handed",17,4,0,21,0.80952381
32,"heavyweight",29,"right-handed",15,0,0,15,1
32,"super lightweight",31,"right-handed",16,2,2,20,0.85
32,"lightweight",NA,"right-handed",23,9,0,32,0.71875
32,"super featherweight",26,"right-handed",16,2,0,18,0.888888889
32,"bantamweight",30,"right-handed",41,6,0,47,0.872340426
32,"super featherweight",23,"right-handed",9,0,2,11,0.909090909
32,"welterweight",29,"right-handed",11,1,1,13,0.884615385
32,"cruiserweight",27,"right-handed",9,1,0,10,0.9
31,"welterweight",25,"right-handed",14,0,1,15,0.966666667
31,"super flyweight",21,"right-handed",11,0,0,11,1
31,"lightweight",29,"right-handed",11,0,0,11,1
31,"heavyweight",32,"right-handed",22,0,0,22,1
31,"flyweight",19,"right-handed",5,0,0,5,1
31,"heavyweight",33,"right-handed",12,0,0,12,1
31,"light heavyweight",30,"right-handed",16,2,0,18,0.888888889
31,"super bantamweight",29,"right-handed",19,10,1,30,0.65
31,"super welterweight",29,"right-handed",14,2,0,16,0.875
34,"super welterweight",30,"right-handed",10,0,0,10,1
34,"super bantamweight",22,"right-handed",17,1,0,18,0.944444444
34,"lightweight",28,"right-handed",10,0,0,10,1
34,"light heavyweight",25,"right-handed",17,8,1,26,0.673076923
34,"super lightweight",26,"right-handed",24,1,0,25,0.96
34,"lightweight",24,"right-handed",14,1,0,15,0.933333333
34,"featherweight",21,"right-handed",13,1,0,14,0.928571429
34,"welterweight",23,"right-handed",10,1,0,11,0.909090909
34,"welterweight",31,"right-handed",35,11,3,49,0.744897959
34,"bantamweight",36,"right-handed",44,14,5,63,0.738095238
34,"featherweight",NA,"right-handed",26,5,1,32,0.828125
34,"welterweight",26,"right-handed",21,5,2,28,0.785714286
34,"super welterweight",26,"right-handed",14,3,1,18,0.805555556
34,"super middleweight",28,"right-handed",11,0,0,11,1
34,"light heavyweight",32,"right-handed",25,10,0,35,0.714285714
34,"super welterweight",27,"right-handed",17,1,1,19,0.921052632
33,"light flyweight",28,"right-handed",12,5,0,17,0.705882353
33,"super featherweight",30,"right-handed",25,2,1,28,0.910714286
33,"lightweight",25,"right-handed",13,2,0,15,0.866666667
33,"super bantamweight",28,"right-handed",12,0,0,12,1
33,"super middleweight",23,"right-handed",14,0,0,14,1
33,"light flyweight",20,"right-handed",10,0,0,10,1
33,"super welterweight",29,"right-handed",19,1,2,22,0.909090909
33,"super lightweight",31,"right-handed",10,1,0,11,0.909090909
33,"welterweight",27,"right-handed",29,6,2,37,0.810810811
33,"light flyweight",24,"right-handed",23,2,0,25,0.92
33,"super middleweight",24,"right-handed",11,1,1,13,0.884615385
33,"lightweight",NA,"right-handed",12,2,0,14,0.857142857
33,"middleweight",26,"right-handed",18,3,0,21,0.857142857
33,"super middleweight",27,"right-handed",17,6,1,24,0.729166667
33,"middleweight",35,"right-handed",23,4,0,27,0.851851852
33,"bantamweight",33,"right-handed",23,5,1,29,0.810344828
33,"flyweight",26,"right-handed",15,5,1,21,0.738095238
33,"super lightweight",31,"right-handed",28,5,0,33,0.848484848
33,"lightweight",32,"right-handed",16,10,1,27,0.611111111
33,"lightweight",29,"right-handed",14,3,1,18,0.805555556
33,"welterweight",19,"right-handed",11,1,0,12,0.916666667
33,"welterweight",25,"right-handed",10,0,0,10,1
33,"super welterweight",32,"right-handed",29,5,0,34,0.852941176
33,"lightweight",25,"right-handed",9,0,0,9,1
33,"light heavyweight",26,"right-handed",25,0,0,25,1
33,"super lightweight",25,"right-handed",18,0,0,18,1
33,"super lightweight",26,"right-handed",36,4,1,41,0.890243902
33,"lightweight",28,"right-handed",11,1,0,12,0.916666667
33,"middleweight",30,"right-handed",30,3,3,36,0.875
33,"light heavyweight",30,"right-handed",17,2,1,20,0.875
33,"super lightweight",26,"right-handed",12,0,0,12,1
33,"middleweight",22,"right-handed",11,1,0,12,0.916666667
33,"super middleweight",24,"right-handed",11,3,0,14,0.785714286
33,"middleweight",32,"right-handed",12,2,0,14,0.857142857
35,"light heavyweight",32,"right-handed",11,1,0,12,0.916666667
35,"super lightweight",28,"right-handed",14,2,0,16,0.875
35,"heavyweight",33,"right-handed",32,3,0,35,0.914285714
35,"welterweight",29,"right-handed",35,8,1,44,0.806818182
35,"bantamweight",21,"right-handed",5,0,0,5,1
35,"heavyweight",37,"right-handed",37,3,0,40,0.925
35,"super welterweight",37,"right-handed",17,5,0,22,0.772727273
35,"super lightweight",32,"right-handed",8,3,1,12,0.708333333
35,"featherweight",39,"right-handed",26,8,1,35,0.757142857
35,"minimumweight",23,"right-handed",9,0,2,11,0.909090909
35,"featherweight",34,"right-handed",29,11,1,41,0.719512195
35,"super middleweight",32,"right-handed",27,2,0,29,0.931034483
35,"bantamweight",23,"right-handed",15,8,1,24,0.645833333
35,"welterweight",37,"right-handed",21,5,1,27,0.796296296
35,"featherweight",23,"right-handed",9,0,1,10,0.95
35,"super flyweight",20,"right-handed",21,2,0,23,0.913043478
35,"flyweight",31,"right-handed",24,1,0,25,0.96
35,"super featherweight",22,"right-handed",10,2,0,12,0.833333333
35,"heavyweight",31,"right-handed",16,2,0,18,0.888888889
35,"featherweight",30,"right-handed",13,7,2,22,0.636363636
35,"middleweight",39,"right-handed",25,2,2,29,0.896551724
35,"super featherweight",28,"right-handed",28,2,1,31,0.919354839
35,"welterweight",33,"right-handed",15,6,0,21,0.714285714
35,"flyweight",30,"right-handed",12,4,0,16,0.75
35,"super lightweight",34,"right-handed",24,4,2,30,0.833333333
35,"super featherweight",24,"right-handed",11,1,0,12,0.916666667
35,"featherweight",29,"right-handed",12,9,1,22,0.568181818
35,"middleweight",31,"right-handed",17,10,1,28,0.625
35,"super welterweight",28,"right-handed",18,4,0,22,0.818181818
34,"middleweight",31,"right-handed",18,8,2,28,0.678571429
34,"super bantamweight",37,"right-handed",17,17,0,34,0.5
34,"super featherweight",29,"right-handed",21,3,0,24,0.875
34,"super lightweight",27,"right-handed",24,3,1,28,0.875
34,"lightweight",26,"right-handed",16,4,0,20,0.8
34,"cruiserweight",28,"right-handed",12,1,0,13,0.923076923
34,"lightweight",25,"right-handed",22,0,1,23,0.97826087
34,"middleweight",34,"right-handed",33,8,0,41,0.804878049
34,"light flyweight",36,"right-handed",59,6,0,65,0.907692308
34,"lightweight",36,"right-handed",22,6,1,29,0.775862069
34,"cruiserweight",35,"right-handed",12,0,0,12,1
34,"super lightweight",24,"right-handed",15,0,0,15,1
34,"welterweight",24,"right-handed",18,6,2,26,0.730769231
34,"super bantamweight",22,"right-handed",16,1,0,17,0.941176471
34,"cruiserweight",32,"right-handed",17,2,0,19,0.894736842
34,"light heavyweight",26,"right-handed",9,0,0,9,1
34,"super lightweight",26,"right-handed",20,1,0,21,0.952380952
34,"flyweight",27,"right-handed",11,2,0,13,0.846153846
34,"lightweight",28,"right-handed",22,4,0,26,0.846153846
34,"super lightweight",36,"right-handed",32,2,1,35,0.928571429
34,"super welterweight",34,"right-handed",28,4,0,32,0.875
37,"featherweight",35,"right-handed",38,5,2,45,0.866666667
37,"super middleweight",25,"right-handed",14,1,0,15,0.933333333
37,"super middleweight",28,"right-handed",5,0,0,5,1
37,"middleweight",26,"right-handed",22,2,1,25,0.9
37,"super bantamweight",22,"right-handed",15,0,0,15,1
37,"welterweight",39,"right-handed",39,6,3,48,0.84375
37,"super featherweight",22,"right-handed",14,2,1,17,0.852941176
37,"super bantamweight",22,"right-handed",13,1,1,15,0.9
37,"flyweight",27,"right-handed",13,1,0,14,0.928571429
37,"cruiserweight",33,"right-handed",19,1,1,21,0.928571429
37,"light heavyweight",26,"right-handed",16,1,1,18,0.916666667
37,"welterweight",NA,"right-handed",17,4,2,23,0.782608696
37,"super bantamweight",22,"right-handed",15,1,1,17,0.911764706
37,"super lightweight",29,"right-handed",16,1,0,17,0.941176471
37,"featherweight",26,"right-handed",17,2,2,21,0.857142857
37,"super welterweight",26,"right-handed",23,2,0,25,0.92
37,"middleweight",33,"right-handed",27,7,2,36,0.777777778
37,"heavyweight",24,"right-handed",7,0,0,7,1
37,"welterweight",31,"right-handed",13,2,0,15,0.866666667
37,"welterweight",37,"right-handed",28,3,2,33,0.878787879
37,"lightweight",26,"right-handed",14,1,0,15,0.933333333
37,"bantamweight",23,"right-handed",13,0,0,13,1
36,"featherweight",26,"right-handed",18,11,1,30,0.616666667
36,"welterweight",35,"right-handed",38,21,5,64,0.6328125
36,"super middleweight",24,"right-handed",12,0,0,12,1
36,"super featherweight",27,"right-handed",17,3,1,21,0.833333333
36,"super bantamweight",33,"right-handed",45,12,2,59,0.779661017
36,"super lightweight",28,"right-handed",9,0,0,9,1
36,"super lightweight",29,"right-handed",10,0,0,10,1
36,"bantamweight",NA,"right-handed",16,9,1,26,0.634615385
36,"super bantamweight",NA,"right-handed",10,0,0,10,1
36,"super featherweight",27,"right-handed",16,1,0,17,0.941176471
36,"cruiserweight",43,"right-handed",49,19,2,70,0.714285714
36,"welterweight",25,"right-handed",11,3,3,17,0.735294118
36,"super featherweight",39,"right-handed",14,8,1,23,0.630434783
36,"welterweight",27,"right-handed",20,1,0,21,0.952380952
36,"super featherweight",22,"right-handed",11,0,0,11,1
36,"super middleweight",33,"right-handed",15,0,0,15,1
36,"minimumweight",22,"right-handed",5,0,0,5,1
36,"super bantamweight",31,"right-handed",22,9,0,31,0.709677419
36,"super bantamweight",33,"right-handed",25,17,1,43,0.593023256
36,"super bantamweight",27,"right-handed",21,3,2,26,0.846153846
36,"super featherweight",30,"right-handed",20,1,0,21,0.952380952
36,"cruiserweight",27,"right-handed",16,0,1,17,0.970588235
36,"super middleweight",30,"right-handed",38,9,0,47,0.808510638
36,"super featherweight",24,"right-handed",13,1,0,14,0.928571429
36,"middleweight",29,"right-handed",15,0,0,15,1
35,"flyweight",24,"right-handed",15,3,0,18,0.833333333
35,"lightweight",33,"right-handed",11,3,0,14,0.785714286
35,"welterweight",28,"right-handed",35,5,2,42,0.857142857
38,"welterweight",34,"right-handed",24,5,1,30,0.816666667
38,"light heavyweight",32,"right-handed",27,3,3,33,0.863636364
38,"super lightweight",27,"right-handed",12,4,0,16,0.75
38,"heavyweight",32,"right-handed",18,1,0,19,0.947368421
38,"welterweight",22,"right-handed",13,0,0,13,1
38,"featherweight",34,"right-handed",19,0,0,19,1
38,"middleweight",23,"right-handed",19,3,0,22,0.863636364
38,"super welterweight",29,"right-handed",25,3,1,29,0.879310345
38,"super lightweight",26,"right-handed",12,1,0,13,0.923076923
38,"light heavyweight",28,"right-handed",18,13,3,34,0.573529412
38,"welterweight",23,"right-handed",8,0,0,8,1
38,"light flyweight",26,"right-handed",30,4,1,35,0.871428571
38,"lightweight",29,"right-handed",23,3,1,27,0.87037037
38,"welterweight",23,"right-handed",19,0,0,19,1
38,"middleweight",27,"right-handed",12,1,1,14,0.892857143
38,"featherweight",29,"right-handed",19,2,2,23,0.869565217
38,"lightweight",23,"right-handed",14,3,0,17,0.823529412
38,"super featherweight",25,"right-handed",20,1,0,21,0.952380952
38,"super middleweight",34,"right-handed",26,9,1,36,0.736111111
38,"welterweight",34,"right-handed",17,5,1,23,0.760869565
38,"cruiserweight",39,"right-handed",19,3,1,23,0.847826087
38,"super middleweight",39,"right-handed",35,8,1,44,0.806818182
38,"lightweight",24,"right-handed",19,2,0,21,0.904761905
38,"super flyweight",28,"right-handed",14,10,4,28,0.571428571
38,"super middleweight",33,"right-handed",10,1,0,11,0.909090909
38,"super flyweight",21,"right-handed",9,1,0,10,0.9
38,"super bantamweight",31,"right-handed",11,9,3,23,0.543478261
38,"super welterweight",21,"right-handed",15,0,0,15,1
38,"super welterweight",25,"right-handed",19,1,0,20,0.95
38,"super middleweight",20,"right-handed",15,0,1,16,0.96875
38,"super featherweight",30,"right-handed",10,0,0,10,1
38,"super featherweight",29,"right-handed",35,8,1,44,0.806818182
38,"middleweight",33,"right-handed",30,5,1,36,0.847222222
38,"super featherweight",24,"right-handed",20,3,1,24,0.854166667
38,"super featherweight",24,"right-handed",13,0,0,13,1
37,"lightweight",24,"right-handed",9,0,0,9,1
37,"super middleweight",31,"right-handed",37,5,0,42,0.880952381
37,"cruiserweight",35,"right-handed",19,1,0,20,0.95
37,"super featherweight",28,"right-handed",14,6,1,21,0.69047619
37,"welterweight",28,"right-handed",18,3,0,21,0.857142857
37,"super flyweight",30,"right-handed",34,13,4,51,0.705882353
37,"middleweight",29,"right-handed",21,4,0,25,0.84
37,"super bantamweight",29,"right-handed",36,5,2,43,0.860465116
37,"light flyweight",29,"right-handed",28,9,1,38,0.75
37,"super featherweight",27,"right-handed",13,0,1,14,0.964285714
37,"light flyweight",35,"right-handed",18,13,3,34,0.573529412
37,"featherweight",31,"right-handed",31,1,0,32,0.96875
37,"welterweight",35,"right-handed",24,5,2,31,0.806451613
37,"middleweight",32,"right-handed",11,2,0,13,0.846153846
37,"super bantamweight",28,"right-handed",3,0,0,3,1
40,"bantamweight",30,"right-handed",17,0,1,18,0.972222222
40,"middleweight",28,"right-handed",16,0,0,16,1
40,"cruiserweight",40,"right-handed",20,1,0,21,0.952380952
40,"super lightweight",29,"right-handed",10,0,1,11,0.954545455
40,"super lightweight",35,"right-handed",34,4,2,40,0.875
40,"cruiserweight",49,"right-handed",36,5,2,43,0.860465116
40,"welterweight",28,"right-handed",18,3,0,21,0.857142857
40,"super flyweight",31,"right-handed",15,2,0,17,0.882352941
40,"super bantamweight",21,"right-handed",17,1,0,18,0.944444444
40,"heavyweight",29,"right-handed",15,0,0,15,1
40,"heavyweight",29,"right-handed",15,1,0,16,0.9375
40,"super lightweight",34,"right-handed",10,1,0,11,0.909090909
39,"middleweight",35,"right-handed",41,0,1,42,0.988095238
39,"super lightweight",34,"right-handed",29,12,2,43,0.697674419
39,"flyweight",31,"right-handed",5,1,0,6,0.833333333
39,"lightweight",24,"right-handed",10,4,0,14,0.714285714
39,"featherweight",23,"right-handed",19,0,0,19,1
39,"middleweight",31,"right-handed",35,3,1,39,0.91025641
39,"super featherweight",27,"right-handed",27,7,0,34,0.794117647
39,"super lightweight",29,"right-handed",13,0,0,13,1
39,"super middleweight",28,"right-handed",15,3,3,21,0.785714286
39,"featherweight",27,"right-handed",16,6,2,24,0.708333333
39,"middleweight",39,"right-handed",12,8,1,21,0.595238095
39,"minimumweight",29,"right-handed",14,5,2,21,0.714285714
39,"lightweight",28,"right-handed",18,3,0,21,0.857142857
39,"welterweight",32,"right-handed",20,3,0,23,0.869565217
39,"middleweight",29,"right-handed",9,0,0,9,1
39,"light heavyweight",25,"right-handed",18,2,0,20,0.9
39,"light flyweight",26,"right-handed",12,0,4,16,0.875
39,"bantamweight",22,"right-handed",13,4,0,17,0.764705882
39,"featherweight",24,"right-handed",14,7,1,22,0.659090909
39,"lightweight",29,"right-handed",12,1,1,14,0.892857143
39,"lightweight",26,"right-handed",20,2,0,22,0.909090909
39,"flyweight",27,"right-handed",15,0,0,15,1
39,"middleweight",28,"right-handed",37,5,1,43,0.872093023
39,"bantamweight",38,"right-handed",18,3,0,21,0.857142857
39,"super welterweight",24,"right-handed",18,3,0,21,0.857142857
39,"super middleweight",23,"right-handed",14,0,1,15,0.966666667
39,"super featherweight",21,"right-handed",12,0,0,12,1
39,"bantamweight",31,"right-handed",18,2,2,22,0.863636364
39,"featherweight",21,"right-handed",10,2,1,13,0.807692308
39,"light heavyweight",30,"right-handed",12,0,0,12,1
39,"super lightweight",34,"right-handed",22,5,0,27,0.814814815
39,"welterweight",27,"right-handed",10,0,0,10,1
39,"welterweight",35,"right-handed",18,0,0,18,1
39,"super flyweight",22,"right-handed",15,3,1,19,0.815789474
39,"welterweight",25,"right-handed",15,0,1,16,0.96875
39,"flyweight",26,"right-handed",18,5,2,25,0.76
38,"welterweight",28,"right-handed",16,5,1,22,0.75
38,"middleweight",31,"right-handed",33,8,0,41,0.804878049
42,"flyweight",25,"right-handed",14,0,0,14,1
42,"super middleweight",27,"right-handed",8,2,0,10,0.8
42,"super welterweight",26,"right-handed",39,1,0,40,0.975
42,"super lightweight",29,"right-handed",30,4,1,35,0.871428571
42,"lightweight",NA,"right-handed",28,5,1,34,0.838235294
42,"bantamweight",24,"right-handed",12,1,1,14,0.892857143
42,"bantamweight",22,"right-handed",11,5,1,17,0.676470588
42,"super flyweight",26,"right-handed",10,1,0,11,0.909090909
42,"super featherweight",23,"right-handed",19,4,0,23,0.826086957
41,"super featherweight",25,"right-handed",14,2,0,16,0.875
41,"heavyweight",28,"right-handed",10,0,0,10,1
41,"super welterweight",28,"right-handed",18,1,1,20,0.925
41,"super featherweight",23,"right-handed",14,0,0,14,1
41,"flyweight",25,"right-handed",17,1,0,18,0.944444444
41,"cruiserweight",35,"right-handed",20,0,0,20,1
41,"super welterweight",23,"right-handed",12,0,0,12,1
41,"lightweight",26,"right-handed",15,0,0,15,1
41,"featherweight",28,"right-handed",27,3,0,30,0.9
41,"super welterweight",28,"right-handed",23,8,1,32,0.734375
41,"featherweight",29,"right-handed",52,5,0,57,0.912280702
41,"welterweight",27,"right-handed",27,2,1,30,0.916666667
41,"super flyweight",22,"right-handed",9,0,0,9,1
41,"cruiserweight",33,"right-handed",17,1,0,18,0.944444444
41,"welterweight",33,"right-handed",20,3,0,23,0.869565217
41,"minimumweight",22,"right-handed",16,1,1,18,0.916666667
41,"cruiserweight",28,"right-handed",24,6,0,30,0.8
41,"middleweight",36,"right-handed",25,3,1,29,0.879310345
41,"welterweight",26,"right-handed",13,3,1,17,0.794117647
41,"bantamweight",26,"right-handed",23,14,2,39,0.615384615
41,"super welterweight",36,"right-handed",19,3,1,23,0.847826087
41,"super bantamweight",21,"right-handed",19,0,0,19,1
41,"super lightweight",23,"right-handed",8,0,0,8,1
41,"heavyweight",36,"right-handed",19,3,0,22,0.863636364
41,"lightweight",20,"right-handed",10,0,0,10,1
41,"super bantamweight",25,"right-handed",17,4,1,22,0.795454545
41,"super lightweight",32,"right-handed",23,8,1,32,0.734375
41,"super lightweight",27,"right-handed",11,1,0,12,0.916666667
41,"super bantamweight",32,"right-handed",26,1,0,27,0.962962963
40,"bantamweight",24,"right-handed",12,2,1,15,0.833333333
40,"super flyweight",31,"right-handed",13,3,1,17,0.794117647
40,"super lightweight",22,"right-handed",13,0,0,13,1
40,"cruiserweight",25,"right-handed",19,1,0,20,0.95
40,"light flyweight",24,"right-handed",14,2,0,16,0.875
40,"super bantamweight",28,"right-handed",9,3,0,12,0.75
40,"welterweight",29,"right-handed",9,0,0,9,1
40,"cruiserweight",34,"right-handed",18,17,2,37,0.513513514
40,"super welterweight",25,"right-handed",13,1,1,15,0.9
40,"featherweight",24,"right-handed",13,0,0,13,1
40,"lightweight",31,"right-handed",23,3,0,26,0.884615385
40,"super bantamweight",23,"right-handed",15,5,3,23,0.717391304
40,"bantamweight",30,"right-handed",17,0,1,18,0.972222222
40,"middleweight",28,"right-handed",16,0,0,16,1
40,"cruiserweight",40,"right-handed",20,1,0,21,0.952380952
40,"super lightweight",29,"right-handed",10,0,1,11,0.954545455
40,"super lightweight",35,"right-handed",34,4,2,40,0.875
40,"cruiserweight",49,"right-handed",36,5,2,43,0.860465116
40,"welterweight",28,"right-handed",18,3,0,21,0.857142857
40,"super flyweight",31,"right-handed",15,2,0,17,0.882352941
40,"super bantamweight",21,"right-handed",17,1,0,18,0.944444444
40,"heavyweight",29,"right-handed",15,0,0,15,1
40,"heavyweight",29,"right-handed",15,1,0,16,0.9375
40,"super lightweight",34,"right-handed",10,1,0,11,0.909090909
39,"middleweight",35,"right-handed",41,0,1,42,0.988095238
39,"super lightweight",34,"right-handed",29,12,2,43,0.697674419
39,"flyweight",31,"right-handed",5,1,0,6,0.833333333
39,"lightweight",24,"right-handed",10,4,0,14,0.714285714
39,"featherweight",23,"right-handed",19,0,0,19,1
39,"middleweight",31,"right-handed",35,3,1,39,0.91025641
39,"super featherweight",27,"right-handed",27,7,0,34,0.794117647
39,"super lightweight",29,"right-handed",13,0,0,13,1
39,"super middleweight",28,"right-handed",15,3,3,21,0.785714286
39,"featherweight",27,"right-handed",16,6,2,24,0.708333333
39,"middleweight",39,"right-handed",12,8,1,21,0.595238095
39,"minimumweight",29,"right-handed",14,5,2,21,0.714285714
39,"lightweight",28,"right-handed",18,3,0,21,0.857142857
39,"welterweight",32,"right-handed",20,3,0,23,0.869565217
39,"middleweight",29,"right-handed",9,0,0,9,1
39,"light heavyweight",25,"right-handed",18,2,0,20,0.9
39,"light flyweight",26,"right-handed",12,0,4,16,0.875
39,"bantamweight",22,"right-handed",13,4,0,17,0.764705882
39,"featherweight",24,"right-handed",14,7,1,22,0.659090909
39,"lightweight",29,"right-handed",12,1,1,14,0.892857143
39,"lightweight",26,"right-handed",20,2,0,22,0.909090909
39,"flyweight",27,"right-handed",15,0,0,15,1
39,"middleweight",28,"right-handed",37,5,1,43,0.872093023
39,"bantamweight",38,"right-handed",18,3,0,21,0.857142857
39,"super welterweight",24,"right-handed",18,3,0,21,0.857142857
39,"super middleweight",23,"right-handed",14,0,1,15,0.966666667
39,"super featherweight",21,"right-handed",12,0,0,12,1
39,"bantamweight",31,"right-handed",18,2,2,22,0.863636364
39,"featherweight",21,"right-handed",10,2,1,13,0.807692308
39,"light heavyweight",30,"right-handed",12,0,0,12,1
39,"super lightweight",34,"right-handed",22,5,0,27,0.814814815
39,"welterweight",27,"right-handed",10,0,0,10,1
39,"welterweight",35,"right-handed",18,0,0,18,1
39,"super flyweight",22,"right-handed",15,3,1,19,0.815789474
39,"welterweight",25,"right-handed",15,0,1,16,0.96875
39,"flyweight",26,"right-handed",18,5,2,25,0.76
38,"welterweight",28,"right-handed",16,5,1,22,0.75
38,"middleweight",31,"right-handed",33,8,0,41,0.804878049
38,"welterweight",34,"right-handed",24,5,1,30,0.816666667
38,"light heavyweight",32,"right-handed",27,3,3,33,0.863636364
38,"super lightweight",27,"right-handed",12,4,0,16,0.75
38,"heavyweight",32,"right-handed",18,1,0,19,0.947368421
38,"welterweight",22,"right-handed",13,0,0,13,1
38,"featherweight",34,"right-handed",19,0,0,19,1
38,"middleweight",23,"right-handed",19,3,0,22,0.863636364
38,"super welterweight",29,"right-handed",25,3,1,29,0.879310345
38,"super lightweight",26,"right-handed",12,1,0,13,0.923076923
38,"light heavyweight",28,"right-handed",18,13,3,34,0.573529412
38,"welterweight",23,"right-handed",8,0,0,8,1
38,"light flyweight",26,"right-handed",30,4,1,35,0.871428571
38,"lightweight",29,"right-handed",23,3,1,27,0.87037037
38,"welterweight",23,"right-handed",19,0,0,19,1
38,"middleweight",27,"right-handed",12,1,1,14,0.892857143
38,"featherweight",29,"right-handed",19,2,2,23,0.869565217
38,"lightweight",23,"right-handed",14,3,0,17,0.823529412
38,"super featherweight",25,"right-handed",20,1,0,21,0.952380952
38,"super middleweight",34,"right-handed",26,9,1,36,0.736111111
38,"welterweight",34,"right-handed",17,5,1,23,0.760869565
38,"cruiserweight",39,"right-handed",19,3,1,23,0.847826087
38,"super middleweight",39,"right-handed",35,8,1,44,0.806818182
38,"lightweight",24,"right-handed",19,2,0,21,0.904761905
38,"super flyweight",28,"right-handed",14,10,4,28,0.571428571
38,"super middleweight",33,"right-handed",10,1,0,11,0.909090909
38,"super flyweight",21,"right-handed",9,1,0,10,0.9
38,"super bantamweight",31,"right-handed",11,9,3,23,0.543478261
38,"super welterweight",21,"right-handed",15,0,0,15,1
38,"super welterweight",25,"right-handed",19,1,0,20,0.95
38,"super middleweight",20,"right-handed",15,0,1,16,0.96875
38,"super featherweight",30,"right-handed",10,0,0,10,1
38,"super featherweight",29,"right-handed",35,8,1,44,0.806818182
38,"middleweight",33,"right-handed",30,5,1,36,0.847222222
38,"super featherweight",24,"right-handed",20,3,1,24,0.854166667
38,"super featherweight",24,"right-handed",13,0,0,13,1
37,"lightweight",24,"right-handed",9,0,0,9,1
37,"super middleweight",31,"right-handed",37,5,0,42,0.880952381
37,"cruiserweight",35,"right-handed",19,1,0,20,0.95
37,"super featherweight",28,"right-handed",14,6,1,21,0.69047619
37,"welterweight",28,"right-handed",18,3,0,21,0.857142857
37,"super flyweight",30,"right-handed",34,13,4,51,0.705882353
37,"middleweight",29,"right-handed",21,4,0,25,0.84
37,"super bantamweight",29,"right-handed",36,5,2,43,0.860465116
37,"light flyweight",29,"right-handed",28,9,1,38,0.75
37,"super featherweight",27,"right-handed",13,0,1,14,0.964285714
37,"light flyweight",35,"right-handed",18,13,3,34,0.573529412
37,"featherweight",31,"right-handed",31,1,0,32,0.96875
37,"welterweight",35,"right-handed",24,5,2,31,0.806451613
37,"middleweight",32,"right-handed",11,2,0,13,0.846153846
37,"super bantamweight",28,"right-handed",3,0,0,3,1
40,"bantamweight",30,"right-handed",17,0,1,18,0.972222222
40,"middleweight",28,"right-handed",16,0,0,16,1
40,"cruiserweight",40,"right-handed",20,1,0,21,0.952380952
40,"super lightweight",29,"right-handed",10,0,1,11,0.954545455
40,"super lightweight",35,"right-handed",34,4,2,40,0.875
40,"cruiserweight",49,"right-handed",36,5,2,43,0.860465116
40,"welterweight",28,"right-handed",18,3,0,21,0.857142857
40,"super flyweight",31,"right-handed",15,2,0,17,0.882352941
40,"super bantamweight",21,"right-handed",17,1,0,18,0.944444444
40,"heavyweight",29,"right-handed",15,0,0,15,1
40,"heavyweight",29,"right-handed",15,1,0,16,0.9375
40,"super lightweight",34,"right-handed",10,1,0,11,0.909090909
39,"middleweight",35,"right-handed",41,0,1,42,0.988095238
39,"super lightweight",34,"right-handed",29,12,2,43,0.697674419
39,"flyweight",31,"right-handed",5,1,0,6,0.833333333
39,"lightweight",24,"right-handed",10,4,0,14,0.714285714
39,"featherweight",23,"right-handed",19,0,0,19,1
39,"middleweight",31,"right-handed",35,3,1,39,0.91025641
39,"super featherweight",27,"right-handed",27,7,0,34,0.794117647
39,"super lightweight",29,"right-handed",13,0,0,13,1
39,"super middleweight",28,"right-handed",15,3,3,21,0.785714286
39,"featherweight",27,"right-handed",16,6,2,24,0.708333333
39,"middleweight",39,"right-handed",12,8,1,21,0.595238095
39,"minimumweight",29,"right-handed",14,5,2,21,0.714285714
39,"lightweight",28,"right-handed",18,3,0,21,0.857142857
39,"welterweight",32,"right-handed",20,3,0,23,0.869565217
39,"middleweight",29,"right-handed",9,0,0,9,1
39,"light heavyweight",25,"right-handed",18,2,0,20,0.9
39,"light flyweight",26,"right-handed",12,0,4,16,0.875
39,"bantamweight",22,"right-handed",13,4,0,17,0.764705882
39,"featherweight",24,"right-handed",14,7,1,22,0.659090909
39,"lightweight",29,"right-handed",12,1,1,14,0.892857143
39,"lightweight",26,"right-handed",20,2,0,22,0.909090909
39,"flyweight",27,"right-handed",15,0,0,15,1
39,"middleweight",28,"right-handed",37,5,1,43,0.872093023
39,"bantamweight",38,"right-handed",18,3,0,21,0.857142857
39,"super welterweight",24,"right-handed",18,3,0,21,0.857142857
39,"super middleweight",23,"right-handed",14,0,1,15,0.966666667
39,"super featherweight",21,"right-handed",12,0,0,12,1
39,"bantamweight",31,"right-handed",18,2,2,22,0.863636364
39,"featherweight",21,"right-handed",10,2,1,13,0.807692308
39,"light heavyweight",30,"right-handed",12,0,0,12,1
39,"super lightweight",34,"right-handed",22,5,0,27,0.814814815
39,"welterweight",27,"right-handed",10,0,0,10,1
39,"welterweight",35,"right-handed",18,0,0,18,1
39,"super flyweight",22,"right-handed",15,3,1,19,0.815789474
39,"welterweight",25,"right-handed",15,0,1,16,0.96875
39,"flyweight",26,"right-handed",18,5,2,25,0.76
38,"welterweight",28,"right-handed",16,5,1,22,0.75
38,"middleweight",31,"right-handed",33,8,0,41,0.804878049
42,"flyweight",25,"right-handed",14,0,0,14,1
42,"super middleweight",27,"right-handed",8,2,0,10,0.8
42,"super welterweight",26,"right-handed",39,1,0,40,0.975
42,"super lightweight",29,"right-handed",30,4,1,35,0.871428571
42,"lightweight",NA,"right-handed",28,5,1,34,0.838235294
42,"bantamweight",24,"right-handed",12,1,1,14,0.892857143
42,"bantamweight",22,"right-handed",11,5,1,17,0.676470588
42,"super flyweight",26,"right-handed",10,1,0,11,0.909090909
42,"super featherweight",23,"right-handed",19,4,0,23,0.826086957
41,"super featherweight",25,"right-handed",14,2,0,16,0.875
41,"heavyweight",28,"right-handed",10,0,0,10,1
41,"super welterweight",28,"right-handed",18,1,1,20,0.925
41,"super featherweight",23,"right-handed",14,0,0,14,1
41,"flyweight",25,"right-handed",17,1,0,18,0.944444444
41,"cruiserweight",35,"right-handed",20,0,0,20,1
41,"super welterweight",23,"right-handed",12,0,0,12,1
41,"lightweight",26,"right-handed",15,0,0,15,1
41,"featherweight",28,"right-handed",27,3,0,30,0.9
41,"super welterweight",28,"right-handed",23,8,1,32,0.734375
41,"featherweight",29,"right-handed",52,5,0,57,0.912280702
41,"welterweight",27,"right-handed",27,2,1,30,0.916666667
41,"super flyweight",22,"right-handed",9,0,0,9,1
41,"cruiserweight",33,"right-handed",17,1,0,18,0.944444444
41,"welterweight",33,"right-handed",20,3,0,23,0.869565217
41,"minimumweight",22,"right-handed",16,1,1,18,0.916666667
41,"cruiserweight",28,"right-handed",24,6,0,30,0.8
41,"middleweight",36,"right-handed",25,3,1,29,0.879310345
41,"welterweight",26,"right-handed",13,3,1,17,0.794117647
41,"bantamweight",26,"right-handed",23,14,2,39,0.615384615
41,"super welterweight",36,"right-handed",19,3,1,23,0.847826087
41,"super bantamweight",21,"right-handed",19,0,0,19,1
41,"super lightweight",23,"right-handed",8,0,0,8,1
41,"heavyweight",36,"right-handed",19,3,0,22,0.863636364
41,"lightweight",20,"right-handed",10,0,0,10,1
41,"super bantamweight",25,"right-handed",17,4,1,22,0.795454545
41,"super lightweight",32,"right-handed",23,8,1,32,0.734375
41,"super lightweight",27,"right-handed",11,1,0,12,0.916666667
41,"super bantamweight",32,"right-handed",26,1,0,27,0.962962963
40,"bantamweight",24,"right-handed",12,2,1,15,0.833333333
40,"super flyweight",31,"right-handed",13,3,1,17,0.794117647
40,"super lightweight",22,"right-handed",13,0,0,13,1
40,"cruiserweight",25,"right-handed",19,1,0,20,0.95
40,"light flyweight",24,"right-handed",14,2,0,16,0.875
40,"super bantamweight",28,"right-handed",9,3,0,12,0.75
40,"welterweight",29,"right-handed",9,0,0,9,1
40,"cruiserweight",34,"right-handed",18,17,2,37,0.513513514
40,"super welterweight",25,"right-handed",13,1,1,15,0.9
40,"featherweight",24,"right-handed",13,0,0,13,1
40,"lightweight",31,"right-handed",23,3,0,26,0.884615385
40,"super bantamweight",23,"right-handed",15,5,3,23,0.717391304
44,"bantamweight",33,"right-handed",29,3,1,33,0.893939394
44,"super featherweight",27,"right-handed",15,4,1,20,0.775
44,"super lightweight",31,"right-handed",23,5,0,28,0.821428571
44,"light heavyweight",31,"right-handed",21,5,0,26,0.807692308
44,"super lightweight",29,"right-handed",21,3,0,24,0.875
44,"featherweight",24,"right-handed",14,0,0,14,1
44,"lightweight",29,"right-handed",15,5,2,22,0.727272727
44,"super lightweight",27,"right-handed",8,3,2,13,0.692307692
44,"flyweight",25,"right-handed",16,12,4,32,0.5625
44,"super bantamweight",21,"right-handed",13,1,0,14,0.928571429
43,"bantamweight",22,"right-handed",11,0,0,11,1
43,"featherweight",28,"right-handed",39,8,5,52,0.798076923
43,"super flyweight",24,"right-handed",26,3,1,30,0.883333333
43,"middleweight",25,"right-handed",10,0,0,10,1
43,"welterweight",33,"right-handed",18,4,1,23,0.804347826
43,"featherweight",27,"right-handed",17,3,1,21,0.833333333
43,"super welterweight",24,"right-handed",4,0,0,4,1
43,"super middleweight",28,"right-handed",10,0,0,10,1
43,"middleweight",26,"right-handed",5,0,0,5,1
43,"super middleweight",32,"right-handed",14,5,1,20,0.725
43,"flyweight",29,"right-handed",16,7,0,23,0.695652174
43,"flyweight",30,"right-handed",14,8,2,24,0.625
43,"super welterweight",32,"right-handed",27,7,3,37,0.77027027
43,"super welterweight",26,"right-handed",11,0,0,11,1
43,"light heavyweight",35,"right-handed",19,5,0,24,0.791666667
43,"middleweight",30,"right-handed",28,2,0,30,0.933333333
43,"middleweight",24,"right-handed",12,0,1,13,0.961538462
43,"welterweight",34,"right-handed",22,3,0,25,0.88
43,"super bantamweight",27,"right-handed",22,1,0,23,0.956521739
43,"super middleweight",27,"right-handed",17,0,1,18,0.972222222
42,"super welterweight",23,"right-handed",1,0,0,1,1
42,"super featherweight",35,"right-handed",24,5,0,29,0.827586207
42,"super bantamweight",27,"right-handed",14,7,0,21,0.666666667
42,"welterweight",36,"right-handed",29,13,4,46,0.673913043
42,"middleweight",24,"right-handed",14,0,0,14,1
42,"super featherweight",23,"right-handed",15,0,0,15,1
42,"super middleweight",28,"right-handed",17,1,0,18,0.944444444
42,"super featherweight",20,"right-handed",14,0,0,14,1
42,"super welterweight",32,"right-handed",29,4,0,33,0.878787879
42,"super bantamweight",21,"right-handed",18,0,0,18,1
42,"featherweight",27,"right-handed",8,0,1,9,0.944444444
42,"super featherweight",32,"right-handed",27,1,0,28,0.964285714
42,"flyweight",23,"right-handed",4,0,0,4,1
42,"minimumweight",25,"right-handed",14,5,1,20,0.725
42,"heavyweight",32,"right-handed",31,3,0,34,0.911764706
42,"super lightweight",25,"right-handed",12,0,0,12,1
42,"featherweight",22,"right-handed",11,1,0,12,0.916666667
42,"light flyweight",24,"right-handed",12,4,1,17,0.735294118
42,"cruiserweight",NA,"right-handed",15,0,0,15,1
42,"heavyweight",30,"right-handed",14,0,0,14,1
46,"super flyweight",27,"right-handed",12,2,1,15,0.833333333
46,"middleweight",34,"right-handed",26,4,1,31,0.85483871
46,"super lightweight",26,"right-handed",17,2,0,19,0.894736842
46,"featherweight",25,"right-handed",19,0,0,19,1
46,"welterweight",27,"right-handed",9,0,0,9,1
46,"featherweight",24,"right-handed",23,7,2,32,0.75
46,"lightweight",27,"right-handed",20,2,1,23,0.891304348
46,"heavyweight",32,"right-handed",20,1,0,21,0.952380952
46,"super welterweight",35,"right-handed",39,7,2,48,0.833333333
46,"bantamweight",22,"right-handed",17,0,0,17,1
46,"welterweight",36,"right-handed",14,1,0,15,0.933333333
46,"light heavyweight",36,"right-handed",35,6,2,43,0.837209302
46,"middleweight",24,"right-handed",22,1,0,23,0.956521739
46,"super middleweight",23,"right-handed",11,1,2,14,0.857142857
46,"super bantamweight",30,"right-handed",20,1,1,22,0.931818182
46,"cruiserweight",28,"right-handed",18,2,0,20,0.9
46,"super welterweight",29,"right-handed",18,1,0,19,0.947368421
46,"super welterweight",29,"right-handed",17,2,0,19,0.894736842
46,"light heavyweight",26,"right-handed",16,3,1,20,0.825
45,"heavyweight",32,"right-handed",18,1,0,19,0.947368421
45,"lightweight",35,"right-handed",26,5,0,31,0.838709677
45,"bantamweight",33,"right-handed",19,7,0,26,0.730769231
45,"super middleweight",29,"right-handed",16,1,2,19,0.894736842
45,"bantamweight",22,"right-handed",25,3,0,28,0.892857143
45,"light heavyweight",33,"right-handed",23,2,1,26,0.903846154
45,"lightweight",28,"right-handed",19,1,0,20,0.95
45,"heavyweight",26,"right-handed",9,0,0,9,1
45,"middleweight",27,"right-handed",16,2,1,19,0.868421053
45,"lightweight",NA,"right-handed",18,3,1,22,0.840909091
45,"super bantamweight",32,"right-handed",27,7,1,35,0.785714286
45,"minimumweight",21,"right-handed",16,0,0,16,1
45,"super lightweight",NA,"right-handed",17,4,0,21,0.80952381
45,"featherweight",30,"right-handed",24,12,0,36,0.666666667
45,"super flyweight",30,"right-handed",17,4,1,22,0.795454545
45,"super welterweight",24,"right-handed",11,0,0,11,1
45,"welterweight",23,"right-handed",21,1,0,22,0.954545455
45,"super middleweight",32,"right-handed",15,11,4,30,0.566666667
45,"welterweight",31,"right-handed",21,5,1,27,0.796296296
44,"light heavyweight",27,"right-handed",15,0,1,16,0.96875
44,"super welterweight",38,"right-handed",45,8,1,54,0.842592593
44,"super lightweight",31,"right-handed",15,2,1,18,0.861111111
44,"heavyweight",21,"right-handed",9,0,0,9,1
44,"heavyweight",26,"right-handed",16,4,2,22,0.772727273
44,"minimumweight",23,"right-handed",10,4,2,16,0.6875
44,"lightweight",31,"right-handed",19,1,0,20,0.95
44,"light heavyweight",30,"right-handed",23,1,0,24,0.958333333
44,"welterweight",28,"right-handed",17,1,0,18,0.944444444
44,"heavyweight",25,"right-handed",17,0,0,17,1
44,"lightweight",27,"right-handed",20,3,0,23,0.869565217
44,"super middleweight",34,"right-handed",36,3,0,39,0.923076923
48,"super featherweight",33,"right-handed",18,4,1,23,0.804347826
48,"welterweight",24,"right-handed",14,13,3,30,0.516666667
48,"light heavyweight",27,"right-handed",24,1,0,25,0.96
48,"super featherweight",23,"right-handed",16,1,0,17,0.941176471
48,"light heavyweight",31,"right-handed",11,1,0,12,0.916666667
48,"super featherweight",24,"right-handed",9,1,0,10,0.9
48,"super lightweight",28,"right-handed",21,2,0,23,0.913043478
48,"welterweight",28,"right-handed",10,1,0,11,0.909090909
48,"super bantamweight",30,"right-handed",13,7,1,21,0.642857143
48,"featherweight",28,"right-handed",13,1,0,14,0.928571429
48,"super lightweight",24,"right-handed",14,2,1,17,0.852941176
48,"super middleweight",25,"right-handed",19,0,0,19,1
48,"lightweight",28,"right-handed",13,0,1,14,0.964285714
48,"welterweight",26,"right-handed",14,2,0,16,0.875
48,"cruiserweight",30,"right-handed",23,5,0,28,0.821428571
48,"cruiserweight",38,"right-handed",29,6,0,35,0.828571429
48,"super middleweight",29,"right-handed",15,0,2,17,0.941176471
48,"featherweight",33,"right-handed",20,3,3,26,0.826923077
48,"super featherweight",24,"right-handed",26,2,2,30,0.9
48,"featherweight",24,"right-handed",21,3,0,24,0.875
48,"heavyweight",26,"right-handed",15,0,0,15,1
48,"super flyweight",27,"right-handed",10,3,0,13,0.769230769
47,"super flyweight",23,"right-handed",9,0,0,9,1
47,"heavyweight",26,"right-handed",5,0,0,5,1
47,"light flyweight",25,"right-handed",37,6,1,44,0.852272727
47,"middleweight",27,"right-handed",12,0,1,13,0.961538462
47,"super bantamweight",26,"right-handed",16,1,2,19,0.894736842
47,"flyweight",28,"right-handed",14,0,0,14,1
47,"welterweight",22,"right-handed",13,0,0,13,1
47,"middleweight",29,"right-handed",19,4,0,23,0.826086957
47,"super middleweight",26,"right-handed",17,0,0,17,1
47,"middleweight",25,"right-handed",9,0,0,9,1
47,"super flyweight",33,"right-handed",26,18,2,46,0.586956522
47,"middleweight",30,"right-handed",21,1,1,23,0.934782609
47,"welterweight",37,"right-handed",25,3,1,29,0.879310345
47,"super welterweight",24,"right-handed",17,0,1,18,0.972222222
47,"bantamweight",23,"right-handed",14,1,1,16,0.90625
47,"super featherweight",28,"right-handed",17,4,3,24,0.770833333
47,"minimumweight",24,"right-handed",18,9,1,28,0.660714286
47,"bantamweight",20,"right-handed",12,0,1,13,0.961538462
47,"super lightweight",37,"right-handed",26,1,1,28,0.946428571
47,"welterweight",24,"right-handed",19,0,1,20,0.975
47,"welterweight",25,"right-handed",10,1,0,11,0.909090909
47,"middleweight",26,"right-handed",11,0,1,12,0.958333333
47,"lightweight",27,"right-handed",8,0,0,8,1
47,"super featherweight",37,"right-handed",46,6,2,54,0.87037037
47,"light heavyweight",22,"right-handed",16,1,0,17,0.941176471
46,"welterweight",24,"right-handed",16,4,0,20,0.8
46,"super middleweight",35,"right-handed",16,1,0,17,0.941176471
46,"welterweight",34,"right-handed",17,0,0,17,1
52,"lightweight",30,"right-handed",9,0,0,9,1
51,"heavyweight",36,"right-handed",41,4,0,45,0.911111111
51,"cruiserweight",28,"right-handed",12,0,0,12,1
51,"super lightweight",28,"right-handed",17,0,0,17,1
51,"super flyweight",23,"right-handed",24,1,0,25,0.96
51,"super featherweight",30,"right-handed",25,3,0,28,0.892857143
51,"flyweight",35,"right-handed",19,2,2,23,0.869565217
51,"super welterweight",25,"right-handed",8,0,0,8,1
51,"flyweight",26,"right-handed",7,3,0,10,0.7
51,"middleweight",26,"right-handed",24,1,1,26,0.942307692
51,"super bantamweight",32,"right-handed",34,3,2,39,0.897435897
51,"cruiserweight",26,"right-handed",26,1,0,27,0.962962963
51,"super middleweight",22,"right-handed",10,0,2,12,0.916666667
51,"super middleweight",27,"right-handed",11,0,0,11,1
51,"super featherweight",29,"right-handed",21,4,0,25,0.84
51,"super bantamweight",24,"right-handed",20,2,0,22,0.909090909
51,"super lightweight",31,"right-handed",23,4,0,27,0.851851852
51,"welterweight",24,"right-handed",7,0,0,7,1
51,"super lightweight",26,"right-handed",9,0,0,9,1
50,"super featherweight",37,"right-handed",21,3,0,24,0.875
50,"featherweight",29,"right-handed",20,2,0,22,0.909090909
50,"super lightweight",31,"right-handed",23,4,0,27,0.851851852
50,"heavyweight",23,"right-handed",13,0,0,13,1
50,"lightweight",24,"right-handed",16,0,0,16,1
50,"flyweight",27,"right-handed",25,1,0,26,0.961538462
50,"light heavyweight",26,"right-handed",12,0,0,12,1
50,"super featherweight",23,"right-handed",17,1,0,18,0.944444444
50,"super lightweight",31,"right-handed",37,4,0,41,0.902439024
50,"middleweight",33,"right-handed",30,6,0,36,0.833333333
50,"featherweight",31,"right-handed",11,3,1,15,0.766666667
50,"light heavyweight",38,"right-handed",13,2,0,15,0.866666667
50,"lightweight",29,"right-handed",22,4,0,26,0.846153846
50,"welterweight",26,"right-handed",16,0,0,16,1
50,"super bantamweight",30,"right-handed",27,2,0,29,0.931034483
50,"lightweight",33,"right-handed",11,4,3,18,0.694444444
50,"middleweight",39,"right-handed",27,5,3,35,0.814285714
49,"super featherweight",22,"right-handed",18,4,1,23,0.804347826
49,"welterweight",27,"right-handed",20,4,1,25,0.82
49,"super lightweight",22,"right-handed",16,0,0,16,1
49,"lightweight",NA,"right-handed",11,1,0,12,0.916666667
49,"super middleweight",21,"right-handed",8,1,1,10,0.85
49,"super bantamweight",30,"right-handed",17,0,0,17,1
49,"lightweight",21,"right-handed",16,0,0,16,1
49,"super featherweight",37,"right-handed",34,9,2,45,0.777777778
49,"middleweight",27,"right-handed",22,1,0,23,0.956521739
49,"cruiserweight",27,"right-handed",6,0,0,6,1
49,"welterweight",29,"right-handed",14,2,0,16,0.875
49,"super lightweight",20,"right-handed",11,0,0,11,1
49,"minimumweight",23,"right-handed",14,0,0,14,1
49,"super lightweight",23,"right-handed",11,0,0,11,1
54,"bantamweight",28,"right-handed",27,9,2,38,0.736842105
54,"lightweight",25,"right-handed",13,1,0,14,0.928571429
54,"featherweight",22,"right-handed",10,1,0,11,0.909090909
54,"heavyweight",29,"right-handed",20,0,0,20,1
54,"super welterweight",30,"right-handed",22,4,1,27,0.833333333
54,"light heavyweight",35,"right-handed",28,2,0,30,0.933333333
54,"featherweight",30,"right-handed",24,2,1,27,0.907407407
54,"middleweight",31,"right-handed",26,5,3,34,0.808823529
54,"super welterweight",28,"right-handed",20,3,1,24,0.854166667
54,"super lightweight",24,"right-handed",14,3,0,17,0.823529412
54,"middleweight",35,"right-handed",23,13,2,38,0.631578947
54,"super lightweight",29,"right-handed",31,7,1,39,0.807692308
54,"featherweight",28,"right-handed",21,9,2,32,0.6875
54,"welterweight",32,"right-handed",27,4,1,32,0.859375
54,"welterweight",35,"right-handed",17,11,1,29,0.603448276
54,"bantamweight",29,"right-handed",15,5,0,20,0.75
54,"super lightweight",36,"right-handed",27,7,2,36,0.777777778
54,"super flyweight",27,"right-handed",20,8,1,29,0.706896552
53,"super welterweight",31,"right-handed",16,11,0,27,0.592592593
53,"cruiserweight",28,"right-handed",7,0,1,8,0.9375
53,"welterweight",29,"right-handed",15,4,0,19,0.789473684
53,"super middleweight",40,"right-handed",34,5,1,40,0.8625
53,"super welterweight",34,"right-handed",25,3,0,28,0.892857143
53,"featherweight",33,"right-handed",29,10,1,40,0.7375
53,"welterweight",29,"right-handed",12,1,1,14,0.892857143
53,"flyweight",NA,"right-handed",21,17,2,40,0.55
53,"featherweight",27,"right-handed",21,5,0,26,0.807692308
53,"lightweight",36,"right-handed",30,2,1,33,0.924242424
53,"flyweight",19,"right-handed",13,1,0,14,0.928571429
53,"super bantamweight",30,"right-handed",19,4,2,25,0.8
53,"featherweight",24,"right-handed",15,0,0,15,1
53,"super welterweight",NA,"right-handed",11,0,0,11,1
53,"flyweight",NA,"right-handed",13,2,0,15,0.866666667
52,"flyweight",29,"right-handed",29,3,1,33,0.893939394
52,"super featherweight",23,"right-handed",17,0,1,18,0.972222222
52,"super middleweight",27,"right-handed",27,1,0,28,0.964285714
52,"light flyweight",33,"right-handed",16,2,0,18,0.888888889
52,"light heavyweight",23,"right-handed",13,0,0,13,1
52,"cruiserweight",39,"right-handed",23,2,1,26,0.903846154
52,"super welterweight",36,"right-handed",26,3,0,29,0.896551724
52,"light heavyweight",28,"right-handed",12,5,1,18,0.694444444
52,"middleweight",32,"right-handed",37,5,0,42,0.880952381
52,"welterweight",30,"right-handed",25,2,0,27,0.925925926
52,"featherweight",24,"right-handed",17,0,0,17,1
52,"super lightweight",33,"right-handed",31,7,1,39,0.807692308
52,"lightweight",22,"right-handed",15,0,1,16,0.96875
52,"heavyweight",38,"right-handed",35,5,1,41,0.865853659
52,"featherweight",24,"right-handed",20,1,1,22,0.931818182
52,"lightweight",28,"right-handed",24,10,0,34,0.705882353
52,"super middleweight",31,"right-handed",24,2,1,27,0.907407407
58,"super lightweight",29,"right-handed",21,0,0,21,1
58,"light heavyweight",25,"right-handed",21,1,0,22,0.954545455
58,"bantamweight",29,"right-handed",23,6,2,31,0.774193548
58,"super welterweight",30,"right-handed",18,0,0,18,1
57,"light heavyweight",30,"right-handed",14,1,0,15,0.933333333
57,"flyweight",28,"right-handed",18,4,1,23,0.804347826
57,"middleweight",38,"right-handed",28,3,0,31,0.903225806
57,"light heavyweight",28,"right-handed",17,1,0,18,0.944444444
57,"heavyweight",38,"right-handed",33,4,0,37,0.891891892
57,"heavyweight",22,"right-handed",14,0,0,14,1
57,"welterweight",30,"right-handed",22,0,0,22,1
57,"lightweight",26,"right-handed",11,0,0,11,1
57,"bantamweight",32,"right-handed",21,3,1,25,0.86
57,"super lightweight",25,"right-handed",21,2,0,23,0.913043478
57,"featherweight",25,"right-handed",20,0,3,23,0.934782609
57,"super lightweight",31,"right-handed",20,1,0,21,0.952380952
57,"super featherweight",24,"right-handed",22,1,1,24,0.9375
56,"super middleweight",34,"right-handed",19,6,0,25,0.76
56,"middleweight",31,"right-handed",15,2,1,18,0.861111111
56,"super bantamweight",25,"right-handed",19,3,1,23,0.847826087
56,"welterweight",29,"right-handed",29,4,2,35,0.857142857
56,"heavyweight",31,"right-handed",25,0,0,25,1
56,"cruiserweight",26,"right-handed",24,1,2,27,0.925925926
56,"light flyweight",25,"right-handed",17,1,0,18,0.944444444
56,"welterweight",31,"right-handed",40,7,0,47,0.85106383
56,"heavyweight",36,"right-handed",19,2,1,22,0.886363636
56,"super bantamweight",28,"right-handed",16,3,1,20,0.825
56,"bantamweight",35,"right-handed",27,9,0,36,0.75
56,"bantamweight",27,"right-handed",21,6,5,32,0.734375
56,"heavyweight",33,"right-handed",7,0,0,7,1
55,"light heavyweight",37,"right-handed",29,2,0,31,0.935483871
55,"light flyweight",26,"right-handed",17,5,1,23,0.760869565
55,"super lightweight",38,"right-handed",68,9,2,79,0.873417722
55,"light heavyweight",28,"right-handed",26,3,0,29,0.896551724
55,"light flyweight",28,"right-handed",15,4,2,21,0.761904762
55,"lightweight",25,"right-handed",25,4,0,29,0.862068966
55,"super bantamweight",32,"right-handed",25,1,0,26,0.961538462
55,"super welterweight",25,"right-handed",14,0,0,14,1
55,"bantamweight",38,"right-handed",35,5,0,40,0.875
55,"super featherweight",31,"right-handed",19,4,1,24,0.8125
55,"light heavyweight",25,"right-handed",8,0,0,8,1
55,"super middleweight",32,"right-handed",26,5,0,31,0.838709677
55,"welterweight",29,"right-handed",21,6,0,27,0.777777778
55,"featherweight",26,"right-handed",22,1,1,24,0.9375
55,"flyweight",27,"right-handed",15,2,1,18,0.861111111
55,"super featherweight",31,"right-handed",27,1,0,28,0.964285714
55,"flyweight",24,"right-handed",22,1,0,23,0.956521739
54,"welterweight",27,"right-handed",14,2,1,17,0.852941176
54,"super featherweight",24,"right-handed",15,2,1,18,0.861111111
54,"super bantamweight",23,"right-handed",15,1,1,17,0.911764706
61,"light flyweight",30,"right-handed",8,0,2,10,0.9
61,"lightweight",27,"right-handed",22,1,0,23,0.956521739
61,"super featherweight",24,"right-handed",6,0,1,7,0.928571429
61,"light heavyweight",29,"right-handed",12,3,0,15,0.8
61,"welterweight",31,"right-handed",19,1,1,21,0.928571429
61,"featherweight",29,"right-handed",22,5,1,28,0.803571429
61,"welterweight",20,"right-handed",9,0,0,9,1
61,"light heavyweight",31,"right-handed",21,0,0,21,1
61,"welterweight",30,"right-handed",27,4,1,32,0.859375
61,"welterweight",22,"right-handed",13,1,0,14,0.928571429
60,"featherweight",33,"right-handed",33,5,4,42,0.833333333
60,"bantamweight",25,"right-handed",17,1,2,20,0.9
60,"flyweight",27,"right-handed",51,4,0,55,0.927272727
60,"super featherweight",27,"right-handed",19,2,0,21,0.904761905
60,"lightweight",34,"right-handed",41,7,1,49,0.846938776
60,"super middleweight",32,"right-handed",17,1,0,18,0.944444444
60,"super lightweight",28,"right-handed",17,3,1,21,0.833333333
60,"bantamweight",26,"right-handed",11,0,0,11,1
60,"super bantamweight",27,"right-handed",16,1,0,17,0.941176471
60,"super welterweight",27,"right-handed",7,0,0,7,1
60,"middleweight",34,"right-handed",18,0,0,18,1
60,"bantamweight",31,"right-handed",28,4,0,32,0.875
60,"cruiserweight",35,"right-handed",18,2,0,20,0.9
59,"super flyweight",29,"right-handed",15,3,1,19,0.815789474
59,"welterweight",30,"right-handed",17,0,0,17,1
59,"super middleweight",28,"right-handed",27,3,2,32,0.875
59,"bantamweight",28,"right-handed",19,1,1,21,0.928571429
59,"light heavyweight",33,"right-handed",20,5,0,25,0.8
59,"welterweight",24,"right-handed",10,0,0,10,1
59,"super welterweight",30,"right-handed",8,0,0,8,1
59,"featherweight",34,"right-handed",25,5,0,30,0.833333333
59,"super welterweight",34,"right-handed",30,2,0,32,0.9375
59,"lightweight",40,"right-handed",40,5,0,45,0.888888889
59,"super middleweight",33,"right-handed",10,0,0,10,1
59,"super middleweight",32,"right-handed",24,3,1,28,0.875
59,"super middleweight",28,"right-handed",21,2,1,24,0.895833333
59,"middleweight",29,"right-handed",20,3,0,23,0.869565217
59,"middleweight",27,"right-handed",25,0,1,26,0.980769231
59,"flyweight",25,"right-handed",17,1,0,18,0.944444444
59,"middleweight",38,"right-handed",41,4,0,45,0.911111111
59,"welterweight",36,"right-handed",36,6,1,43,0.848837209
59,"welterweight",25,"right-handed",21,0,0,21,1
59,"flyweight",25,"right-handed",13,1,0,14,0.928571429
58,"super bantamweight",28,"right-handed",29,3,0,32,0.90625
58,"super bantamweight",25,"right-handed",12,5,0,17,0.705882353
58,"middleweight",23,"right-handed",24,1,0,25,0.96
58,"featherweight",24,"right-handed",13,0,2,15,0.933333333
58,"cruiserweight",34,"right-handed",24,3,1,28,0.875
58,"welterweight",27,"right-handed",23,3,2,28,0.857142857
58,"lightweight",27,"right-handed",20,0,0,20,1
65,"welterweight",23,"right-handed",9,0,0,9,1
65,"light flyweight",30,"right-handed",14,7,6,27,0.62962963
65,"super featherweight",30,"right-handed",19,4,2,25,0.8
65,"super bantamweight",31,"right-handed",23,8,1,32,0.734375
65,"super bantamweight",27,"right-handed",11,1,0,12,0.916666667
65,"super middleweight",32,"right-handed",19,3,0,22,0.863636364
65,"lightweight",32,"right-handed",14,1,0,15,0.933333333
65,"super middleweight",30,"right-handed",17,1,0,18,0.944444444
65,"featherweight",25,"right-handed",21,0,0,21,1
65,"heavyweight",24,"right-handed",21,2,0,23,0.913043478
65,"super middleweight",27,"right-handed",18,0,2,20,0.95
65,"minimumweight",36,"right-handed",27,8,1,36,0.763888889
65,"super welterweight",33,"right-handed",27,3,0,30,0.9
65,"middleweight",23,"right-handed",18,3,0,21,0.857142857
64,"lightweight",34,"right-handed",29,7,1,37,0.797297297
64,"super flyweight",33,"right-handed",16,1,1,18,0.916666667
64,"super welterweight",26,"right-handed",18,1,0,19,0.947368421
64,"featherweight",24,"right-handed",17,1,0,18,0.944444444
64,"featherweight",27,"right-handed",17,7,2,26,0.692307692
64,"middleweight",30,"right-handed",6,0,0,6,1
64,"super middleweight",34,"right-handed",23,1,0,24,0.958333333
64,"super lightweight",32,"right-handed",22,1,0,23,0.956521739
64,"super lightweight",30,"right-handed",20,2,0,22,0.909090909
64,"bantamweight",22,"right-handed",15,2,1,18,0.861111111
63,"welterweight",30,"right-handed",32,1,0,33,0.96969697
63,"cruiserweight",31,"right-handed",19,3,0,22,0.863636364
63,"super featherweight",22,"right-handed",19,0,0,19,1
63,"super featherweight",24,"right-handed",24,1,0,25,0.96
63,"lightweight",34,"right-handed",30,1,0,31,0.967741935
63,"featherweight",27,"right-handed",32,1,0,33,0.96969697
63,"featherweight",33,"right-handed",16,1,0,17,0.941176471
63,"welterweight",32,"right-handed",20,3,1,24,0.854166667
63,"heavyweight",32,"right-handed",14,3,0,17,0.823529412
63,"featherweight",21,"right-handed",8,1,1,10,0.85
63,"bantamweight",33,"right-handed",42,8,0,50,0.84
63,"lightweight",35,"right-handed",26,3,0,29,0.896551724
63,"super welterweight",24,"right-handed",7,0,0,7,1
63,"super welterweight",26,"right-handed",25,3,0,28,0.892857143
63,"featherweight",23,"right-handed",20,1,0,21,0.952380952
62,"middleweight",28,"right-handed",21,5,0,26,0.807692308
62,"flyweight",31,"right-handed",8,1,0,9,0.888888889
62,"super featherweight",35,"right-handed",23,3,1,27,0.87037037
62,"bantamweight",22,"right-handed",20,0,0,20,1
62,"bantamweight",29,"right-handed",27,10,0,37,0.72972973
62,"welterweight",28,"right-handed",17,1,0,18,0.944444444
61,"super featherweight",26,"right-handed",22,5,1,28,0.803571429
61,"super welterweight",27,"right-handed",27,2,1,30,0.916666667
61,"welterweight",29,"right-handed",32,1,0,33,0.96969697
61,"featherweight",27,"right-handed",26,7,0,33,0.787878788
61,"super welterweight",26,"right-handed",34,1,0,35,0.971428571
71,"super welterweight",23,"right-handed",23,1,0,24,0.958333333
71,"super bantamweight",26,"right-handed",14,0,1,15,0.966666667
71,"super welterweight",25,"right-handed",14,0,0,14,1
71,"super lightweight",35,"right-handed",38,6,2,46,0.847826087
71,"super bantamweight",30,"right-handed",11,1,0,12,0.916666667
71,"bantamweight",31,"right-handed",18,1,1,20,0.925
70,"super flyweight",29,"right-handed",29,1,0,30,0.966666667
70,"lightweight",26,"right-handed",18,4,0,22,0.818181818
70,"bantamweight",26,"right-handed",14,4,2,20,0.75
70,"lightweight",35,"right-handed",23,2,1,26,0.903846154
70,"featherweight",24,"right-handed",16,0,3,19,0.921052632
70,"featherweight",28,"right-handed",34,5,1,40,0.8625
70,"heavyweight",42,"right-handed",53,6,0,59,0.898305085
70,"flyweight",25,"right-handed",9,3,1,13,0.730769231
69,"heavyweight",39,"right-handed",27,1,0,28,0.964285714
69,"featherweight",32,"right-handed",22,2,2,26,0.884615385
69,"welterweight",28,"right-handed",15,0,0,15,1
69,"middleweight",21,"right-handed",17,0,0,17,1
69,"super bantamweight",30,"right-handed",12,2,1,15,0.833333333
69,"middleweight",23,"right-handed",13,0,0,13,1
68,"middleweight",30,"right-handed",18,2,0,20,0.9
68,"super bantamweight",24,"right-handed",25,0,0,25,1
68,"light heavyweight",36,"right-handed",38,8,0,46,0.826086957
68,"welterweight",31,"right-handed",32,2,1,35,0.928571429
68,"super bantamweight",29,"right-handed",23,1,0,24,0.958333333
68,"super bantamweight",29,"right-handed",24,5,1,30,0.816666667
68,"lightweight",27,"right-handed",8,0,0,8,1
68,"super lightweight",37,"right-handed",23,6,3,32,0.765625
68,"heavyweight",37,"right-handed",37,5,0,42,0.880952381
68,"featherweight",32,"right-handed",27,3,0,30,0.9
68,"welterweight",29,"right-handed",27,1,0,28,0.964285714
68,"bantamweight",29,"right-handed",32,3,1,36,0.902777778
67,"middleweight",45,"right-handed",45,14,1,60,0.758333333
67,"light heavyweight",33,"right-handed",17,1,0,18,0.944444444
67,"super lightweight",30,"right-handed",13,1,2,16,0.875
67,"super lightweight",26,"right-handed",10,1,0,11,0.909090909
67,"welterweight",26,"right-handed",22,3,0,25,0.88
67,"super flyweight",33,"right-handed",29,5,1,35,0.842857143
67,"super middleweight",24,"right-handed",17,0,0,17,1
67,"minimumweight",23,"right-handed",14,1,1,16,0.90625
67,"middleweight",29,"right-handed",24,3,1,28,0.875
67,"cruiserweight",31,"right-handed",10,0,0,10,1
66,"super welterweight",32,"right-handed",20,2,0,22,0.909090909
66,"middleweight",34,"right-handed",11,3,0,14,0.785714286
66,"welterweight",38,"right-handed",40,4,0,44,0.909090909
66,"super flyweight",NA,"right-handed",23,3,0,26,0.884615385
66,"middleweight",27,"right-handed",21,0,0,21,1
66,"welterweight",33,"right-handed",27,0,0,27,1
65,"super bantamweight",30,"right-handed",38,4,0,42,0.904761905
65,"super welterweight",24,"right-handed",14,0,0,14,1
79,"super welterweight",30,"right-handed",20,3,1,24,0.854166667
79,"light flyweight",25,"right-handed",21,0,1,22,0.977272727
79,"super lightweight",26,"right-handed",30,1,0,31,0.967741935
79,"super bantamweight",37,"right-handed",27,4,1,32,0.859375
79,"welterweight",30,"right-handed",24,2,1,27,0.907407407
79,"super welterweight",27,"right-handed",9,0,0,9,1
79,"light heavyweight",31,"right-handed",19,1,1,21,0.928571429
78,"heavyweight",34,"right-handed",28,2,0,30,0.933333333
78,"heavyweight",29,"right-handed",31,1,0,32,0.96875
78,"heavyweight",31,"right-handed",14,0,0,14,1
78,"lightweight",21,"right-handed",16,1,1,18,0.916666667
78,"super featherweight",30,"right-handed",27,5,1,33,0.833333333
78,"middleweight",32,"right-handed",36,4,1,41,0.890243902
78,"super featherweight",27,"right-handed",21,1,2,24,0.916666667
78,"featherweight",24,"right-handed",5,1,0,6,0.833333333
77,"minimumweight",24,"right-handed",14,0,0,14,1
77,"welterweight",34,"right-handed",36,7,0,43,0.837209302
77,"heavyweight",30,"right-handed",16,1,0,17,0.941176471
77,"super featherweight",25,"right-handed",20,2,0,22,0.909090909
77,"cruiserweight",29,"right-handed",17,0,0,17,1
76,"lightweight",20,"right-handed",20,0,0,20,1
76,"bantamweight",36,"right-handed",28,5,1,34,0.838235294
76,"heavyweight",26,"right-handed",18,0,0,18,1
76,"flyweight",29,"right-handed",24,5,0,29,0.827586207
75,"super welterweight",25,"right-handed",23,5,0,28,0.821428571
75,"super welterweight",23,"right-handed",16,1,1,18,0.916666667
75,"welterweight",25,"right-handed",21,0,0,21,1
75,"super flyweight",33,"right-handed",37,7,0,44,0.840909091
75,"cruiserweight",27,"right-handed",23,1,0,24,0.958333333
75,"lightweight",25,"right-handed",24,1,0,25,0.96
75,"lightweight",30,"right-handed",31,1,0,32,0.96875
75,"super lightweight",29,"right-handed",27,5,1,33,0.833333333
74,"cruiserweight",28,"right-handed",15,0,0,15,1
74,"super lightweight",22,"right-handed",21,0,0,21,1
74,"welterweight",27,"right-handed",19,0,0,19,1
74,"super bantamweight",31,"right-handed",30,5,0,35,0.857142857
73,"welterweight",31,"right-handed",28,2,0,30,0.933333333
73,"super welterweight",33,"right-handed",20,2,2,24,0.875
73,"super welterweight",32,"right-handed",24,7,0,31,0.774193548
73,"flyweight",26,"right-handed",13,0,0,13,1
73,"lightweight",23,"right-handed",18,1,0,19,0.947368421
73,"super welterweight",26,"right-handed",16,2,1,19,0.868421053
73,"heavyweight",24,"right-handed",23,0,0,23,1
72,"welterweight",35,"right-handed",28,1,0,29,0.965517241
72,"super bantamweight",22,"right-handed",17,2,0,19,0.894736842
72,"lightweight",28,"right-handed",19,2,1,22,0.886363636
72,"middleweight",34,"right-handed",17,1,0,18,0.944444444
72,"super bantamweight",24,"right-handed",31,1,0,32,0.96875
71,"super flyweight",30,"right-handed",23,4,1,28,0.839285714
71,"middleweight",34,"right-handed",29,3,0,32,0.90625
90,"middleweight",29,"right-handed",21,2,0,23,0.913043478
89,"super middleweight",26,"right-handed",23,1,0,24,0.958333333
89,"super bantamweight",27,"right-handed",23,6,0,29,0.793103448
89,"light heavyweight",33,"right-handed",30,2,0,32,0.9375
89,"super middleweight",33,"right-handed",40,7,0,47,0.85106383
89,"super bantamweight",32,"right-handed",33,2,2,37,0.918918919
89,"lightweight",30,"right-handed",26,3,0,29,0.896551724
89,"super welterweight",25,"right-handed",11,0,1,12,0.958333333
89,"light flyweight",38,"right-handed",38,15,1,54,0.712962963
88,"super welterweight",40,"right-handed",29,10,0,39,0.743589744
87,"middleweight",32,"right-handed",24,11,1,36,0.680555556
87,"super bantamweight",32,"right-handed",20,2,2,24,0.875
87,"bantamweight",27,"right-handed",43,1,1,45,0.966666667
87,"bantamweight",21,"right-handed",22,2,0,24,0.916666667
87,"welterweight",31,"right-handed",23,1,1,25,0.94
86,"lightweight",34,"right-handed",25,7,1,33,0.772727273
86,"super flyweight",27,"right-handed",29,8,4,41,0.756097561
86,"lightweight",25,"right-handed",19,2,1,22,0.886363636
86,"welterweight",29,"right-handed",17,4,0,21,0.80952381
85,"super bantamweight",30,"right-handed",15,3,0,18,0.833333333
85,"welterweight",26,"right-handed",27,1,0,28,0.964285714
85,"super featherweight",27,"right-handed",21,0,1,22,0.977272727
85,"super welterweight",29,"right-handed",13,0,1,14,0.964285714
84,"middleweight",27,"right-handed",15,0,0,15,1
84,"cruiserweight",35,"right-handed",22,0,0,22,1
84,"super lightweight",27,"right-handed",22,3,0,25,0.88
84,"super middleweight",34,"right-handed",14,1,0,15,0.933333333
83,"light flyweight",28,"right-handed",24,8,2,34,0.735294118
83,"super middleweight",26,"right-handed",17,0,0,17,1
83,"super lightweight",25,"right-handed",16,1,1,18,0.916666667
83,"heavyweight",26,"right-handed",7,0,0,7,1
83,"super featherweight",25,"right-handed",22,3,0,25,0.88
82,"super featherweight",37,"right-handed",66,11,0,77,0.857142857
82,"super welterweight",26,"right-handed",18,2,1,21,0.880952381
82,"super flyweight",31,"right-handed",25,6,1,32,0.796875
82,"lightweight",33,"right-handed",40,5,1,46,0.880434783
81,"super lightweight",23,"right-handed",22,0,0,22,1
81,"lightweight",28,"right-handed",25,0,0,25,1
81,"super featherweight",26,"right-handed",14,0,0,14,1
81,"super lightweight",32,"right-handed",34,2,1,37,0.932432432
81,"super bantamweight",38,"right-handed",27,2,0,29,0.931034483
80,"welterweight",21,"right-handed",22,0,0,22,1
80,"super lightweight",26,"right-handed",16,0,0,16,1
80,"middleweight",27,"right-handed",10,0,0,10,1
80,"super featherweight",28,"right-handed",18,1,1,20,0.925
80,"featherweight",24,"right-handed",22,0,0,22,1
80,"lightweight",25,"right-handed",24,3,0,27,0.888888889
79,"cruiserweight",29,"right-handed",23,4,1,28,0.839285714
79,"featherweight",29,"right-handed",16,5,2,23,0.739130435
79,"super middleweight",38,"right-handed",23,5,1,29,0.810344828
105,"super bantamweight",37,"right-handed",31,3,3,37,0.878378378
104,"super featherweight",31,"right-handed",37,3,0,40,0.925
104,"cruiserweight",37,"right-handed",56,4,1,61,0.926229508
104,"flyweight",31,"right-handed",11,0,0,11,1
103,"lightweight",25,"right-handed",22,2,0,24,0.916666667
102,"super flyweight",35,"right-handed",27,6,0,33,0.818181818
102,"middleweight",29,"right-handed",18,0,0,18,1
102,"super middleweight",46,"right-handed",42,15,1,58,0.732758621
102,"super featherweight",28,"right-handed",20,0,0,20,1
102,"light flyweight",30,"right-handed",22,4,1,27,0.833333333
101,"super lightweight",32,"right-handed",25,5,1,31,0.822580645
101,"super bantamweight",28,"right-handed",18,2,2,22,0.863636364
101,"featherweight",21,"right-handed",17,0,0,17,1
101,"super middleweight",26,"right-handed",23,1,1,25,0.94
101,"heavyweight",31,"right-handed",23,5,0,28,0.821428571
100,"super featherweight",20,"right-handed",16,0,0,16,1
100,"lightweight",29,"right-handed",17,0,0,17,1
100,"super flyweight",27,"right-handed",27,1,0,28,0.964285714
99,"super lightweight",31,"right-handed",27,1,0,28,0.964285714
99,"flyweight",32,"right-handed",30,7,3,40,0.7875
99,"super welterweight",23,"right-handed",15,0,0,15,1
98,"super bantamweight",28,"right-handed",16,3,1,20,0.825
98,"bantamweight",30,"right-handed",27,2,0,29,0.931034483
98,"super lightweight",26,"right-handed",18,2,0,20,0.9
98,"light heavyweight",31,"right-handed",25,6,2,33,0.787878788
98,"cruiserweight",33,"right-handed",23,2,0,25,0.92
98,"cruiserweight",31,"right-handed",41,5,0,46,0.891304348
97,"super featherweight",25,"right-handed",37,2,1,40,0.9375
97,"super lightweight",31,"right-handed",25,7,1,33,0.772727273
97,"super flyweight",33,"right-handed",36,5,0,41,0.87804878
97,"flyweight",38,"right-handed",38,6,0,44,0.863636364
96,"cruiserweight",25,"right-handed",10,0,0,10,1
96,"lightweight",32,"right-handed",22,0,0,22,1
96,"cruiserweight",32,"right-handed",17,0,0,17,1
95,"cruiserweight",31,"right-handed",30,5,0,35,0.857142857
95,"welterweight",30,"right-handed",23,3,1,27,0.87037037
94,"super featherweight",21,"right-handed",27,0,0,27,1
94,"middleweight",28,"right-handed",18,1,1,20,0.925
94,"lightweight",25,"right-handed",15,0,0,15,1
94,"lightweight",25,"right-handed",17,1,0,18,0.944444444
93,"super lightweight",24,"right-handed",28,1,0,29,0.965517241
93,"lightweight",33,"right-handed",21,2,0,23,0.913043478
93,"super featherweight",35,"right-handed",29,5,0,34,0.852941176
93,"middleweight",23,"right-handed",26,1,1,28,0.946428571
92,"super middleweight",26,"right-handed",12,0,0,12,1
92,"heavyweight",34,"right-handed",41,5,1,47,0.882978723
92,"featherweight",32,"right-handed",39,8,2,49,0.816326531
91,"lightweight",28,"right-handed",40,2,1,43,0.941860465
91,"super lightweight",29,"right-handed",25,4,0,29,0.862068966
90,"welterweight",32,"right-handed",25,6,1,32,0.796875
125,"heavyweight",26,"right-handed",24,2,0,26,0.923076923
125,"featherweight",24,"right-handed",15,2,0,17,0.882352941
124,"welterweight",27,"right-handed",12,0,0,12,1
124,"lightweight",22,"right-handed",19,0,0,19,1
124,"super flyweight",33,"right-handed",17,4,0,21,0.80952381
123,"light heavyweight",26,"right-handed",14,1,0,15,0.933333333
123,"super middleweight",31,"right-handed",49,5,0,54,0.907407407
123,"super featherweight",36,"right-handed",24,14,0,38,0.631578947
122,"super bantamweight",27,"right-handed",36,2,0,38,0.947368421
122,"middleweight",33,"right-handed",25,3,0,28,0.892857143
122,"lightweight",35,"right-handed",43,7,1,51,0.852941176
121,"super middleweight",23,"right-handed",29,2,0,31,0.935483871
121,"super middleweight",34,"right-handed",32,1,1,34,0.955882353
120,"super welterweight",28,"right-handed",27,2,0,29,0.931034483
119,"super flyweight",25,"right-handed",29,4,1,34,0.867647059
119,"middleweight",27,"right-handed",26,2,0,28,0.928571429
118,"minimumweight",28,"right-handed",25,4,3,32,0.828125
118,"super bantamweight",26,"right-handed",14,0,1,15,0.966666667
117,"super welterweight",30,"right-handed",26,2,0,28,0.928571429
117,"light flyweight",28,"right-handed",19,1,0,20,0.95
116,"cruiserweight",31,"right-handed",24,0,0,24,1
116,"super welterweight",23,"right-handed",16,0,0,16,1
116,"super welterweight",23,"right-handed",14,2,0,16,0.875
114,"bantamweight",29,"right-handed",29,13,0,42,0.69047619
114,"cruiserweight",28,"right-handed",23,2,0,25,0.92
113,"lightweight",31,"right-handed",31,2,0,33,0.939393939
113,"heavyweight",34,"right-handed",29,8,0,37,0.783783784
112,"welterweight",29,"right-handed",14,1,0,15,0.933333333
112,"lightweight",37,"right-handed",30,4,0,34,0.882352941
112,"light heavyweight",24,"right-handed",23,1,0,24,0.958333333
111,"welterweight",31,"right-handed",15,0,0,15,1
111,"lightweight",31,"right-handed",38,4,0,42,0.904761905
111,"middleweight",32,"right-handed",14,2,0,16,0.875
111,"welterweight",28,"right-handed",29,3,1,33,0.893939394
111,"super featherweight",23,"right-handed",12,0,0,12,1
110,"lightweight",24,"right-handed",10,0,0,10,1
110,"cruiserweight",32,"right-handed",42,3,0,45,0.933333333
109,"super bantamweight",26,"right-handed",32,3,0,35,0.914285714
109,"minimumweight",24,"right-handed",14,2,0,16,0.875
108,"super featherweight",29,"right-handed",30,8,0,38,0.789473684
108,"super lightweight",29,"right-handed",19,0,0,19,1
108,"super welterweight",32,"right-handed",35,4,1,40,0.8875
107,"welterweight",24,"right-handed",8,0,0,8,1
107,"light flyweight",34,"right-handed",33,9,2,44,0.772727273
106,"heavyweight",34,"right-handed",24,2,0,26,0.923076923
106,"featherweight",31,"right-handed",26,2,2,30,0.9
106,"light heavyweight",29,"right-handed",28,1,0,29,0.965517241
105,"lightweight",36,"right-handed",37,7,2,46,0.826086957
105,"super welterweight",33,"right-handed",27,1,1,29,0.948275862
105,"super middleweight",35,"right-handed",34,1,1,36,0.958333333
160,"super featherweight",27,"right-handed",24,1,1,26,0.942307692
160,"super middleweight",21,"right-handed",20,0,0,20,1
160,"minimumweight",NA,"right-handed",19,5,0,24,0.791666667
159,"super middleweight",31,"right-handed",18,2,0,20,0.9
157,"flyweight",29,"right-handed",11,0,0,11,1
156,"light heavyweight",36,"right-handed",33,6,1,40,0.8375
156,"bantamweight",27,"right-handed",17,1,0,18,0.944444444
155,"super lightweight",34,"right-handed",30,2,0,32,0.9375
154,"flyweight",30,"right-handed",17,2,2,21,0.857142857
154,"cruiserweight",29,"right-handed",17,0,0,17,1
153,"super welterweight",31,"right-handed",33,2,1,36,0.930555556
151,"super middleweight",38,"right-handed",47,6,0,53,0.886792453
150,"cruiserweight",32,"right-handed",23,1,0,24,0.958333333
148,"super flyweight",23,"right-handed",15,1,0,16,0.9375
148,"super lightweight",35,"right-handed",30,7,0,37,0.810810811
147,"super bantamweight",24,"right-handed",21,0,0,21,1
147,"super middleweight",27,"right-handed",21,1,0,22,0.954545455
147,"featherweight",28,"right-handed",26,0,0,26,1
146,"super flyweight",29,"right-handed",14,3,3,20,0.775
143,"featherweight",27,"right-handed",16,5,0,21,0.761904762
142,"minimumweight",28,"right-handed",18,3,0,21,0.857142857
141,"welterweight",NA,"right-handed",15,0,0,15,1
141,"flyweight",35,"right-handed",39,4,0,43,0.906976744
141,"super flyweight",26,"right-handed",15,4,0,19,0.789473684
141,"bantamweight",30,"right-handed",37,3,1,41,0.914634146
139,"light heavyweight",35,"right-handed",32,3,1,36,0.902777778
138,"welterweight",29,"right-handed",20,6,2,28,0.75
138,"light flyweight",30,"right-handed",37,4,0,41,0.902439024
137,"lightweight",26,"right-handed",13,1,0,14,0.928571429
137,"super middleweight",27,"right-handed",8,0,0,8,1
136,"light heavyweight",27,"right-handed",17,0,0,17,1
135,"light flyweight",29,"right-handed",34,2,0,36,0.944444444
135,"welterweight",28,"right-handed",24,3,1,28,0.875
133,"super middleweight",35,"right-handed",30,4,2,36,0.861111111
133,"welterweight",35,"right-handed",32,5,0,37,0.864864865
132,"flyweight",36,"right-handed",36,2,0,38,0.947368421
132,"super welterweight",24,"right-handed",15,0,0,15,1
131,"super lightweight",30,"right-handed",16,1,0,17,0.941176471
131,"lightweight",37,"right-handed",35,8,1,44,0.806818182
131,"super flyweight",22,"right-handed",16,2,5,23,0.804347826
130,"heavyweight",29,"right-handed",18,0,0,18,1
129,"super lightweight",28,"right-handed",12,0,0,12,1
129,"welterweight",30,"right-handed",24,1,0,25,0.96
128,"super lightweight",29,"right-handed",17,1,0,18,0.944444444
128,"super welterweight",26,"right-handed",28,0,0,28,1
128,"bantamweight",32,"right-handed",29,3,1,33,0.893939394
127,"super flyweight",33,"right-handed",31,7,0,38,0.815789474
127,"super lightweight",32,"right-handed",26,1,0,27,0.962962963
126,"featherweight",29,"right-handed",25,4,0,29,0.862068966
125,"super welterweight",30,"right-handed",26,2,1,29,0.913793103
237,"super lightweight",29,"right-handed",25,0,3,28,0.946428571
236,"heavyweight",39,"right-handed",34,2,0,36,0.944444444
229,"super lightweight",29,"right-handed",23,2,0,25,0.92
227,"lightweight",29,"right-handed",25,2,0,27,0.925925926
225,"light flyweight",30,"right-handed",32,3,0,35,0.914285714
220,"light heavyweight",33,"right-handed",13,0,0,13,1
219,"light heavyweight",29,"right-handed",24,2,0,26,0.923076923
212,"middleweight",33,"right-handed",12,1,0,13,0.923076923
211,"welterweight",34,"right-handed",35,4,1,40,0.8875
210,"super lightweight",25,"right-handed",19,0,0,19,1
210,"heavyweight",30,"right-handed",23,0,1,24,0.979166667
209,"lightweight",32,"right-handed",34,6,3,43,0.825581395
206,"light flyweight",32,"right-handed",27,3,2,32,0.875
205,"super middleweight",27,"right-handed",28,2,0,30,0.933333333
204,"super lightweight",26,"right-handed",23,0,0,23,1
204,"flyweight",31,"right-handed",17,0,0,17,1
204,"lightweight",27,"right-handed",21,1,0,22,0.954545455
203,"super welterweight",32,"right-handed",38,2,0,40,0.95
199,"super welterweight",28,"right-handed",26,1,1,28,0.946428571
199,"heavyweight",30,"right-handed",24,1,0,25,0.96
199,"super middleweight",31,"right-handed",27,1,0,28,0.964285714
198,"bantamweight",22,"right-handed",12,0,0,12,1
197,"super middleweight",29,"right-handed",25,1,0,26,0.961538462
194,"middleweight",29,"right-handed",40,4,0,44,0.909090909
193,"welterweight",29,"right-handed",33,3,1,37,0.905405405
192,"welterweight",30,"right-handed",21,0,0,21,1
189,"bantamweight",26,"right-handed",19,0,0,19,1
189,"light heavyweight",36,"right-handed",22,2,0,24,0.916666667
184,"lightweight",31,"right-handed",27,2,0,29,0.931034483
184,"welterweight",32,"right-handed",33,4,0,37,0.891891892
184,"welterweight",25,"right-handed",15,0,0,15,1
182,"welterweight",32,"right-handed",23,3,0,26,0.884615385
179,"welterweight",29,"right-handed",28,2,2,32,0.90625
177,"welterweight",26,"right-handed",27,0,0,27,1
176,"featherweight",26,"right-handed",10,0,0,10,1
176,"bantamweight",26,"right-handed",19,1,0,20,0.95
174,"super featherweight",30,"right-handed",35,2,2,39,0.923076923
172,"heavyweight",37,"right-handed",26,1,0,27,0.962962963
171,"light flyweight",25,"right-handed",11,0,0,11,1
171,"middleweight",36,"right-handed",37,4,1,42,0.892857143
170,"super featherweight",30,"right-handed",21,3,4,28,0.821428571
169,"lightweight",29,"right-handed",29,1,0,30,0.966666667
169,"super welterweight",29,"right-handed",15,0,0,15,1
169,"middleweight",28,"right-handed",24,1,0,25,0.96
168,"super flyweight",27,"right-handed",24,2,1,27,0.907407407
166,"super flyweight",27,"right-handed",18,0,0,18,1
164,"middleweight",29,"right-handed",27,1,0,28,0.964285714
163,"super lightweight",38,"right-handed",27,2,0,29,0.931034483
161,"super flyweight",29,"right-handed",32,3,1,36,0.902777778
161,"lightweight",36,"right-handed",29,2,0,31,0.935483871
1041,"middleweight",28,"right-handed",50,1,2,53,0.962264151
814,"middleweight",36,"right-handed",38,1,1,40,0.9625
730,"super featherweight",27,"right-handed",35,1,0,36,0.972222222
682,"heavyweight",29,"right-handed",22,0,0,22,1
672,"featherweight",30,"right-handed",35,1,1,37,0.959459459
663,"super middleweight",28,"right-handed",25,0,0,25,1
597,"light heavyweight",34,"right-handed",24,0,0,24,1
585,"light heavyweight",31,"right-handed",16,0,0,16,1
556,"lightweight",30,"right-handed",39,0,0,39,1
504,"welterweight",31,"right-handed",29,2,1,32,0.921875
488,"light flyweight",26,"right-handed",14,0,0,14,1
470,"featherweight",31,"right-handed",26,1,0,27,0.962962963
434,"minimumweight",33,"right-handed",52,0,0,52,1
419,"super bantamweight",23,"right-handed",26,1,0,27,0.962962963
409,"bantamweight",25,"right-handed",17,0,0,17,1
408,"light heavyweight",27,"right-handed",15,0,0,15,1
399,"featherweight",27,"right-handed",24,0,0,24,1
399,"flyweight",24,"right-handed",28,3,0,31,0.903225806
393,"light heavyweight",35,"right-handed",22,1,3,26,0.903846154
389,"middleweight",31,"right-handed",35,2,0,37,0.945945946
381,"middleweight",28,"right-handed",27,0,0,27,1
375,"bantamweight",36,"right-handed",39,5,0,44,0.886363636
367,"cruiserweight",33,"right-handed",25,1,0,26,0.961538462
355,"super flyweight",28,"right-handed",38,3,0,41,0.926829268
344,"welterweight",30,"right-handed",34,2,0,36,0.944444444
339,"featherweight",33,"right-handed",31,3,1,35,0.9
338,"minimumweight",28,"right-handed",19,0,0,19,1
334,"middleweight",30,"right-handed",19,1,1,21,0.928571429
328,"heavyweight",33,"right-handed",40,0,1,41,0.987804878
323,"super flyweight",31,"right-handed",47,2,0,49,0.959183673
321,"super welterweight",28,"right-handed",23,0,0,23,1
320,"super middleweight",30,"right-handed",28,4,0,32,0.875
320,"super bantamweight",24,"right-handed",20,1,0,21,0.952380952
318,"super middleweight",29,"right-handed",27,2,0,29,0.931034483
293,"super welterweight",22,"right-handed",31,0,0,31,1
292,"super flyweight",29,"right-handed",23,1,0,24,0.958333333
287,"super welterweight",28,"right-handed",31,0,0,31,1
284,"featherweight",28,"right-handed",27,0,0,27,1
273,"super flyweight",29,"right-handed",25,0,0,25,1
271,"light heavyweight",35,"right-handed",32,3,1,36,0.902777778
271,"super flyweight",36,"right-handed",41,1,5,47,0.925531915
270,"featherweight",31,"right-handed",26,2,0,28,0.928571429
268,"heavyweight",30,"right-handed",27,0,1,28,0.982142857
265,"super featherweight",33,"right-handed",25,1,2,28,0.928571429
256,"super bantamweight",28,"right-handed",32,0,0,32,1
254,"super bantamweight",28,"right-handed",26,2,1,29,0.913793103
251,"flyweight",23,"right-handed",12,0,0,12,1
249,"super lightweight",33,"right-handed",45,4,0,49,0.918367347
240,"cruiserweight",25,"right-handed",26,1,0,27,0.962962963
239,"super featherweight",33,"right-handed",60,13,0,73,0.821917808
9,"bantamweight",25,"right-handed",5,4,0,9,0.555555556
9,"bantamweight",21,"right-handed",6,0,1,7,0.928571429
9,"featherweight",28,"right-handed",17,6,0,23,0.739130435
9,"light flyweight",29,"right-handed",12,18,2,32,0.40625
9,"super flyweight",22,"right-handed",4,5,2,11,0.454545455
9,"super featherweight",21,"right-handed",4,0,0,4,1
9,"super lightweight",20,"right-handed",6,0,0,6,1
9,"lightweight",27,"right-handed",4,0,0,4,1
9,"super bantamweight",20,"right-handed",6,3,0,9,0.666666667
9,"super lightweight",19,"right-handed",7,0,0,7,1
9,"middleweight",NA,"right-handed",6,2,1,9,0.722222222
9,"cruiserweight",35,"right-handed",19,6,0,25,0.76
9,"light flyweight",25,"right-handed",4,3,0,7,0.571428571
9,"middleweight",23,"right-handed",4,0,1,5,0.9
9,"super middleweight",28,"right-handed",3,0,1,4,0.875
9,"featherweight",26,"right-handed",4,2,0,6,0.666666667
9,"super middleweight",27,"right-handed",23,10,1,34,0.691176471
9,"welterweight",28,"right-handed",6,1,0,7,0.857142857
9,"super welterweight",35,"right-handed",8,1,0,9,0.888888889
9,"featherweight",20,"right-handed",4,2,0,6,0.666666667
9,"welterweight",23,"right-handed",3,0,0,3,1
9,"super featherweight",30,"right-handed",8,4,1,13,0.653846154
9,"welterweight",44,"right-handed",12,26,3,41,0.329268293
9,"welterweight",20,"right-handed",16,4,0,20,0.8
9,"super bantamweight",23,"right-handed",6,2,0,8,0.75
9,"lightweight",24,"right-handed",5,0,0,5,1
9,"super featherweight",NA,"right-handed",10,9,0,19,0.526315789
9,"super featherweight",32,"right-handed",22,16,6,44,0.568181818
9,"featherweight",27,"right-handed",5,3,0,8,0.625
9,"welterweight",31,"right-handed",7,2,0,9,0.777777778
9,"bantamweight",21,"right-handed",3,0,0,3,1
9,"super bantamweight",30,"right-handed",5,1,1,7,0.785714286
9,"heavyweight",27,"right-handed",9,13,5,27,0.425925926
9,"bantamweight",32,"right-handed",21,12,0,33,0.636363636
9,"light flyweight",31,"right-handed",8,4,3,15,0.633333333
9,"super bantamweight",23,"right-handed",6,0,1,7,0.928571429
9,"light heavyweight",27,"right-handed",5,0,0,5,1
9,"light heavyweight",30,"right-handed",3,14,3,20,0.225
9,"super bantamweight",24,"right-handed",6,2,1,9,0.722222222
9,"super middleweight",23,"right-handed",4,2,1,7,0.642857143
9,"light flyweight",24,"right-handed",7,14,1,22,0.340909091
9,"welterweight",34,"right-handed",7,5,0,12,0.583333333
9,"super welterweight",34,"right-handed",17,1,0,18,0.944444444
9,"super welterweight",22,"right-handed",5,0,0,5,1
9,"cruiserweight",25,"right-handed",4,11,0,15,0.266666667
9,"heavyweight",43,"right-handed",25,22,2,49,0.530612245
9,"heavyweight",26,"right-handed",2,0,0,2,1
9,"super bantamweight",25,"right-handed",12,9,4,25,0.56
9,"lightweight",36,"right-handed",25,13,0,38,0.657894737
9,"middleweight",37,"right-handed",13,4,0,17,0.764705882
9,"lightweight",28,"right-handed",13,11,3,27,0.537037037
9,"super welterweight",22,"right-handed",5,0,0,5,1
9,"super bantamweight",21,"right-handed",5,0,0,5,1
9,"super lightweight",24,"right-handed",10,1,0,11,0.909090909
9,"light heavyweight",32,"right-handed",9,1,2,12,0.833333333
9,"super lightweight",26,"right-handed",6,0,0,6,1
9,"super lightweight",24,"right-handed",4,0,0,4,1
9,"super middleweight",31,"right-handed",28,4,0,32,0.875
9,"heavyweight",32,"right-handed",7,2,0,9,0.777777778
9,"welterweight",47,"right-handed",36,16,1,53,0.688679245
9,"heavyweight",23,"right-handed",13,8,0,21,0.619047619
9,"super welterweight",29,"right-handed",7,3,0,10,0.7
9,"super lightweight",19,"right-handed",3,0,0,3,1
9,"super lightweight",32,"right-handed",8,8,4,20,0.5
9,"super lightweight",25,"right-handed",6,1,0,7,0.857142857
9,"light heavyweight",30,"right-handed",4,8,0,12,0.333333333
9,"super flyweight",22,"right-handed",9,1,0,10,0.9
9,"super lightweight",33,"right-handed",25,6,1,32,0.796875
9,"light heavyweight",37,"right-handed",10,19,0,29,0.344827586
9,"super featherweight",36,"right-handed",10,12,7,29,0.465517241
9,"light heavyweight",22,"right-handed",3,0,0,3,1
9,"bantamweight",26,"right-handed",8,9,1,18,0.472222222
9,"light heavyweight",29,"right-handed",5,0,0,5,1
9,"super welterweight",33,"right-handed",8,13,2,23,0.391304348
9,"featherweight",22,"right-handed",3,0,0,3,1
9,"lightweight",33,"right-handed",10,5,1,16,0.65625
9,"heavyweight",45,"right-handed",52,26,0,78,0.666666667
9,"middleweight",38,"right-handed",5,9,1,15,0.366666667
9,"featherweight",23,"right-handed",4,4,1,9,0.5
9,"lightweight",38,"right-handed",15,2,1,18,0.861111111
9,"welterweight",33,"right-handed",26,7,0,33,0.787878788
9,"welterweight",26,"right-handed",5,2,0,7,0.714285714
9,"featherweight",26,"right-handed",18,7,3,28,0.696428571
9,"heavyweight",34,"right-handed",14,11,1,26,0.557692308
9,"super featherweight",29,"right-handed",8,6,2,16,0.5625
9,"lightweight",25,"right-handed",7,4,0,11,0.636363636
9,"super featherweight",32,"right-handed",29,8,2,39,0.769230769
9,"flyweight",26,"right-handed",6,3,2,11,0.636363636
9,"super featherweight",30,"right-handed",13,9,2,24,0.583333333
9,"super middleweight",25,"right-handed",3,0,0,3,1
9,"bantamweight",24,"right-handed",4,1,0,5,0.8
9,"featherweight",20,"right-handed",5,0,0,5,1
9,"lightweight",28,"right-handed",5,0,1,6,0.916666667
9,"super welterweight",30,"right-handed",5,15,0,20,0.25
9,"welterweight",27,"right-handed",7,5,0,12,0.583333333
9,"lightweight",29,"right-handed",4,1,0,5,0.8
9,"super lightweight",26,"right-handed",4,4,1,9,0.5
9,"super lightweight",35,"right-handed",21,11,1,33,0.651515152
9,"light heavyweight",45,"right-handed",32,11,1,44,0.738636364
9,"super bantamweight",28,"right-handed",16,15,1,32,0.515625
9,"super lightweight",26,"right-handed",17,15,4,36,0.527777778
9,"super bantamweight",19,"right-handed",4,1,0,5,0.8
9,"featherweight",22,"right-handed",4,0,0,4,1
9,"welterweight",31,"right-handed",19,15,2,36,0.555555556
9,"middleweight",25,"right-handed",7,3,1,11,0.681818182
9,"middleweight",37,"right-handed",19,5,0,24,0.791666667
9,"super middleweight",21,"right-handed",8,0,0,8,1
9,"super welterweight",33,"right-handed",8,7,0,15,0.533333333
9,"middleweight",26,"right-handed",11,1,1,13,0.884615385
9,"super bantamweight",24,"right-handed",6,9,2,17,0.411764706
9,"light heavyweight",27,"right-handed",4,0,0,4,1
9,"cruiserweight",26,"right-handed",7,1,0,8,0.875
9,"lightweight",38,"right-handed",28,19,4,51,0.588235294
9,"heavyweight",42,"right-handed",12,1,0,13,0.923076923
9,"welterweight",34,"right-handed",4,1,0,5,0.8
9,"welterweight",27,"right-handed",4,0,1,5,0.9
9,"flyweight",22,"right-handed",7,4,0,11,0.636363636
9,"middleweight",24,"right-handed",2,0,0,2,1
9,"super middleweight",33,"right-handed",12,6,1,19,0.657894737
9,"featherweight",27,"right-handed",11,5,0,16,0.6875
9,"heavyweight",37,"right-handed",9,1,1,11,0.863636364
9,"bantamweight",26,"right-handed",6,3,0,9,0.666666667
9,"featherweight",34,"right-handed",6,5,2,13,0.538461538
9,"super welterweight",20,"right-handed",4,1,1,6,0.75
9,"super lightweight",35,"right-handed",20,7,1,28,0.732142857
9,"super middleweight",34,"right-handed",28,9,0,37,0.756756757
9,"minimumweight",21,"right-handed",5,1,1,7,0.785714286
9,"cruiserweight",29,"right-handed",4,0,0,4,1
9,"minimumweight",24,"right-handed",7,1,1,9,0.833333333
9,"bantamweight",26,"right-handed",4,3,0,7,0.571428571
9,"super bantamweight",23,"right-handed",5,1,0,6,0.833333333
9,"super lightweight",25,"right-handed",6,4,2,12,0.583333333
9,"heavyweight",28,"right-handed",6,0,0,6,1
9,"middleweight",29,"right-handed",4,0,0,4,1
9,"light flyweight",18,"right-handed",4,1,1,6,0.75
9,"welterweight",28,"right-handed",10,6,2,18,0.611111111
9,"super welterweight",22,"right-handed",4,0,0,4,1
9,"super bantamweight",29,"right-handed",8,9,0,17,0.470588235
9,"super welterweight",28,"right-handed",4,0,0,4,1
9,"bantamweight",22,"right-handed",7,7,2,16,0.5
9,"flyweight",27,"right-handed",7,1,0,8,0.875
9,"lightweight",26,"right-handed",4,0,0,4,1
9,"heavyweight",34,"right-handed",23,6,0,29,0.793103448
9,"super lightweight",28,"right-handed",4,0,1,5,0.9
9,"super welterweight",27,"right-handed",16,20,3,39,0.448717949
9,"heavyweight",42,"right-handed",26,22,3,51,0.539215686
9,"middleweight",37,"right-handed",15,3,0,18,0.833333333
9,"middleweight",35,"right-handed",7,9,0,16,0.4375
9,"minimumweight",20,"right-handed",6,1,1,8,0.8125
9,"light heavyweight",26,"right-handed",8,35,6,49,0.224489796
9,"bantamweight",24,"right-handed",13,6,1,20,0.675
9,"featherweight",32,"right-handed",13,10,0,23,0.565217391
9,"super lightweight",20,"right-handed",6,0,2,8,0.875
9,"middleweight",22,"right-handed",4,1,0,5,0.8
9,"featherweight",23,"right-handed",7,0,1,8,0.9375
9,"super flyweight",28,"right-handed",17,8,4,29,0.655172414
9,"heavyweight",28,"right-handed",9,2,2,13,0.769230769
9,"super lightweight",34,"right-handed",12,6,2,20,0.65
9,"lightweight",28,"right-handed",4,3,0,7,0.571428571
9,"super welterweight",25,"right-handed",8,1,1,10,0.85
9,"super lightweight",24,"right-handed",6,0,0,6,1
9,"super middleweight",22,"right-handed",6,1,1,8,0.8125
9,"lightweight",NA,"right-handed",3,1,0,4,0.75
9,"middleweight",26,"right-handed",7,1,0,8,0.875
9,"welterweight",NA,"right-handed",4,0,0,4,1
9,"super middleweight",36,"right-handed",32,3,0,35,0.914285714
9,"featherweight",26,"right-handed",10,12,2,24,0.458333333
9,"super bantamweight",31,"right-handed",23,3,0,26,0.884615385
9,"welterweight",25,"right-handed",8,8,0,16,0.5
9,"bantamweight",30,"right-handed",13,6,1,20,0.675
9,"featherweight",32,"right-handed",6,4,1,11,0.590909091
9,"lightweight",27,"right-handed",13,4,0,17,0.764705882
9,"super welterweight",29,"right-handed",6,6,0,12,0.5
9,"lightweight",27,"right-handed",4,0,0,4,1
9,"super bantamweight",23,"right-handed",7,3,0,10,0.7
9,"super flyweight",20,"right-handed",5,3,0,8,0.625
9,"middleweight",25,"right-handed",9,2,1,12,0.791666667
9,"lightweight",NA,"right-handed",4,1,0,5,0.8
9,"cruiserweight",33,"right-handed",21,12,0,33,0.636363636
9,"middleweight",29,"right-handed",3,0,0,3,1
9,"heavyweight",34,"right-handed",12,7,0,19,0.631578947
9,"super welterweight",29,"right-handed",4,1,1,6,0.75
9,"light heavyweight",22,"right-handed",4,0,0,4,1
9,"bantamweight",22,"right-handed",14,3,0,17,0.823529412
9,"light heavyweight",25,"right-handed",5,2,0,7,0.714285714
9,"super lightweight",24,"right-handed",4,1,2,7,0.714285714
9,"super lightweight",34,"right-handed",10,20,0,30,0.333333333
9,"super lightweight",25,"right-handed",13,7,1,21,0.642857143
9,"featherweight",32,"right-handed",7,4,0,11,0.636363636
9,"flyweight",22,"right-handed",12,8,1,21,0.595238095
9,"super lightweight",30,"right-handed",11,5,0,16,0.6875
9,"super lightweight",21,"right-handed",4,0,0,4,1
9,"light heavyweight",28,"right-handed",9,1,0,10,0.9
9,"super bantamweight",21,"right-handed",6,0,1,7,0.928571429
9,"super lightweight",26,"right-handed",5,0,2,7,0.857142857
9,"super welterweight",40,"right-handed",26,39,3,68,0.404411765
9,"welterweight",27,"right-handed",13,7,0,20,0.65
9,"light heavyweight",38,"right-handed",10,9,2,21,0.523809524
9,"minimumweight",25,"right-handed",10,8,3,21,0.547619048
9,"featherweight",22,"right-handed",8,3,1,12,0.708333333
9,"cruiserweight",23,"right-handed",3,0,0,3,1
9,"heavyweight",37,"right-handed",8,2,1,11,0.772727273
9,"super featherweight",24,"right-handed",4,0,0,4,1
9,"flyweight",24,"right-handed",2,2,2,6,0.5
9,"super lightweight",28,"right-handed",11,2,0,13,0.846153846
9,"middleweight",24,"right-handed",5,3,1,9,0.611111111
9,"lightweight",30,"right-handed",17,18,2,37,0.486486486
9,"featherweight",36,"right-handed",27,24,4,55,0.527272727
9,"heavyweight",38,"right-handed",18,17,0,35,0.514285714
9,"lightweight",37,"right-handed",5,4,0,9,0.555555556
9,"middleweight",37,"right-handed",29,10,1,40,0.7375
9,"super lightweight",27,"right-handed",9,8,3,20,0.525
9,"super welterweight",30,"right-handed",20,9,0,29,0.689655172
9,"welterweight",30,"right-handed",7,9,1,17,0.441176471
9,"middleweight",28,"right-handed",24,10,0,34,0.705882353
9,"welterweight",31,"right-handed",6,2,0,8,0.75
9,"super middleweight",31,"right-handed",3,0,0,3,1
9,"lightweight",25,"right-handed",4,0,0,4,1
9,"super lightweight",22,"right-handed",4,0,0,4,1
9,"super bantamweight",20,"right-handed",4,0,0,4,1
9,"heavyweight",25,"right-handed",4,0,0,4,1
9,"welterweight",25,"right-handed",8,5,1,14,0.607142857
9,"super bantamweight",25,"right-handed",8,3,0,11,0.727272727
9,"minimumweight",18,"right-handed",10,2,1,13,0.807692308
9,"middleweight",34,"right-handed",7,6,0,13,0.538461538
9,"lightweight",33,"right-handed",10,11,3,24,0.479166667
9,"super lightweight",22,"right-handed",4,0,0,4,1
9,"welterweight",26,"right-handed",3,0,1,4,0.875
9,"super welterweight",32,"right-handed",8,2,0,10,0.8
9,"light heavyweight",49,"right-handed",27,3,1,31,0.887096774
9,"cruiserweight",39,"right-handed",14,9,0,23,0.608695652
9,"heavyweight",42,"right-handed",9,7,0,16,0.5625
9,"cruiserweight",32,"right-handed",3,1,0,4,0.75
9,"welterweight",23,"right-handed",5,0,0,5,1
9,"super flyweight",18,"right-handed",5,1,0,6,0.833333333
9,"super middleweight",32,"right-handed",7,3,1,11,0.681818182
9,"welterweight",25,"right-handed",4,0,0,4,1
9,"light heavyweight",20,"right-handed",6,1,0,7,0.857142857
9,"middleweight",28,"right-handed",3,0,0,3,1
9,"welterweight",41,"right-handed",17,8,0,25,0.68
9,"light heavyweight",29,"right-handed",3,0,0,3,1
9,"welterweight",20,"right-handed",10,3,0,13,0.769230769
9,"super bantamweight",25,"right-handed",13,3,0,16,0.8125
8,"super middleweight",33,"right-handed",6,3,0,9,0.666666667
8,"super bantamweight",34,"right-handed",33,26,3,62,0.556451613
8,"super middleweight",30,"right-handed",3,1,0,4,0.75
8,"super welterweight",35,"right-handed",15,26,1,42,0.369047619
8,"welterweight",20,"right-handed",9,1,0,10,0.9
8,"super bantamweight",21,"right-handed",7,1,0,8,0.875
8,"lightweight",24,"right-handed",5,2,1,8,0.6875
8,"cruiserweight",28,"right-handed",3,0,0,3,1
8,"lightweight",37,"right-handed",10,5,3,18,0.638888889
8,"cruiserweight",23,"right-handed",3,0,0,3,1
8,"light heavyweight",46,"right-handed",34,18,2,54,0.648148148
8,"super lightweight",22,"right-handed",3,0,0,3,1
8,"lightweight",37,"right-handed",23,17,1,41,0.573170732
8,"heavyweight",27,"right-handed",5,0,0,5,1
8,"bantamweight",20,"right-handed",3,3,0,6,0.5
8,"light heavyweight",28,"right-handed",7,1,0,8,0.875
8,"light flyweight",23,"right-handed",3,0,0,3,1
8,"lightweight",25,"right-handed",18,6,0,24,0.75
8,"super welterweight",25,"right-handed",1,0,1,2,0.75
8,"lightweight",31,"right-handed",13,13,2,28,0.5
8,"super lightweight",29,"right-handed",8,10,2,20,0.45
8,"middleweight",NA,"right-handed",5,0,0,5,1
8,"lightweight",34,"right-handed",14,6,0,20,0.7
8,"heavyweight",38,"right-handed",19,8,0,27,0.703703704
8,"super welterweight",22,"right-handed",11,8,0,19,0.578947368
8,"cruiserweight",NA,"right-handed",7,1,1,9,0.833333333
8,"bantamweight",32,"right-handed",12,5,2,19,0.684210526
8,"flyweight",36,"right-handed",48,6,1,55,0.881818182
8,"welterweight",29,"right-handed",9,4,0,13,0.692307692
8,"featherweight",25,"right-handed",6,5,0,11,0.545454545
8,"super featherweight",33,"right-handed",2,0,0,2,1
8,"super welterweight",24,"right-handed",3,0,0,3,1
8,"super featherweight",21,"right-handed",7,1,0,8,0.875
8,"heavyweight",NA,"right-handed",5,0,0,5,1
8,"cruiserweight",26,"right-handed",9,2,0,11,0.818181818
8,"lightweight",28,"right-handed",3,0,0,3,1
8,"light heavyweight",42,"right-handed",16,24,6,46,0.413043478
8,"middleweight",28,"right-handed",6,4,1,11,0.590909091
8,"heavyweight",45,"right-handed",16,7,0,23,0.695652174
8,"featherweight",24,"right-handed",6,7,5,18,0.472222222
8,"super bantamweight",30,"right-handed",7,9,1,17,0.441176471
8,"welterweight",19,"right-handed",8,0,0,8,1
8,"lightweight",27,"right-handed",7,5,1,13,0.576923077
8,"flyweight",26,"right-handed",9,9,1,19,0.5
8,"featherweight",23,"right-handed",6,1,0,7,0.857142857
8,"lightweight",22,"right-handed",6,0,0,6,1
8,"super featherweight",26,"right-handed",7,3,1,11,0.681818182
8,"super lightweight",33,"right-handed",16,14,3,33,0.53030303
8,"super bantamweight",28,"right-handed",9,9,3,21,0.5
8,"lightweight",29,"right-handed",5,17,3,25,0.26
8,"super bantamweight",26,"right-handed",11,6,1,18,0.638888889
8,"super featherweight",25,"right-handed",15,13,1,29,0.534482759
8,"middleweight",36,"right-handed",9,28,0,37,0.243243243
8,"middleweight",25,"right-handed",8,13,2,23,0.391304348
8,"light heavyweight",21,"right-handed",4,0,0,4,1
8,"lightweight",18,"right-handed",9,3,0,12,0.75
8,"middleweight",22,"right-handed",8,3,0,11,0.727272727
8,"super welterweight",39,"right-handed",16,20,2,38,0.447368421
8,"featherweight",34,"right-handed",16,8,2,26,0.653846154
8,"super lightweight",22,"right-handed",7,3,0,10,0.7
8,"middleweight",24,"right-handed",3,0,0,3,1
8,"super welterweight",31,"right-handed",11,4,0,15,0.733333333
8,"featherweight",26,"right-handed",4,0,0,4,1
8,"super welterweight",35,"right-handed",21,11,0,32,0.65625
8,"light heavyweight",31,"right-handed",35,21,1,57,0.622807018
8,"super welterweight",19,"right-handed",5,2,0,7,0.714285714
8,"super welterweight",32,"right-handed",4,0,1,5,0.9
8,"heavyweight",24,"right-handed",13,3,0,16,0.8125
8,"cruiserweight",23,"right-handed",8,10,0,18,0.444444444
8,"middleweight",27,"right-handed",7,1,0,8,0.875
8,"lightweight",26,"right-handed",8,9,1,18,0.472222222
8,"super featherweight",24,"right-handed",3,0,0,3,1
8,"super middleweight",38,"right-handed",37,15,3,55,0.7
8,"heavyweight",26,"right-handed",4,0,0,4,1
8,"heavyweight",39,"right-handed",3,3,0,6,0.5
8,"lightweight",20,"right-handed",10,3,0,13,0.769230769
8,"super featherweight",18,"right-handed",7,10,0,17,0.411764706
8,"super lightweight",32,"right-handed",24,28,2,54,0.462962963
8,"super flyweight",21,"right-handed",18,10,1,29,0.637931034
8,"super welterweight",23,"right-handed",6,1,0,7,0.857142857
8,"super lightweight",22,"right-handed",3,2,0,5,0.6
8,"super bantamweight",36,"right-handed",1,5,0,6,0.166666667
8,"super lightweight",31,"right-handed",8,2,0,10,0.8
8,"super bantamweight",22,"right-handed",5,14,1,20,0.275
8,"welterweight",29,"right-handed",5,1,1,7,0.785714286
8,"cruiserweight",29,"right-handed",12,15,1,28,0.446428571
8,"featherweight",22,"right-handed",7,3,1,11,0.681818182
8,"heavyweight",38,"right-handed",10,1,0,11,0.909090909
8,"cruiserweight",35,"right-handed",6,5,1,12,0.541666667
8,"lightweight",26,"right-handed",4,4,0,8,0.5
8,"lightweight",35,"right-handed",9,37,4,50,0.22
8,"super welterweight",25,"right-handed",2,0,0,2,1
8,"super welterweight",28,"right-handed",5,0,0,5,1
8,"lightweight",26,"right-handed",11,7,0,18,0.611111111
8,"cruiserweight",36,"right-handed",21,16,3,40,0.5625
8,"super middleweight",24,"right-handed",4,1,1,6,0.75
8,"super featherweight",26,"right-handed",9,7,1,17,0.558823529
8,"cruiserweight",36,"right-handed",42,21,2,65,0.661538462
8,"super flyweight",25,"right-handed",10,10,0,20,0.5
8,"middleweight",25,"right-handed",5,1,0,6,0.833333333
8,"featherweight",28,"right-handed",5,2,0,7,0.714285714
8,"heavyweight",38,"right-handed",11,2,0,13,0.846153846
8,"light heavyweight",30,"right-handed",9,0,0,9,1
8,"flyweight",26,"right-handed",4,1,0,5,0.8
8,"bantamweight",23,"right-handed",11,2,0,13,0.846153846
8,"heavyweight",39,"right-handed",13,2,0,15,0.866666667
8,"super welterweight",23,"right-handed",7,4,2,13,0.615384615
8,"light heavyweight",28,"right-handed",5,1,0,6,0.833333333
8,"middleweight",25,"right-handed",7,3,0,10,0.7
8,"super lightweight",35,"right-handed",7,5,1,13,0.576923077
8,"super middleweight",39,"right-handed",8,10,3,21,0.452380952
8,"cruiserweight",29,"right-handed",5,0,0,5,1
8,"bantamweight",34,"right-handed",8,4,4,16,0.625
8,"super welterweight",42,"right-handed",56,21,0,77,0.727272727
8,"welterweight",26,"right-handed",3,0,0,3,1
8,"welterweight",27,"right-handed",6,3,1,10,0.65
8,"middleweight",26,"right-handed",7,0,0,7,1
8,"bantamweight",34,"right-handed",15,49,3,67,0.246268657
8,"super bantamweight",21,"right-handed",4,0,0,4,1
8,"super featherweight",29,"right-handed",4,0,0,4,1
8,"welterweight",34,"right-handed",17,5,0,22,0.772727273
8,"welterweight",28,"right-handed",25,11,0,36,0.694444444
8,"super bantamweight",21,"right-handed",17,11,3,31,0.596774194
8,"lightweight",44,"right-handed",20,13,0,33,0.606060606
8,"welterweight",27,"right-handed",19,16,1,36,0.541666667
8,"super featherweight",39,"right-handed",21,27,5,53,0.443396226
8,"super featherweight",32,"right-handed",5,7,4,16,0.4375
8,"flyweight",22,"right-handed",14,4,1,19,0.763157895
8,"super welterweight",27,"right-handed",8,2,0,10,0.8
8,"lightweight",24,"right-handed",5,6,1,12,0.458333333
8,"heavyweight",26,"right-handed",13,4,0,17,0.764705882
8,"light heavyweight",33,"right-handed",14,7,0,21,0.666666667
8,"welterweight",31,"right-handed",8,6,4,18,0.555555556
8,"middleweight",NA,"right-handed",11,2,0,13,0.846153846
8,"welterweight",34,"right-handed",9,12,1,22,0.431818182
8,"super flyweight",26,"right-handed",5,2,0,7,0.714285714
8,"super middleweight",29,"right-handed",13,11,1,25,0.54
8,"bantamweight",34,"right-handed",10,9,2,21,0.523809524
8,"middleweight",24,"right-handed",3,0,0,3,1
8,"super middleweight",NA,"right-handed",3,1,0,4,0.75
8,"heavyweight",24,"right-handed",6,1,1,8,0.8125
8,"super welterweight",26,"right-handed",12,2,2,16,0.8125
8,"lightweight",30,"right-handed",9,3,0,12,0.75
8,"light heavyweight",30,"right-handed",3,0,0,3,1
8,"welterweight",25,"right-handed",3,0,0,3,1
8,"lightweight",29,"right-handed",10,4,2,16,0.6875
8,"super featherweight",21,"right-handed",3,0,0,3,1
8,"middleweight",36,"right-handed",11,12,1,24,0.479166667
8,"super welterweight",28,"right-handed",15,7,5,27,0.648148148
8,"cruiserweight",29,"right-handed",6,2,2,10,0.7
8,"super featherweight",32,"right-handed",61,51,2,114,0.543859649
8,"super welterweight",26,"right-handed",5,2,0,7,0.714285714
8,"middleweight",29,"right-handed",2,0,0,2,1
8,"bantamweight",31,"right-handed",7,1,0,8,0.875
8,"super lightweight",21,"right-handed",5,0,0,5,1
8,"super middleweight",36,"right-handed",22,18,2,42,0.547619048
8,"flyweight",31,"right-handed",13,16,3,32,0.453125
8,"light flyweight",23,"right-handed",4,1,1,6,0.75
8,"super lightweight",27,"right-handed",13,14,1,28,0.482142857
8,"",20,"right-handed",6,0,0,6,1
8,"cruiserweight",27,"right-handed",9,6,3,18,0.583333333
8,"super welterweight",21,"right-handed",7,1,0,8,0.875
8,"cruiserweight",32,"right-handed",5,12,4,21,0.333333333
8,"flyweight",21,"right-handed",12,2,0,14,0.857142857
8,"super welterweight",35,"right-handed",12,7,2,21,0.619047619
8,"middleweight",27,"right-handed",6,5,4,15,0.533333333
8,"welterweight",32,"right-handed",22,22,3,47,0.5
8,"light heavyweight",21,"right-handed",3,0,0,3,1
8,"super lightweight",29,"right-handed",16,8,1,25,0.66
8,"super welterweight",28,"right-handed",8,1,1,10,0.85
8,"cruiserweight",40,"right-handed",12,10,1,23,0.543478261
8,"light flyweight",31,"right-handed",7,6,2,15,0.533333333
8,"lightweight",27,"right-handed",6,0,1,7,0.928571429
8,"cruiserweight",31,"right-handed",9,6,0,15,0.6
8,"lightweight",30,"right-handed",11,9,1,21,0.547619048
8,"super welterweight",27,"right-handed",3,0,0,3,1
8,"flyweight",23,"right-handed",5,1,1,7,0.785714286
8,"super featherweight",24,"right-handed",2,3,1,6,0.416666667
8,"featherweight",22,"right-handed",8,3,0,11,0.727272727
8,"super featherweight",28,"right-handed",15,6,3,24,0.6875
8,"super flyweight",25,"right-handed",5,1,0,6,0.833333333
8,"flyweight",24,"right-handed",9,7,1,17,0.558823529
8,"light heavyweight",30,"right-handed",12,3,2,17,0.764705882
8,"super featherweight",27,"right-handed",12,7,0,19,0.631578947
8,"super featherweight",23,"right-handed",7,0,0,7,1
8,"super lightweight",35,"right-handed",28,9,2,39,0.743589744
8,"super lightweight",37,"right-handed",26,20,3,49,0.56122449
8,"light heavyweight",22,"right-handed",9,0,0,9,1
8,"super featherweight",36,"right-handed",30,8,2,40,0.775
8,"super lightweight",25,"right-handed",2,0,0,2,1
8,"welterweight",22,"right-handed",10,4,1,15,0.7
8,"super welterweight",23,"right-handed",3,1,1,5,0.7
8,"lightweight",34,"right-handed",10,12,0,22,0.454545455
8,"lightweight",32,"right-handed",7,15,1,23,0.326086957
8,"super flyweight",26,"right-handed",8,0,0,8,1
8,"heavyweight",42,"right-handed",6,0,1,7,0.928571429
8,"super welterweight",26,"right-handed",3,0,1,4,0.875
8,"super welterweight",21,"right-handed",6,1,1,8,0.8125
8,"super lightweight",39,"right-handed",4,2,1,7,0.642857143
8,"heavyweight",30,"right-handed",10,2,1,13,0.807692308
8,"welterweight",28,"right-handed",7,3,1,11,0.681818182
8,"flyweight",23,"right-handed",8,2,2,12,0.75
8,"cruiserweight",35,"right-handed",5,4,0,9,0.555555556
8,"bantamweight",21,"right-handed",5,1,0,6,0.833333333
8,"bantamweight",18,"right-handed",4,1,0,5,0.8
8,"featherweight",24,"right-handed",2,0,0,2,1
8,"flyweight",30,"right-handed",6,0,1,7,0.928571429
8,"featherweight",23,"right-handed",6,2,0,8,0.75
8,"super lightweight",34,"right-handed",28,18,1,47,0.606382979
8,"super bantamweight",22,"right-handed",4,1,0,5,0.8
8,"super welterweight",44,"right-handed",25,8,2,35,0.742857143
8,"super middleweight",32,"right-handed",38,12,0,50,0.76
8,"super welterweight",24,"right-handed",4,0,0,4,1
8,"lightweight",24,"right-handed",14,8,2,24,0.625
8,"super flyweight",NA,"right-handed",16,6,0,22,0.727272727
8,"bantamweight",28,"right-handed",7,7,3,17,0.5
8,"super welterweight",40,"right-handed",25,20,1,46,0.554347826
8,"super bantamweight",28,"right-handed",15,9,2,26,0.615384615
8,"light flyweight",18,"right-handed",2,0,0,2,1
8,"super flyweight",19,"right-handed",7,2,2,11,0.727272727
8,"super featherweight",NA,"right-handed",7,1,0,8,0.875
8,"super lightweight",26,"right-handed",9,9,1,19,0.5
8,"bantamweight",26,"right-handed",5,2,1,8,0.6875
8,"lightweight",29,"right-handed",3,0,0,3,1
8,"welterweight",26,"right-handed",8,0,0,8,1
8,"light heavyweight",32,"right-handed",18,42,2,62,0.306451613
8,"super middleweight",20,"right-handed",2,0,0,2,1
8,"welterweight",43,"right-handed",17,2,1,20,0.875
8,"cruiserweight",37,"right-handed",6,6,0,12,0.5
8,"heavyweight",38,"right-handed",7,2,1,10,0.75
8,"middleweight",33,"right-handed",4,3,0,7,0.571428571
8,"welterweight",26,"right-handed",5,0,0,5,1
8,"lightweight",23,"right-handed",5,3,1,9,0.611111111
8,"super featherweight",35,"right-handed",8,2,3,13,0.730769231
8,"cruiserweight",37,"right-handed",11,5,0,16,0.6875
8,"welterweight",24,"right-handed",5,2,1,8,0.6875
8,"super featherweight",24,"right-handed",7,1,1,9,0.833333333
8,"lightweight",27,"right-handed",13,8,1,22,0.613636364
8,"featherweight",23,"right-handed",5,0,0,5,1
8,"super bantamweight",25,"right-handed",3,5,0,8,0.375
8,"super featherweight",27,"right-handed",5,0,0,5,1
8,"middleweight",27,"right-handed",12,7,0,19,0.631578947
8,"super welterweight",34,"right-handed",11,15,2,28,0.428571429
8,"featherweight",32,"right-handed",16,12,0,28,0.571428571
8,"middleweight",23,"right-handed",2,0,0,2,1
8,"welterweight",25,"right-handed",5,5,1,11,0.5
8,"heavyweight",34,"right-handed",8,7,0,15,0.533333333
8,"super welterweight",30,"right-handed",12,6,1,19,0.657894737
8,"super middleweight",28,"right-handed",8,4,1,13,0.653846154
8,"middleweight",38,"right-handed",16,6,1,23,0.717391304
8,"welterweight",NA,"right-handed",6,0,1,7,0.928571429
8,"welterweight",23,"right-handed",6,0,1,7,0.928571429
8,"super featherweight",36,"right-handed",2,4,1,7,0.357142857
8,"welterweight",26,"right-handed",15,6,0,21,0.714285714
8,"super bantamweight",17,"right-handed",5,0,0,5,1
8,"middleweight",29,"right-handed",6,3,0,9,0.666666667
8,"welterweight",26,"right-handed",5,0,0,5,1
8,"welterweight",23,"right-handed",3,0,0,3,1
8,"welterweight",24,"right-handed",3,1,0,4,0.75
7,"super featherweight",28,"right-handed",14,15,3,32,0.484375
7,"super welterweight",30,"right-handed",5,20,1,26,0.211538462
7,"super lightweight",27,"right-handed",8,4,2,14,0.642857143
7,"super bantamweight",NA,"right-handed",6,4,0,10,0.6
7,"featherweight",28,"right-handed",3,0,0,3,1
7,"super flyweight",NA,"right-handed",1,0,1,2,0.75
7,"super bantamweight",22,"right-handed",5,0,1,6,0.916666667
7,"super featherweight",24,"right-handed",13,15,5,33,0.46969697
7,"super middleweight",23,"right-handed",7,7,0,14,0.5
7,"heavyweight",34,"right-handed",6,2,0,8,0.75
7,"heavyweight",31,"right-handed",9,3,2,14,0.714285714
7,"featherweight",24,"right-handed",3,0,0,3,1
7,"welterweight",23,"right-handed",3,0,0,3,1
7,"cruiserweight",37,"right-handed",12,11,1,24,0.520833333
7,"middleweight",32,"right-handed",6,8,0,14,0.428571429
7,"super lightweight",30,"right-handed",4,5,1,10,0.45
7,"super bantamweight",23,"right-handed",7,5,0,12,0.583333333
7,"super welterweight",26,"right-handed",11,8,1,20,0.575
7,"super featherweight",23,"right-handed",5,1,0,6,0.833333333
7,"featherweight",NA,"right-handed",5,1,0,6,0.833333333
7,"super middleweight",24,"right-handed",3,0,0,3,1
7,"super middleweight",26,"right-handed",8,1,2,11,0.818181818
7,"cruiserweight",38,"right-handed",22,25,1,48,0.46875
7,"lightweight",23,"right-handed",3,0,0,3,1
7,"middleweight",31,"right-handed",8,4,0,12,0.666666667
7,"super featherweight",20,"right-handed",6,0,0,6,1
7,"heavyweight",32,"right-handed",7,2,1,10,0.75
7,"super middleweight",NA,"right-handed",4,3,0,7,0.571428571
7,"light heavyweight",24,"right-handed",16,9,0,25,0.64
7,"super featherweight",24,"right-handed",10,10,0,20,0.5
7,"featherweight",20,"right-handed",6,0,0,6,1
7,"lightweight",38,"right-handed",5,6,0,11,0.454545455
7,"welterweight",23,"right-handed",2,0,0,2,1
7,"super featherweight",30,"right-handed",10,13,4,27,0.444444444
7,"welterweight",NA,"right-handed",9,2,0,11,0.818181818
7,"middleweight",30,"right-handed",5,5,3,13,0.5
7,"super bantamweight",23,"right-handed",5,1,0,6,0.833333333
7,"super middleweight",21,"right-handed",4,0,0,4,1
7,"heavyweight",25,"right-handed",15,6,1,22,0.704545455
7,"bantamweight",NA,"right-handed",5,0,2,7,0.857142857
7,"super featherweight",NA,"right-handed",5,1,1,7,0.785714286
7,"super lightweight",20,"right-handed",8,10,0,18,0.444444444
7,"super welterweight",24,"right-handed",6,5,1,12,0.541666667
7,"featherweight",21,"right-handed",7,3,2,12,0.666666667
7,"featherweight",23,"right-handed",6,5,0,11,0.545454545
7,"lightweight",26,"right-handed",6,2,0,8,0.75
7,"lightweight",30,"right-handed",8,1,2,11,0.818181818
7,"super lightweight",22,"right-handed",5,0,0,5,1
7,"super bantamweight",45,"right-handed",31,15,0,46,0.673913043
7,"featherweight",22,"right-handed",6,4,0,10,0.6
7,"super featherweight",22,"right-handed",5,2,1,8,0.6875
7,"bantamweight",31,"right-handed",7,0,1,8,0.9375
7,"super middleweight",31,"right-handed",2,0,0,2,1
7,"super featherweight",24,"right-handed",5,4,0,9,0.555555556
7,"super featherweight",19,"right-handed",1,0,0,1,1
7,"super welterweight",23,"right-handed",3,1,0,4,0.75
7,"welterweight",26,"right-handed",8,0,0,8,1
7,"heavyweight",33,"right-handed",3,0,0,3,1
7,"super bantamweight",31,"right-handed",6,3,1,10,0.65
7,"super bantamweight",33,"right-handed",30,16,1,47,0.64893617
7,"welterweight",28,"right-handed",4,1,0,5,0.8
7,"light heavyweight",38,"right-handed",7,11,2,20,0.4
7,"super middleweight",41,"right-handed",14,9,0,23,0.608695652
7,"welterweight",27,"right-handed",6,0,1,7,0.928571429
7,"heavyweight",40,"right-handed",10,3,0,13,0.769230769
7,"super bantamweight",26,"right-handed",4,1,0,5,0.8
7,"heavyweight",45,"right-handed",3,5,0,8,0.375
7,"bantamweight",22,"right-handed",13,2,0,15,0.866666667
7,"featherweight",21,"right-handed",7,0,0,7,1
7,"lightweight",21,"right-handed",3,2,0,5,0.6
7,"super flyweight",25,"right-handed",8,9,0,17,0.470588235
7,"super lightweight",22,"right-handed",4,0,0,4,1
7,"super middleweight",29,"right-handed",16,6,0,22,0.727272727
7,"welterweight",35,"right-handed",4,0,0,4,1
7,"super bantamweight",27,"right-handed",5,6,0,11,0.454545455
7,"welterweight",27,"right-handed",9,6,1,16,0.59375
7,"heavyweight",39,"right-handed",30,24,1,55,0.554545455
7,"super bantamweight",22,"right-handed",4,5,0,9,0.444444444
7,"super lightweight",22,"right-handed",13,1,0,14,0.928571429
7,"heavyweight",38,"right-handed",14,5,0,19,0.736842105
7,"super lightweight",25,"right-handed",5,1,0,6,0.833333333
7,"super lightweight",27,"right-handed",23,12,5,40,0.6375
7,"super welterweight",29,"right-handed",11,14,4,29,0.448275862
7,"welterweight",27,"right-handed",14,12,2,28,0.535714286
7,"lightweight",31,"right-handed",8,3,0,11,0.727272727
7,"super lightweight",32,"right-handed",19,19,2,40,0.5
7,"featherweight",24,"right-handed",3,0,0,3,1
7,"super welterweight",28,"right-handed",4,6,3,13,0.423076923
7,"welterweight",35,"right-handed",7,2,1,10,0.75
7,"middleweight",26,"right-handed",6,0,0,6,1
7,"super middleweight",27,"right-handed",11,8,5,24,0.5625
7,"light heavyweight",24,"right-handed",3,0,0,3,1
7,"super welterweight",23,"right-handed",4,0,0,4,1
7,"heavyweight",21,"right-handed",3,0,1,4,0.875
7,"lightweight",31,"right-handed",19,8,1,28,0.696428571
7,"super featherweight",34,"right-handed",37,28,6,71,0.563380282
7,"super bantamweight",23,"right-handed",4,3,0,7,0.571428571
7,"super welterweight",25,"right-handed",5,0,0,5,1
7,"super welterweight",40,"right-handed",20,24,3,47,0.457446809
7,"lightweight",33,"right-handed",9,10,3,22,0.477272727
7,"super middleweight",31,"right-handed",4,0,1,5,0.9
7,"cruiserweight",31,"right-handed",13,28,4,45,0.333333333
7,"super flyweight",NA,"right-handed",3,1,0,4,0.75
7,"super lightweight",23,"right-handed",3,0,0,3,1
7,"super lightweight",26,"right-handed",7,6,4,17,0.529411765
7,"super welterweight",30,"right-handed",4,0,0,4,1
7,"welterweight",34,"right-handed",4,11,1,16,0.28125
7,"flyweight",23,"right-handed",5,5,0,10,0.5
7,"super featherweight",28,"right-handed",9,14,4,27,0.407407407
7,"bantamweight",31,"right-handed",5,1,0,6,0.833333333
7,"middleweight",26,"right-handed",3,0,1,4,0.875
7,"heavyweight",43,"right-handed",42,29,0,71,0.591549296
7,"minimumweight",24,"right-handed",5,1,0,6,0.833333333
7,"heavyweight",29,"right-handed",14,5,0,19,0.736842105
7,"super middleweight",29,"right-handed",3,0,0,3,1
7,"super bantamweight",20,"right-handed",4,2,0,6,0.666666667
7,"cruiserweight",34,"right-handed",8,2,1,11,0.772727273
7,"featherweight",20,"right-handed",2,1,0,3,0.666666667
7,"flyweight",19,"right-handed",5,2,0,7,0.714285714
7,"lightweight",26,"right-handed",8,4,0,12,0.666666667
7,"middleweight",25,"right-handed",3,0,0,3,1
7,"lightweight",27,"right-handed",14,14,1,29,0.5
7,"featherweight",17,"right-handed",2,0,0,2,1
7,"super bantamweight",20,"right-handed",10,2,0,12,0.833333333
7,"super welterweight",29,"right-handed",9,2,1,12,0.791666667
7,"cruiserweight",40,"right-handed",10,6,0,16,0.625
7,"super lightweight",NA,"right-handed",4,1,1,6,0.75
7,"lightweight",43,"right-handed",7,4,1,12,0.625
7,"lightweight",33,"right-handed",10,4,0,14,0.714285714
7,"heavyweight",43,"right-handed",8,12,4,24,0.416666667
7,"super bantamweight",22,"right-handed",11,12,1,24,0.479166667
7,"heavyweight",45,"right-handed",11,5,0,16,0.6875
7,"middleweight",37,"right-handed",28,25,4,57,0.526315789
7,"super flyweight",21,"right-handed",4,1,1,6,0.75
7,"welterweight",26,"right-handed",5,2,0,7,0.714285714
7,"super welterweight",24,"right-handed",4,0,1,5,0.9
7,"lightweight",35,"right-handed",29,19,1,49,0.602040816
7,"super flyweight",24,"right-handed",9,3,1,13,0.730769231
7,"featherweight",33,"right-handed",10,6,4,20,0.6
7,"cruiserweight",45,"right-handed",30,4,2,36,0.861111111
7,"super flyweight",36,"right-handed",4,2,0,6,0.666666667
7,"super lightweight",24,"right-handed",9,3,0,12,0.75
7,"super featherweight",23,"right-handed",4,0,0,4,1
7,"bantamweight",29,"right-handed",5,5,0,10,0.5
7,"cruiserweight",22,"right-handed",4,0,0,4,1
7,"cruiserweight",30,"right-handed",20,7,0,27,0.740740741
7,"welterweight",21,"right-handed",3,0,0,3,1
7,"heavyweight",34,"right-handed",2,0,1,3,0.833333333
7,"cruiserweight",46,"right-handed",8,4,1,13,0.653846154
7,"bantamweight",26,"right-handed",5,1,0,6,0.833333333
7,"welterweight",34,"right-handed",18,12,0,30,0.6
7,"heavyweight",30,"right-handed",16,6,0,22,0.727272727
7,"bantamweight",20,"right-handed",7,1,1,9,0.833333333
7,"super middleweight",33,"right-handed",4,7,0,11,0.363636364
7,"cruiserweight",37,"right-handed",13,30,4,47,0.319148936
7,"light heavyweight",34,"right-handed",11,5,1,17,0.676470588
7,"flyweight",25,"right-handed",12,11,5,28,0.517857143
7,"cruiserweight",24,"right-handed",3,1,0,4,0.75
7,"super bantamweight",37,"right-handed",21,15,0,36,0.583333333
7,"super featherweight",33,"right-handed",6,10,3,19,0.394736842
7,"super featherweight",22,"right-handed",2,1,0,3,0.666666667
7,"super featherweight",29,"right-handed",25,15,0,40,0.625
7,"heavyweight",33,"right-handed",2,1,0,3,0.666666667
7,"super lightweight",29,"right-handed",5,3,2,10,0.6
7,"super flyweight",25,"right-handed",1,0,0,1,1
7,"bantamweight",24,"right-handed",3,3,1,7,0.5
7,"heavyweight",22,"right-handed",5,1,0,6,0.833333333
7,"super bantamweight",28,"right-handed",16,8,1,25,0.66
7,"lightweight",34,"right-handed",9,6,0,15,0.6
7,"welterweight",21,"right-handed",6,0,0,6,1
7,"super welterweight",30,"right-handed",20,6,0,26,0.769230769
7,"cruiserweight",22,"right-handed",4,1,0,5,0.8
7,"bantamweight",36,"right-handed",4,2,1,7,0.642857143
7,"bantamweight",22,"right-handed",7,4,0,11,0.636363636
7,"featherweight",32,"right-handed",21,18,1,40,0.5375
7,"welterweight",31,"right-handed",14,10,0,24,0.583333333
7,"super middleweight",35,"right-handed",16,7,0,23,0.695652174
7,"flyweight",NA,"right-handed",4,3,2,9,0.555555556
7,"super lightweight",30,"right-handed",5,2,2,9,0.666666667
7,"middleweight",39,"right-handed",6,7,1,14,0.464285714
7,"super welterweight",28,"right-handed",4,0,0,4,1
7,"middleweight",26,"right-handed",3,1,0,4,0.75
7,"featherweight",24,"right-handed",2,0,0,2,1
7,"middleweight",40,"right-handed",15,10,1,26,0.596153846
7,"middleweight",NA,"right-handed",34,15,2,51,0.68627451
7,"middleweight",28,"right-handed",3,0,1,4,0.875
7,"middleweight",NA,"right-handed",4,2,0,6,0.666666667
7,"super middleweight",27,"right-handed",7,0,1,8,0.9375
7,"welterweight",22,"right-handed",4,0,0,4,1
7,"welterweight",18,"right-handed",8,0,0,8,1
7,"middleweight",27,"right-handed",3,0,0,3,1
7,"bantamweight",24,"right-handed",12,5,2,19,0.684210526
7,"super bantamweight",23,"right-handed",10,4,1,15,0.7
7,"super welterweight",28,"right-handed",8,2,0,10,0.8
7,"super featherweight",37,"right-handed",18,2,0,20,0.9
7,"bantamweight",20,"right-handed",3,2,0,5,0.6
7,"super middleweight",32,"right-handed",5,2,0,7,0.714285714
7,"heavyweight",NA,"right-handed",3,0,0,3,1
7,"super lightweight",37,"right-handed",5,2,0,7,0.714285714
7,"lightweight",NA,"right-handed",2,2,0,4,0.5
7,"super welterweight",23,"right-handed",3,0,0,3,1
7,"middleweight",29,"right-handed",9,21,1,31,0.306451613
7,"super welterweight",29,"right-handed",6,0,0,6,1
7,"super lightweight",34,"right-handed",13,13,1,27,0.5
7,"super bantamweight",33,"right-handed",4,5,2,11,0.454545455
7,"middleweight",NA,"right-handed",4,2,0,6,0.666666667
7,"super featherweight",23,"right-handed",4,2,0,6,0.666666667
7,"welterweight",34,"right-handed",7,3,1,11,0.681818182
7,"super lightweight",36,"right-handed",9,5,1,15,0.633333333
7,"lightweight",NA,"right-handed",3,0,0,3,1
7,"light heavyweight",33,"right-handed",3,0,0,3,1
7,"light heavyweight",23,"right-handed",3,0,0,3,1
7,"heavyweight",32,"right-handed",2,0,0,2,1
7,"super flyweight",22,"right-handed",8,1,0,9,0.888888889
7,"cruiserweight",33,"right-handed",6,2,2,10,0.7
7,"bantamweight",29,"right-handed",8,14,2,24,0.375
7,"welterweight",29,"right-handed",3,1,0,4,0.75
7,"middleweight",28,"right-handed",6,6,0,12,0.5
7,"featherweight",29,"right-handed",6,12,0,18,0.333333333
7,"featherweight",NA,"right-handed",5,2,1,8,0.6875
7,"heavyweight",21,"right-handed",5,1,0,6,0.833333333
7,"super welterweight",24,"right-handed",7,2,0,9,0.777777778
7,"welterweight",28,"right-handed",3,1,1,5,0.7
7,"super bantamweight",19,"right-handed",9,1,1,11,0.863636364
7,"cruiserweight",33,"right-handed",14,22,2,38,0.394736842
7,"middleweight",33,"right-handed",6,8,1,15,0.433333333
7,"super bantamweight",23,"right-handed",3,1,0,4,0.75
7,"middleweight",25,"right-handed",5,0,1,6,0.916666667
7,"light heavyweight",41,"right-handed",10,13,2,25,0.44
7,"cruiserweight",28,"right-handed",19,6,0,25,0.76
7,"super bantamweight",21,"right-handed",6,2,0,8,0.75
7,"lightweight",26,"right-handed",4,3,0,7,0.571428571
7,"super welterweight",38,"right-handed",10,6,2,18,0.611111111
7,"middleweight",23,"right-handed",3,0,0,3,1
7,"super lightweight",34,"right-handed",42,24,1,67,0.634328358
7,"cruiserweight",29,"right-handed",6,3,0,9,0.666666667
7,"super lightweight",40,"right-handed",11,11,1,23,0.5
7,"middleweight",30,"right-handed",16,38,0,54,0.296296296
7,"flyweight",34,"right-handed",6,9,2,17,0.411764706
7,"super flyweight",25,"right-handed",6,4,0,10,0.6
7,"cruiserweight",32,"right-handed",10,4,0,14,0.714285714
7,"super welterweight",29,"right-handed",17,7,0,24,0.708333333
7,"cruiserweight",38,"right-handed",7,7,2,16,0.5
7,"super featherweight",27,"right-handed",5,3,0,8,0.625
7,"lightweight",35,"right-handed",7,12,3,22,0.386363636
7,"welterweight",33,"right-handed",9,17,5,31,0.370967742
7,"super featherweight",33,"right-handed",5,7,4,16,0.4375
7,"super welterweight",34,"right-handed",4,2,2,8,0.625
7,"super featherweight",26,"right-handed",3,0,1,4,0.875
7,"featherweight",NA,"right-handed",4,0,0,4,1
7,"lightweight",31,"right-handed",9,4,0,13,0.692307692
7,"bantamweight",23,"right-handed",9,5,0,14,0.642857143
7,"super middleweight",25,"right-handed",3,2,0,5,0.6
7,"super lightweight",32,"right-handed",21,15,0,36,0.583333333
7,"flyweight",21,"right-handed",3,1,0,4,0.75
7,"heavyweight",39,"right-handed",19,6,1,26,0.75
7,"super welterweight",34,"right-handed",18,15,0,33,0.545454545
7,"cruiserweight",28,"right-handed",1,0,0,1,1
7,"lightweight",25,"right-handed",7,3,0,10,0.7
7,"super featherweight",40,"right-handed",19,11,0,30,0.633333333
7,"bantamweight",21,"right-handed",5,2,0,7,0.714285714
7,"super bantamweight",27,"right-handed",8,6,1,15,0.566666667
7,"super lightweight",26,"right-handed",1,3,0,4,0.25
7,"featherweight",26,"right-handed",5,6,2,13,0.461538462
7,"super lightweight",20,"right-handed",10,4,0,14,0.714285714
7,"super middleweight",23,"right-handed",4,1,1,6,0.75
7,"featherweight",29,"right-handed",13,3,2,18,0.777777778
7,"super flyweight",27,"right-handed",5,6,1,12,0.458333333
7,"super middleweight",NA,"right-handed",4,10,3,17,0.323529412
7,"super bantamweight",21,"right-handed",4,2,0,6,0.666666667
7,"lightweight",27,"right-handed",17,3,0,20,0.85
7,"cruiserweight",33,"right-handed",6,0,0,6,1
7,"super welterweight",33,"right-handed",5,2,0,7,0.714285714
7,"middleweight",36,"right-handed",19,12,1,32,0.609375
7,"super bantamweight",23,"right-handed",4,0,0,4,1
7,"cruiserweight",33,"right-handed",16,9,0,25,0.64
7,"middleweight",26,"right-handed",10,35,3,48,0.239583333
7,"light heavyweight",44,"right-handed",15,5,0,20,0.75
7,"middleweight",26,"right-handed",3,0,0,3,1
7,"super featherweight",31,"right-handed",4,5,0,9,0.444444444
7,"light heavyweight",28,"right-handed",7,0,0,7,1
7,"super featherweight",29,"right-handed",6,1,0,7,0.857142857
7,"super featherweight",29,"right-handed",4,2,1,7,0.642857143
7,"lightweight",25,"right-handed",5,2,1,8,0.6875
7,"bantamweight",22,"right-handed",3,3,2,8,0.5
7,"lightweight",28,"right-handed",23,5,0,28,0.821428571
7,"heavyweight",25,"right-handed",3,1,0,4,0.75
7,"super welterweight",25,"right-handed",3,0,0,3,1
7,"super featherweight",22,"right-handed",2,0,0,2,1
7,"super bantamweight",NA,"right-handed",4,0,0,4,1
6,"cruiserweight",35,"right-handed",10,4,1,15,0.7
6,"bantamweight",25,"right-handed",7,3,1,11,0.681818182
6,"heavyweight",26,"right-handed",5,2,0,7,0.714285714
6,"lightweight",28,"right-handed",6,4,2,12,0.583333333
6,"middleweight",22,"right-handed",7,1,0,8,0.875
6,"welterweight",25,"right-handed",4,2,0,6,0.666666667
6,"featherweight",25,"right-handed",3,0,0,3,1
6,"welterweight",26,"right-handed",3,0,0,3,1
6,"flyweight",27,"right-handed",4,1,0,5,0.8
6,"light heavyweight",33,"right-handed",14,17,0,31,0.451612903
6,"super lightweight",23,"right-handed",2,1,2,5,0.6
6,"super featherweight",30,"right-handed",7,15,1,23,0.326086957
6,"super featherweight",24,"right-handed",3,1,0,4,0.75
6,"middleweight",21,"right-handed",3,0,1,4,0.875
6,"super middleweight",23,"right-handed",3,0,0,3,1
6,"featherweight",22,"right-handed",3,0,0,3,1
6,"cruiserweight",26,"right-handed",5,1,0,6,0.833333333
6,"featherweight",35,"right-handed",4,2,0,6,0.666666667
6,"cruiserweight",23,"right-handed",13,10,0,23,0.565217391
6,"flyweight",22,"right-handed",5,5,1,11,0.5
6,"super middleweight",27,"right-handed",13,5,0,18,0.722222222
6,"super featherweight",20,"right-handed",5,0,0,5,1
6,"light heavyweight",33,"right-handed",32,17,1,50,0.65
6,"super welterweight",36,"right-handed",11,7,0,18,0.611111111
6,"super bantamweight",30,"right-handed",8,8,1,17,0.5
6,"welterweight",23,"right-handed",2,3,1,6,0.416666667
6,"cruiserweight",30,"right-handed",6,6,1,13,0.5
6,"minimumweight",23,"right-handed",4,3,0,7,0.571428571
6,"super lightweight",27,"right-handed",10,6,1,17,0.617647059
6,"flyweight",29,"right-handed",24,19,0,43,0.558139535
6,"super featherweight",31,"right-handed",16,15,3,34,0.514705882
6,"bantamweight",24,"right-handed",4,12,0,16,0.25
6,"bantamweight",17,"right-handed",6,0,1,7,0.928571429
6,"super bantamweight",20,"right-handed",4,2,1,7,0.642857143
6,"welterweight",22,"right-handed",3,0,0,3,1
6,"light heavyweight",21,"right-handed",2,0,0,2,1
6,"light heavyweight",34,"right-handed",10,3,0,13,0.769230769
6,"flyweight",29,"right-handed",15,6,0,21,0.714285714
6,"super lightweight",22,"right-handed",5,1,0,6,0.833333333
6,"cruiserweight",34,"right-handed",9,0,0,9,1
6,"super middleweight",23,"right-handed",3,0,0,3,1
6,"bantamweight",24,"right-handed",0,0,2,2,0.5
6,"cruiserweight",27,"right-handed",3,0,0,3,1
6,"super bantamweight",20,"right-handed",6,0,0,6,1
6,"featherweight",21,"right-handed",2,0,0,2,1
6,"heavyweight",36,"right-handed",6,0,0,6,1
6,"middleweight",41,"right-handed",9,10,1,20,0.475
6,"heavyweight",29,"right-handed",18,44,7,69,0.311594203
6,"super middleweight",25,"right-handed",9,2,0,11,0.818181818
6,"welterweight",22,"right-handed",10,6,0,16,0.625
6,"super middleweight",27,"right-handed",6,5,0,11,0.545454545
6,"middleweight",NA,"right-handed",6,4,0,10,0.6
6,"cruiserweight",45,"right-handed",32,18,0,50,0.64
6,"middleweight",26,"right-handed",3,0,1,4,0.875
6,"cruiserweight",34,"right-handed",6,4,0,10,0.6
6,"super welterweight",28,"right-handed",4,1,2,7,0.714285714
6,"super featherweight",23,"right-handed",3,3,0,6,0.5
6,"middleweight",23,"right-handed",3,0,0,3,1
6,"lightweight",28,"right-handed",9,3,2,14,0.714285714
6,"super middleweight",29,"right-handed",5,2,0,7,0.714285714
6,"featherweight",30,"right-handed",6,5,2,13,0.538461538
6,"welterweight",23,"right-handed",5,0,0,5,1
6,"super welterweight",35,"right-handed",3,9,4,16,0.3125
6,"light heavyweight",25,"right-handed",26,16,0,42,0.619047619
6,"light heavyweight",26,"right-handed",3,1,1,5,0.7
6,"flyweight",25,"right-handed",3,4,0,7,0.428571429
6,"super middleweight",20,"right-handed",2,0,0,2,1
6,"featherweight",31,"right-handed",6,13,5,24,0.354166667
6,"super middleweight",27,"right-handed",2,0,0,2,1
6,"heavyweight",28,"right-handed",8,11,0,19,0.421052632
6,"super welterweight",24,"right-handed",11,11,0,22,0.5
6,"welterweight",34,"right-handed",7,24,1,32,0.234375
6,"super bantamweight",24,"right-handed",5,2,0,7,0.714285714
6,"super middleweight",21,"right-handed",2,0,0,2,1
6,"super welterweight",21,"right-handed",7,1,0,8,0.875
6,"light heavyweight",24,"right-handed",4,1,1,6,0.75
6,"light heavyweight",23,"right-handed",3,5,2,10,0.4
6,"featherweight",31,"right-handed",8,4,0,12,0.666666667
6,"heavyweight",32,"right-handed",23,6,0,29,0.793103448
6,"heavyweight",34,"right-handed",8,8,0,16,0.5
6,"lightweight",34,"right-handed",23,15,2,40,0.6
6,"middleweight",28,"right-handed",5,0,2,7,0.857142857
6,"bantamweight",22,"right-handed",4,0,0,4,1
6,"featherweight",32,"right-handed",10,18,3,31,0.370967742
6,"bantamweight",25,"right-handed",6,9,1,16,0.40625
6,"light heavyweight",25,"right-handed",2,0,0,2,1
6,"super lightweight",NA,"right-handed",4,9,0,13,0.307692308
6,"super lightweight",21,"right-handed",4,1,0,5,0.8
6,"middleweight",21,"right-handed",3,0,0,3,1
6,"middleweight",21,"right-handed",4,1,0,5,0.8
6,"super lightweight",27,"right-handed",4,1,0,5,0.8
6,"super middleweight",31,"right-handed",10,14,2,26,0.423076923
6,"super lightweight",24,"right-handed",3,0,1,4,0.875
6,"light heavyweight",35,"right-handed",8,3,1,12,0.708333333
6,"super featherweight",25,"right-handed",4,1,0,5,0.8
6,"middleweight",31,"right-handed",15,11,2,28,0.571428571
6,"heavyweight",22,"right-handed",2,1,0,3,0.666666667
6,"super bantamweight",26,"right-handed",6,2,1,9,0.722222222
6,"light flyweight",25,"right-handed",7,14,2,23,0.347826087
6,"middleweight",30,"right-handed",6,2,1,9,0.722222222
6,"lightweight",30,"right-handed",7,2,0,9,0.777777778
6,"super welterweight",30,"right-handed",16,7,3,26,0.673076923
6,"super lightweight",33,"right-handed",2,0,0,2,1
6,"bantamweight",26,"right-handed",8,15,3,26,0.365384615
6,"welterweight",36,"right-handed",4,1,0,5,0.8
6,"light flyweight",28,"right-handed",7,6,2,15,0.533333333
6,"lightweight",24,"right-handed",2,0,0,2,1
6,"heavyweight",41,"right-handed",14,11,2,27,0.555555556
6,"super welterweight",32,"right-handed",11,13,2,26,0.461538462
6,"flyweight",20,"right-handed",5,2,1,8,0.6875
6,"light heavyweight",36,"right-handed",4,6,1,11,0.409090909
6,"heavyweight",34,"right-handed",14,6,1,21,0.69047619
6,"minimumweight",NA,"right-handed",8,5,1,14,0.607142857
6,"",26,"right-handed",4,0,0,4,1
6,"light flyweight",22,"right-handed",5,2,1,8,0.6875
6,"featherweight",20,"right-handed",9,3,1,13,0.730769231
6,"cruiserweight",24,"right-handed",10,9,0,19,0.526315789
6,"featherweight",38,"right-handed",29,28,3,60,0.508333333
6,"super welterweight",28,"right-handed",19,17,5,41,0.524390244
6,"welterweight",23,"right-handed",5,1,0,6,0.833333333
6,"bantamweight",29,"right-handed",3,6,2,11,0.363636364
6,"super bantamweight",31,"right-handed",5,5,1,11,0.5
6,"welterweight",27,"right-handed",3,1,0,4,0.75
6,"welterweight",35,"right-handed",7,4,0,11,0.636363636
6,"welterweight",32,"right-handed",13,2,0,15,0.866666667
6,"featherweight",32,"right-handed",15,13,1,29,0.534482759
6,"light heavyweight",23,"right-handed",7,3,1,11,0.681818182
6,"super bantamweight",27,"right-handed",4,2,1,7,0.642857143
6,"lightweight",29,"right-handed",16,9,1,26,0.634615385
6,"super featherweight",31,"right-handed",12,10,4,26,0.538461538
6,"welterweight",28,"right-handed",8,3,2,13,0.692307692
6,"welterweight",26,"right-handed",6,3,1,10,0.65
6,"super featherweight",20,"right-handed",3,1,0,4,0.75
6,"heavyweight",39,"right-handed",39,13,0,52,0.75
6,"flyweight",42,"right-handed",13,17,1,31,0.435483871
6,"super bantamweight",26,"right-handed",4,6,3,13,0.423076923
6,"featherweight",23,"right-handed",8,8,4,20,0.5
6,"heavyweight",41,"right-handed",11,8,1,20,0.575
6,"cruiserweight",27,"right-handed",18,15,0,33,0.545454545
6,"featherweight",23,"right-handed",3,0,0,3,1
6,"super welterweight",22,"right-handed",4,0,0,4,1
6,"welterweight",32,"right-handed",5,7,1,13,0.423076923
6,"bantamweight",28,"right-handed",9,21,3,33,0.318181818
6,"bantamweight",29,"right-handed",3,6,2,11,0.363636364
6,"heavyweight",35,"right-handed",4,0,0,4,1
6,"super welterweight",30,"right-handed",5,0,0,5,1
6,"super welterweight",23,"right-handed",3,0,0,3,1
6,"lightweight",27,"right-handed",4,2,0,6,0.666666667
6,"super featherweight",25,"right-handed",6,1,0,7,0.857142857
6,"super welterweight",27,"right-handed",5,3,2,10,0.6
6,"bantamweight",28,"right-handed",5,1,1,7,0.785714286
6,"super lightweight",45,"right-handed",18,18,4,40,0.5
6,"cruiserweight",29,"right-handed",3,0,0,3,1
6,"super featherweight",39,"right-handed",16,8,2,26,0.653846154
6,"super welterweight",27,"right-handed",12,13,5,30,0.483333333
6,"light heavyweight",30,"right-handed",2,0,0,2,1
6,"lightweight",25,"right-handed",11,10,2,23,0.52173913
6,"super lightweight",38,"right-handed",21,12,2,35,0.628571429
6,"super lightweight",23,"right-handed",6,2,0,8,0.75
6,"light heavyweight",36,"right-handed",6,20,2,28,0.25
6,"lightweight",22,"right-handed",4,0,0,4,1
6,"super lightweight",27,"right-handed",4,1,1,6,0.75
6,"lightweight",35,"right-handed",18,16,0,34,0.529411765
6,"super welterweight",25,"right-handed",2,0,0,2,1
6,"lightweight",28,"right-handed",5,1,1,7,0.785714286
6,"heavyweight",37,"right-handed",5,0,0,5,1
6,"welterweight",34,"right-handed",12,10,0,22,0.545454545
6,"middleweight",28,"right-handed",5,0,0,5,1
6,"super featherweight",27,"right-handed",3,1,1,5,0.7
6,"cruiserweight",42,"right-handed",13,29,0,42,0.30952381
6,"cruiserweight",30,"right-handed",6,2,0,8,0.75
6,"light flyweight",18,"right-handed",3,1,1,5,0.7
6,"bantamweight",25,"right-handed",4,1,0,5,0.8
6,"super featherweight",19,"right-handed",4,0,0,4,1
6,"welterweight",37,"right-handed",13,13,0,26,0.5
6,"middleweight",35,"right-handed",23,23,1,47,0.5
6,"flyweight",20,"right-handed",4,4,0,8,0.5
6,"super featherweight",20,"right-handed",5,1,0,6,0.833333333
6,"welterweight",20,"right-handed",2,0,0,2,1
6,"super bantamweight",46,"right-handed",24,9,1,34,0.720588235
6,"welterweight",19,"right-handed",5,0,0,5,1
6,"super middleweight",27,"right-handed",4,1,1,6,0.75
6,"super lightweight",30,"right-handed",6,4,1,11,0.590909091
6,"featherweight",28,"right-handed",6,3,1,10,0.65
6,"welterweight",33,"right-handed",8,16,2,26,0.346153846
6,"lightweight",25,"right-handed",2,1,1,4,0.625
6,"heavyweight",NA,"right-handed",5,0,0,5,1
6,"welterweight",38,"right-handed",4,3,1,8,0.5625
6,"super middleweight",35,"right-handed",7,9,1,17,0.441176471
6,"super featherweight",31,"right-handed",9,16,1,26,0.365384615
6,"flyweight",19,"right-handed",2,0,2,4,0.75
6,"welterweight",26,"right-handed",2,1,2,5,0.6
6,"middleweight",38,"right-handed",4,4,1,9,0.5
6,"featherweight",24,"right-handed",6,0,0,6,1
6,"light heavyweight",NA,"right-handed",6,2,0,8,0.75
6,"cruiserweight",23,"right-handed",5,2,0,7,0.714285714
6,"welterweight",24,"right-handed",4,1,1,6,0.75
6,"lightweight",31,"right-handed",37,23,0,60,0.616666667
6,"lightweight",26,"right-handed",2,0,0,2,1
6,"lightweight",23,"right-handed",3,5,0,8,0.375
6,"super welterweight",29,"right-handed",16,18,3,37,0.472972973
6,"lightweight",20,"right-handed",10,1,0,11,0.909090909
6,"welterweight",21,"right-handed",4,0,1,5,0.9
6,"lightweight",21,"right-handed",9,7,0,16,0.5625
6,"super lightweight",20,"right-handed",5,0,0,5,1
6,"middleweight",31,"right-handed",5,2,1,8,0.6875
6,"bantamweight",39,"right-handed",18,12,5,35,0.585714286
6,"lightweight",22,"right-handed",4,1,0,5,0.8
6,"super featherweight",24,"right-handed",2,0,2,4,0.75
6,"super lightweight",33,"right-handed",4,2,0,6,0.666666667
6,"featherweight",19,"right-handed",2,0,2,4,0.75
6,"flyweight",30,"right-handed",21,18,1,40,0.5375
6,"super middleweight",29,"right-handed",3,3,0,6,0.5
6,"light heavyweight",28,"right-handed",3,0,0,3,1
6,"super bantamweight",36,"right-handed",3,2,0,5,0.6
6,"light flyweight",25,"right-handed",4,4,0,8,0.5
6,"flyweight",30,"right-handed",6,1,1,8,0.8125
6,"light heavyweight",21,"right-handed",2,1,0,3,0.666666667
6,"lightweight",26,"right-handed",4,6,3,13,0.423076923
6,"lightweight",21,"right-handed",3,0,0,3,1
6,"super lightweight",28,"right-handed",8,12,1,21,0.404761905
6,"super flyweight",33,"right-handed",25,12,1,38,0.671052632
6,"bantamweight",26,"right-handed",11,7,1,19,0.605263158
6,"flyweight",27,"right-handed",5,4,1,10,0.55
6,"heavyweight",24,"right-handed",4,1,1,6,0.75
6,"flyweight",28,"right-handed",9,10,2,21,0.476190476
6,"super welterweight",32,"right-handed",18,11,0,29,0.620689655
6,"lightweight",18,"right-handed",8,4,0,12,0.666666667
6,"super welterweight",42,"right-handed",18,4,1,23,0.804347826
6,"welterweight",26,"right-handed",4,0,1,5,0.9
6,"featherweight",37,"right-handed",10,5,0,15,0.666666667
6,"super bantamweight",26,"right-handed",5,10,0,15,0.333333333
6,"super middleweight",29,"right-handed",7,1,0,8,0.875
6,"super bantamweight",27,"right-handed",8,11,1,20,0.425
6,"bantamweight",28,"right-handed",8,12,0,20,0.4
6,"bantamweight",23,"right-handed",5,5,0,10,0.5
6,"super middleweight",28,"right-handed",4,2,0,6,0.666666667
6,"super flyweight",27,"right-handed",3,5,3,11,0.409090909
6,"super middleweight",38,"right-handed",14,15,0,29,0.482758621
6,"minimumweight",34,"right-handed",2,3,0,5,0.4
6,"light heavyweight",23,"right-handed",3,0,0,3,1
6,"light heavyweight",23,"right-handed",2,2,0,4,0.5
6,"heavyweight",43,"right-handed",14,13,2,29,0.517241379
6,"featherweight",39,"right-handed",9,16,1,26,0.365384615
6,"super bantamweight",27,"right-handed",5,1,0,6,0.833333333
6,"light flyweight",25,"right-handed",7,3,1,11,0.681818182
6,"light heavyweight",41,"right-handed",5,16,1,22,0.25
6,"middleweight",23,"right-handed",3,0,0,3,1
6,"featherweight",20,"right-handed",4,0,1,5,0.9
6,"lightweight",26,"right-handed",11,14,0,25,0.44
6,"bantamweight",38,"right-handed",31,18,1,50,0.63
6,"super bantamweight",26,"right-handed",16,12,1,29,0.568965517
6,"middleweight",34,"right-handed",21,10,0,31,0.677419355
6,"super bantamweight",35,"right-handed",8,17,2,27,0.333333333
6,"super lightweight",23,"right-handed",2,0,0,2,1
6,"featherweight",26,"right-handed",5,2,0,7,0.714285714
6,"lightweight",NA,"right-handed",3,2,0,5,0.6
6,"welterweight",23,"right-handed",5,0,0,5,1
6,"light flyweight",32,"right-handed",5,8,5,18,0.416666667
6,"super lightweight",23,"right-handed",5,2,0,7,0.714285714
6,"super featherweight",30,"right-handed",13,6,0,19,0.684210526
6,"bantamweight",22,"right-handed",1,2,0,3,0.333333333
6,"super bantamweight",27,"right-handed",3,4,2,9,0.444444444
6,"bantamweight",25,"right-handed",6,4,0,10,0.6
6,"featherweight",28,"right-handed",4,0,0,4,1
6,"lightweight",28,"right-handed",7,9,2,18,0.444444444
6,"flyweight",24,"right-handed",3,1,1,5,0.7
6,"super lightweight",26,"right-handed",12,14,0,26,0.461538462
6,"lightweight",23,"right-handed",6,1,2,9,0.777777778
6,"heavyweight",22,"right-handed",3,0,0,3,1
6,"super middleweight",40,"right-handed",19,16,0,35,0.542857143
6,"welterweight",31,"right-handed",3,1,0,4,0.75
6,"super lightweight",30,"right-handed",4,7,2,13,0.384615385
6,"super lightweight",27,"right-handed",7,4,0,11,0.636363636
6,"lightweight",35,"right-handed",7,6,1,14,0.535714286
6,"super featherweight",24,"right-handed",8,6,0,14,0.571428571
6,"super middleweight",44,"right-handed",6,4,0,10,0.6
6,"welterweight",30,"right-handed",5,8,1,14,0.392857143
6,"super featherweight",21,"right-handed",10,2,0,12,0.833333333
6,"welterweight",33,"right-handed",9,2,0,11,0.818181818
6,"lightweight",36,"right-handed",4,5,0,9,0.444444444
6,"heavyweight",29,"right-handed",5,6,1,12,0.458333333
6,"featherweight",29,"right-handed",30,25,0,55,0.545454545
6,"super middleweight",29,"right-handed",6,0,0,6,1
6,"lightweight",21,"right-handed",3,5,0,8,0.375
6,"super lightweight",21,"right-handed",3,0,1,4,0.875
6,"super featherweight",25,"right-handed",2,3,0,5,0.4
6,"super lightweight",27,"right-handed",7,19,5,31,0.306451613
6,"featherweight",26,"right-handed",10,6,0,16,0.625
6,"welterweight",26,"right-handed",3,1,0,4,0.75
6,"light heavyweight",36,"right-handed",22,11,0,33,0.666666667
6,"featherweight",24,"right-handed",3,2,0,5,0.6
6,"welterweight",22,"right-handed",4,6,2,12,0.416666667
6,"featherweight",19,"right-handed",4,1,0,5,0.8
6,"lightweight",NA,"right-handed",3,0,0,3,1
6,"super featherweight",24,"right-handed",2,0,0,2,1
6,"lightweight",22,"right-handed",2,0,0,2,1
6,"middleweight",20,"right-handed",2,0,0,2,1
6,"super featherweight",23,"right-handed",4,0,1,5,0.9
6,"welterweight",33,"right-handed",10,2,1,13,0.807692308
6,"cruiserweight",31,"right-handed",5,3,0,8,0.625
6,"flyweight",27,"right-handed",9,11,0,20,0.45
6,"super lightweight",29,"right-handed",4,1,0,5,0.8
6,"super lightweight",25,"right-handed",3,1,1,5,0.7
6,"super featherweight",26,"right-handed",3,3,0,6,0.5
6,"super featherweight",24,"right-handed",3,0,0,3,1
6,"super featherweight",25,"right-handed",18,17,1,36,0.513888889
6,"cruiserweight",29,"right-handed",3,0,0,3,1
6,"middleweight",32,"right-handed",5,6,1,12,0.458333333
6,"cruiserweight",26,"right-handed",3,1,0,4,0.75
6,"super featherweight",NA,"right-handed",2,0,0,2,1
5,"middleweight",35,"right-handed",3,5,1,9,0.388888889
5,"cruiserweight",28,"right-handed",4,3,1,8,0.5625
5,"featherweight",24,"right-handed",9,4,0,13,0.692307692
5,"super welterweight",40,"right-handed",9,15,2,26,0.384615385
5,"bantamweight",21,"right-handed",4,3,0,7,0.571428571
5,"super featherweight",22,"right-handed",4,1,2,7,0.714285714
5,"super featherweight",24,"right-handed",9,2,0,11,0.818181818
5,"super middleweight",28,"right-handed",3,3,1,7,0.5
5,"super lightweight",21,"right-handed",3,2,1,6,0.583333333
5,"lightweight",30,"right-handed",3,2,0,5,0.6
5,"super bantamweight",21,"right-handed",5,2,2,9,0.666666667
5,"featherweight",32,"right-handed",4,2,0,6,0.666666667
5,"welterweight",23,"right-handed",4,6,1,11,0.409090909
5,"middleweight",30,"right-handed",4,13,2,19,0.263157895
5,"super welterweight",26,"right-handed",2,0,0,2,1
5,"welterweight",26,"right-handed",4,1,4,9,0.666666667
5,"super bantamweight",21,"right-handed",4,3,0,7,0.571428571
5,"super welterweight",22,"right-handed",6,0,0,6,1
5,"lightweight",23,"right-handed",3,1,0,4,0.75
5,"cruiserweight",26,"right-handed",4,0,0,4,1
5,"super welterweight",NA,"right-handed",16,9,2,27,0.62962963
5,"cruiserweight",22,"right-handed",3,4,1,8,0.4375
5,"lightweight",23,"right-handed",3,6,1,10,0.35
5,"super welterweight",34,"right-handed",18,36,1,55,0.336363636
5,"super welterweight",41,"right-handed",19,12,0,31,0.612903226
5,"super flyweight",23,"right-handed",11,1,0,12,0.916666667
5,"heavyweight",35,"right-handed",4,1,0,5,0.8
5,"light flyweight",26,"right-handed",3,29,2,34,0.117647059
5,"welterweight",31,"right-handed",4,10,0,14,0.285714286
5,"light heavyweight",31,"right-handed",4,12,2,18,0.277777778
5,"cruiserweight",29,"right-handed",3,0,1,4,0.875
5,"featherweight",20,"right-handed",3,0,1,4,0.875
5,"cruiserweight",24,"right-handed",8,1,0,9,0.888888889
5,"light flyweight",26,"right-handed",4,1,0,5,0.8
5,"featherweight",28,"right-handed",5,1,1,7,0.785714286
5,"cruiserweight",42,"right-handed",44,15,0,59,0.745762712
5,"middleweight",32,"right-handed",13,18,1,32,0.421875
5,"bantamweight",NA,"right-handed",2,0,0,2,1
5,"super featherweight",32,"right-handed",6,9,0,15,0.4
5,"light heavyweight",NA,"right-handed",8,14,0,22,0.363636364
5,"super featherweight",34,"right-handed",5,5,0,10,0.5
5,"super bantamweight",23,"right-handed",2,0,1,3,0.833333333
5,"flyweight",21,"right-handed",3,2,2,7,0.571428571
5,"super welterweight",28,"right-handed",6,2,1,9,0.722222222
5,"super lightweight",22,"right-handed",5,0,0,5,1
5,"super middleweight",33,"right-handed",9,2,0,11,0.818181818
5,"middleweight",NA,"right-handed",2,0,0,2,1
5,"super welterweight",32,"right-handed",17,25,3,45,0.411111111
5,"featherweight",29,"right-handed",2,0,0,2,1
5,"light flyweight",21,"right-handed",4,6,3,13,0.423076923
5,"cruiserweight",21,"right-handed",4,2,0,6,0.666666667
5,"featherweight",22,"right-handed",2,0,0,2,1
5,"welterweight",18,"right-handed",2,0,0,2,1
5,"cruiserweight",24,"right-handed",2,0,0,2,1
5,"featherweight",25,"right-handed",7,6,2,15,0.533333333
5,"super featherweight",26,"right-handed",14,11,2,27,0.555555556
5,"featherweight",24,"right-handed",3,2,0,5,0.6
5,"super bantamweight",19,"right-handed",2,1,1,4,0.625
5,"welterweight",21,"right-handed",3,0,0,3,1
5,"middleweight",27,"right-handed",3,0,0,3,1
5,"super welterweight",24,"right-handed",5,3,1,9,0.611111111
5,"featherweight",25,"right-handed",24,18,4,46,0.565217391
5,"welterweight",30,"right-handed",4,1,0,5,0.8
5,"middleweight",35,"right-handed",36,14,0,50,0.72
5,"super featherweight",27,"right-handed",15,10,1,26,0.596153846
5,"super bantamweight",29,"right-handed",15,14,1,30,0.516666667
5,"super welterweight",25,"right-handed",2,0,0,2,1
5,"super middleweight",33,"right-handed",8,4,4,16,0.625
5,"lightweight",32,"right-handed",17,14,3,34,0.544117647
5,"heavyweight",33,"right-handed",21,10,0,31,0.677419355
5,"super middleweight",26,"right-handed",4,4,1,9,0.5
5,"super welterweight",30,"right-handed",12,8,1,21,0.595238095
5,"lightweight",26,"right-handed",3,1,0,4,0.75
5,"super lightweight",31,"right-handed",8,5,1,14,0.607142857
5,"featherweight",29,"right-handed",2,0,0,2,1
5,"heavyweight",39,"right-handed",15,5,0,20,0.75
5,"cruiserweight",29,"right-handed",3,0,0,3,1
5,"flyweight",27,"right-handed",6,3,2,11,0.636363636
5,"lightweight",19,"right-handed",3,0,0,3,1
5,"welterweight",35,"right-handed",6,2,0,8,0.75
5,"welterweight",30,"right-handed",2,1,0,3,0.666666667
5,"super welterweight",41,"right-handed",14,9,1,24,0.604166667
5,"heavyweight",41,"right-handed",26,22,3,51,0.539215686
5,"super featherweight",23,"right-handed",6,9,0,15,0.4
5,"super lightweight",NA,"right-handed",1,0,0,1,1
5,"middleweight",20,"right-handed",2,2,2,6,0.5
5,"welterweight",27,"right-handed",12,44,2,58,0.224137931
5,"super middleweight",32,"right-handed",26,30,4,60,0.466666667
5,"middleweight",25,"right-handed",3,0,0,3,1
5,"super welterweight",28,"right-handed",4,2,0,6,0.666666667
5,"lightweight",24,"right-handed",3,0,0,3,1
5,"middleweight",30,"right-handed",1,0,0,1,1
5,"welterweight",23,"right-handed",1,3,0,4,0.25
5,"super bantamweight",28,"right-handed",16,11,2,29,0.586206897
5,"light heavyweight",41,"right-handed",13,14,4,31,0.483870968
5,"featherweight",20,"right-handed",3,0,0,3,1
5,"heavyweight",34,"right-handed",5,1,0,6,0.833333333
5,"heavyweight",25,"right-handed",4,0,0,4,1
5,"welterweight",34,"right-handed",17,11,4,32,0.59375
5,"super middleweight",42,"right-handed",23,16,0,39,0.58974359
5,"welterweight",20,"right-handed",2,1,2,5,0.6
5,"heavyweight",33,"right-handed",7,5,0,12,0.583333333
5,"super middleweight",22,"right-handed",4,1,0,5,0.8
5,"lightweight",36,"right-handed",9,10,0,19,0.473684211
5,"super welterweight",28,"right-handed",4,0,0,4,1
5,"cruiserweight",39,"right-handed",7,16,0,23,0.304347826
5,"super featherweight",21,"right-handed",4,0,1,5,0.9
5,"super bantamweight",20,"right-handed",11,3,0,14,0.785714286
5,"super bantamweight",25,"right-handed",1,19,1,21,0.071428571
5,"middleweight",30,"right-handed",6,5,0,11,0.545454545
5,"welterweight",23,"right-handed",3,0,0,3,1
5,"super bantamweight",30,"right-handed",3,9,0,12,0.25
5,"super featherweight",23,"right-handed",4,3,0,7,0.571428571
5,"heavyweight",32,"right-handed",3,0,0,3,1
5,"super middleweight",25,"right-handed",3,0,0,3,1
5,"welterweight",26,"right-handed",2,1,1,4,0.625
5,"super lightweight",18,"right-handed",3,0,0,3,1
5,"bantamweight",32,"right-handed",19,15,2,36,0.555555556
5,"super flyweight",22,"right-handed",5,3,0,8,0.625
5,"super flyweight",32,"right-handed",14,8,6,28,0.607142857
5,"super welterweight",29,"right-handed",4,1,2,7,0.714285714
5,"featherweight",26,"right-handed",9,7,6,22,0.545454545
5,"super welterweight",38,"right-handed",26,12,2,40,0.675
5,"super welterweight",22,"right-handed",4,2,3,9,0.611111111
5,"light heavyweight",34,"right-handed",7,12,1,20,0.375
5,"middleweight",30,"right-handed",3,1,0,4,0.75
5,"middleweight",36,"right-handed",32,37,1,70,0.464285714
5,"welterweight",28,"right-handed",9,4,0,13,0.692307692
5,"cruiserweight",43,"right-handed",33,9,1,43,0.779069767
5,"cruiserweight",29,"right-handed",1,0,0,1,1
5,"super middleweight",24,"right-handed",7,0,0,7,1
5,"light heavyweight",21,"right-handed",3,0,1,4,0.875
5,"super lightweight",22,"right-handed",2,0,0,2,1
5,"super lightweight",28,"right-handed",3,1,0,4,0.75
5,"super welterweight",24,"right-handed",2,0,0,2,1
5,"super featherweight",32,"right-handed",5,7,1,13,0.423076923
5,"super featherweight",31,"right-handed",7,13,0,20,0.35
5,"super bantamweight",32,"right-handed",2,2,0,4,0.5
5,"bantamweight",21,"right-handed",4,3,1,8,0.5625
5,"cruiserweight",27,"right-handed",2,0,0,2,1
5,"super featherweight",40,"right-handed",2,9,1,12,0.208333333
5,"super middleweight",27,"right-handed",13,5,0,18,0.722222222
5,"middleweight",36,"right-handed",3,9,3,15,0.3
5,"middleweight",30,"right-handed",5,2,0,7,0.714285714
5,"middleweight",NA,"right-handed",3,4,1,8,0.4375
5,"lightweight",26,"right-handed",2,0,1,3,0.833333333
5,"lightweight",27,"right-handed",4,6,0,10,0.4
5,"super lightweight",34,"right-handed",7,14,1,22,0.340909091
5,"welterweight",29,"right-handed",11,7,0,18,0.611111111
5,"heavyweight",39,"right-handed",6,4,0,10,0.6
5,"flyweight",18,"right-handed",4,1,1,6,0.75
5,"featherweight",23,"right-handed",2,0,0,2,1
5,"lightweight",29,"right-handed",8,9,1,18,0.472222222
5,"super bantamweight",22,"right-handed",6,8,0,14,0.428571429
5,"super featherweight",21,"right-handed",8,1,1,10,0.85
5,"lightweight",27,"right-handed",9,15,0,24,0.375
5,"lightweight",25,"right-handed",3,1,0,4,0.75
5,"featherweight",27,"right-handed",6,8,1,15,0.433333333
5,"lightweight",26,"right-handed",2,0,0,2,1
5,"lightweight",26,"right-handed",2,0,0,2,1
5,"lightweight",22,"right-handed",2,0,0,2,1
5,"super featherweight",37,"right-handed",12,1,0,13,0.923076923
5,"super middleweight",32,"right-handed",22,9,0,31,0.709677419
5,"super featherweight",22,"right-handed",3,1,0,4,0.75
5,"flyweight",21,"right-handed",4,1,1,6,0.75
5,"super welterweight",NA,"right-handed",1,0,0,1,1
5,"welterweight",28,"right-handed",8,7,1,16,0.53125
5,"super welterweight",32,"right-handed",5,3,0,8,0.625
5,"super featherweight",23,"right-handed",2,4,0,6,0.333333333
5,"super featherweight",30,"right-handed",11,22,2,35,0.342857143
5,"lightweight",28,"right-handed",2,0,0,2,1
5,"lightweight",23,"right-handed",2,0,0,2,1
5,"bantamweight",22,"right-handed",2,0,0,2,1
5,"light heavyweight",34,"right-handed",15,12,0,27,0.555555556
5,"lightweight",27,"right-handed",6,7,0,13,0.461538462
5,"lightweight",29,"right-handed",41,49,1,91,0.456043956
5,"super welterweight",24,"right-handed",6,0,0,6,1
5,"featherweight",22,"right-handed",4,4,0,8,0.5
5,"cruiserweight",33,"right-handed",4,9,0,13,0.307692308
5,"lightweight",22,"right-handed",3,0,0,3,1
5,"light flyweight",25,"right-handed",9,18,2,29,0.344827586
5,"welterweight",30,"right-handed",9,20,2,31,0.322580645
5,"super welterweight",36,"right-handed",18,7,0,25,0.72
5,"super bantamweight",22,"right-handed",2,0,0,2,1
5,"super middleweight",37,"right-handed",45,13,1,59,0.771186441
5,"welterweight",30,"right-handed",4,1,0,5,0.8
5,"super lightweight",30,"right-handed",6,1,1,8,0.8125
5,"middleweight",23,"right-handed",3,0,2,5,0.8
5,"lightweight",30,"right-handed",2,1,1,4,0.625
5,"middleweight",26,"right-handed",6,8,1,15,0.433333333
5,"super lightweight",26,"right-handed",3,0,0,3,1
5,"welterweight",NA,"right-handed",2,1,0,3,0.666666667
5,"middleweight",20,"right-handed",6,0,0,6,1
5,"super featherweight",29,"right-handed",2,3,0,5,0.4
5,"featherweight",30,"right-handed",10,11,1,22,0.477272727
5,"super middleweight",27,"right-handed",3,1,0,4,0.75
5,"super bantamweight",23,"right-handed",12,3,0,15,0.8
5,"featherweight",NA,"right-handed",1,0,0,1,1
5,"welterweight",24,"right-handed",5,1,1,7,0.785714286
5,"super lightweight",37,"right-handed",24,38,4,66,0.393939394
5,"super flyweight",32,"right-handed",3,5,0,8,0.375
5,"minimumweight",21,"right-handed",4,4,0,8,0.5
5,"super welterweight",22,"right-handed",1,0,0,1,1
5,"heavyweight",25,"right-handed",5,2,2,9,0.666666667
5,"super featherweight",30,"right-handed",8,15,0,23,0.347826087
5,"welterweight",NA,"right-handed",2,0,0,2,1
5,"super welterweight",38,"right-handed",6,10,2,18,0.388888889
5,"super featherweight",32,"right-handed",5,4,2,11,0.545454545
5,"super welterweight",29,"right-handed",8,2,0,10,0.8
5,"super middleweight",43,"right-handed",12,4,1,17,0.735294118
5,"lightweight",29,"right-handed",29,11,1,41,0.719512195
5,"cruiserweight",29,"right-handed",8,6,1,15,0.566666667
5,"light heavyweight",31,"right-handed",13,6,0,19,0.684210526
5,"cruiserweight",40,"right-handed",3,7,0,10,0.3
5,"flyweight",24,"right-handed",9,12,0,21,0.428571429
5,"super bantamweight",27,"right-handed",3,4,0,7,0.428571429
5,"featherweight",22,"right-handed",2,0,0,2,1
5,"super lightweight",33,"right-handed",17,9,1,27,0.648148148
5,"heavyweight",24,"right-handed",4,0,0,4,1
5,"flyweight",28,"right-handed",4,5,0,9,0.444444444
5,"super featherweight",33,"right-handed",4,0,1,5,0.9
5,"light flyweight",21,"right-handed",5,5,0,10,0.5
5,"super featherweight",28,"right-handed",8,6,0,14,0.571428571
5,"cruiserweight",41,"right-handed",13,32,0,45,0.288888889
5,"super middleweight",31,"right-handed",7,11,0,18,0.388888889
5,"featherweight",35,"right-handed",2,1,2,5,0.6
5,"super featherweight",28,"right-handed",11,9,0,20,0.55
5,"super middleweight",28,"right-handed",12,3,0,15,0.8
5,"super lightweight",32,"right-handed",7,16,1,24,0.3125
5,"super featherweight",31,"right-handed",30,17,3,50,0.63
5,"lightweight",30,"right-handed",4,2,2,8,0.625
5,"featherweight",NA,"right-handed",5,13,1,19,0.289473684
5,"cruiserweight",32,"right-handed",5,2,0,7,0.714285714
5,"super featherweight",37,"right-handed",5,15,5,25,0.3
5,"featherweight",18,"right-handed",2,0,0,2,1
5,"super flyweight",20,"right-handed",4,3,0,7,0.571428571
5,"featherweight",30,"right-handed",1,0,0,1,1
5,"welterweight",21,"right-handed",2,0,0,2,1
5,"super middleweight",36,"right-handed",9,9,0,18,0.5
5,"super flyweight",20,"right-handed",6,5,0,11,0.545454545
5,"bantamweight",21,"right-handed",2,1,1,4,0.625
5,"featherweight",23,"right-handed",2,1,0,3,0.666666667
5,"super flyweight",23,"right-handed",8,9,0,17,0.470588235
5,"middleweight",40,"right-handed",20,21,0,41,0.487804878
5,"lightweight",33,"right-handed",5,7,2,14,0.428571429
5,"featherweight",19,"right-handed",2,0,0,2,1
5,"super middleweight",32,"right-handed",19,18,3,40,0.5125
5,"bantamweight",27,"right-handed",5,14,0,19,0.263157895
5,"lightweight",43,"right-handed",29,10,1,40,0.7375
5,"heavyweight",41,"right-handed",5,7,0,12,0.416666667
5,"featherweight",22,"right-handed",7,2,0,9,0.777777778
5,"middleweight",30,"right-handed",2,0,0,2,1
5,"super welterweight",25,"right-handed",6,3,1,10,0.65
5,"featherweight",33,"right-handed",12,6,0,18,0.666666667
5,"featherweight",18,"right-handed",2,0,1,3,0.833333333
5,"super welterweight",NA,"right-handed",3,0,0,3,1
5,"light heavyweight",24,"right-handed",2,0,0,2,1
5,"bantamweight",24,"right-handed",2,0,0,2,1
5,"super middleweight",26,"right-handed",2,0,0,2,1
5,"welterweight",24,"right-handed",2,0,0,2,1
5,"lightweight",24,"right-handed",2,0,0,2,1
5,"super welterweight",21,"right-handed",2,0,0,2,1
5,"heavyweight",26,"right-handed",2,0,0,2,1
5,"super middleweight",39,"right-handed",16,17,2,35,0.485714286
5,"lightweight",28,"right-handed",5,4,2,11,0.545454545
5,"heavyweight",19,"right-handed",3,1,1,5,0.7
5,"super bantamweight",37,"right-handed",12,9,1,22,0.568181818
5,"welterweight",30,"right-handed",3,10,1,14,0.25
5,"welterweight",23,"right-handed",2,0,0,2,1
5,"super flyweight",36,"right-handed",8,14,0,22,0.363636364
5,"middleweight",NA,"right-handed",4,1,0,5,0.8
5,"super middleweight",27,"right-handed",11,8,0,19,0.578947368
5,"welterweight",33,"right-handed",18,25,0,43,0.418604651
5,"middleweight",29,"right-handed",4,3,1,8,0.5625
5,"welterweight",26,"right-handed",3,0,1,4,0.875
5,"super featherweight",32,"right-handed",3,0,0,3,1
5,"welterweight",29,"right-handed",8,3,0,11,0.727272727
5,"super featherweight",31,"right-handed",6,6,0,12,0.5
5,"lightweight",27,"right-handed",7,4,1,12,0.625
5,"heavyweight",27,"right-handed",2,0,0,2,1
5,"flyweight",24,"right-handed",5,7,1,13,0.423076923
5,"bantamweight",19,"right-handed",1,0,0,1,1
5,"heavyweight",30,"right-handed",7,3,0,10,0.7
5,"bantamweight",29,"right-handed",16,14,2,32,0.53125
5,"middleweight",37,"right-handed",5,4,0,9,0.555555556
5,"super bantamweight",21,"right-handed",2,1,0,3,0.666666667
5,"minimumweight",28,"right-handed",10,30,2,42,0.261904762
5,"super welterweight",24,"right-handed",3,2,1,6,0.583333333
5,"middleweight",33,"right-handed",6,10,0,16,0.375
5,"light heavyweight",19,"right-handed",3,1,0,4,0.75
5,"super flyweight",19,"right-handed",3,0,0,3,1
5,"super lightweight",22,"right-handed",1,2,0,3,0.333333333
5,"super welterweight",NA,"right-handed",1,0,0,1,1
5,"super bantamweight",25,"right-handed",3,1,1,5,0.7
5,"cruiserweight",27,"right-handed",4,3,0,7,0.571428571
5,"bantamweight",34,"right-handed",14,6,1,21,0.69047619
5,"lightweight",28,"right-handed",3,0,0,3,1
5,"light flyweight",23,"right-handed",1,0,1,2,0.75
5,"lightweight",38,"right-handed",8,27,2,37,0.243243243
5,"minimumweight",NA,"right-handed",1,0,0,1,1
5,"lightweight",24,"right-handed",7,2,3,12,0.708333333
5,"super featherweight",26,"right-handed",6,5,1,12,0.541666667
5,"welterweight",NA,"right-handed",1,0,0,1,1
5,"super middleweight",28,"right-handed",3,7,1,11,0.318181818
5,"heavyweight",39,"right-handed",9,7,2,18,0.555555556
5,"lightweight",24,"right-handed",3,2,1,6,0.583333333
5,"super middleweight",NA,"right-handed",5,4,2,11,0.545454545
5,"flyweight",27,"right-handed",3,1,0,4,0.75
5,"super bantamweight",18,"right-handed",3,0,0,3,1
5,"middleweight",32,"right-handed",3,2,1,6,0.583333333
5,"super welterweight",24,"right-handed",9,18,1,28,0.339285714
5,"super middleweight",37,"right-handed",3,2,2,7,0.571428571
5,"heavyweight",34,"right-handed",16,11,1,28,0.589285714
5,"heavyweight",38,"right-handed",3,1,1,5,0.7
5,"heavyweight",28,"right-handed",5,1,0,6,0.833333333
5,"super bantamweight",20,"right-handed",2,1,0,3,0.666666667
5,"super lightweight",36,"right-handed",4,3,2,9,0.555555556
5,"welterweight",27,"right-handed",11,7,2,20,0.6
5,"super welterweight",19,"right-handed",3,3,0,6,0.5
5,"super lightweight",19,"right-handed",5,0,0,5,1
5,"bantamweight",23,"right-handed",2,2,2,6,0.5
5,"super lightweight",27,"right-handed",2,0,0,2,1
5,"super lightweight",36,"right-handed",14,16,2,32,0.46875
5,"featherweight",37,"right-handed",7,10,0,17,0.411764706
5,"super flyweight",24,"right-handed",2,5,0,7,0.285714286
5,"light heavyweight",24,"right-handed",3,0,0,3,1
5,"featherweight",30,"right-handed",7,5,3,15,0.566666667
5,"cruiserweight",23,"right-handed",4,2,0,6,0.666666667
5,"lightweight",NA,"right-handed",4,1,0,5,0.8
5,"welterweight",26,"right-handed",4,3,1,8,0.5625
5,"super lightweight",NA,"right-handed",2,1,0,3,0.666666667
5,"lightweight",21,"right-handed",4,3,0,7,0.571428571
5,"middleweight",NA,"right-handed",1,0,0,1,1
5,"middleweight",32,"right-handed",5,2,1,8,0.6875
5,"welterweight",28,"right-handed",11,19,2,32,0.375
5,"cruiserweight",29,"right-handed",11,3,0,14,0.785714286
5,"super lightweight",NA,"right-handed",2,1,1,4,0.625
5,"flyweight",24,"right-handed",2,2,0,4,0.5
5,"flyweight",29,"right-handed",5,4,2,11,0.545454545
5,"featherweight",23,"right-handed",4,3,0,7,0.571428571
5,"super middleweight",25,"right-handed",3,4,1,8,0.4375
5,"super welterweight",23,"right-handed",6,6,0,12,0.5
5,"super middleweight",29,"right-handed",3,7,2,12,0.333333333
5,"middleweight",28,"right-handed",16,6,0,22,0.727272727
5,"middleweight",29,"right-handed",3,0,0,3,1
5,"welterweight",30,"right-handed",18,18,1,37,0.5
5,"flyweight",NA,"right-handed",3,1,0,4,0.75
5,"heavyweight",28,"right-handed",2,1,2,5,0.6
5,"lightweight",NA,"right-handed",5,3,0,8,0.625
5,"super middleweight",32,"right-handed",18,34,7,59,0.36440678
5,"super lightweight",31,"right-handed",7,6,0,13,0.538461538
5,"bantamweight",34,"right-handed",21,48,7,76,0.322368421
5,"heavyweight",35,"right-handed",5,3,0,8,0.625
5,"super middleweight",25,"right-handed",3,1,0,4,0.75
5,"featherweight",25,"right-handed",7,9,1,17,0.441176471
5,"cruiserweight",20,"right-handed",1,0,0,1,1
5,"light flyweight",25,"right-handed",3,5,1,9,0.388888889
5,"featherweight",28,"right-handed",6,25,2,33,0.212121212
5,"welterweight",32,"right-handed",5,9,1,15,0.366666667
5,"super bantamweight",18,"right-handed",2,1,0,3,0.666666667
5,"super featherweight",23,"right-handed",3,2,3,8,0.5625
5,"super welterweight",33,"right-handed",7,12,2,21,0.380952381
5,"super middleweight",35,"right-handed",8,7,0,15,0.533333333
5,"middleweight",32,"right-handed",7,16,3,26,0.326923077
5,"bantamweight",21,"right-handed",4,0,1,5,0.9
5,"welterweight",37,"right-handed",43,10,0,53,0.811320755
5,"super bantamweight",26,"right-handed",6,1,0,7,0.857142857
5,"welterweight",23,"right-handed",4,0,1,5,0.9
5,"featherweight",37,"right-handed",22,12,0,34,0.647058824
5,"heavyweight",25,"right-handed",17,27,0,44,0.386363636
5,"super lightweight",26,"right-handed",3,1,0,4,0.75
5,"lightweight",26,"right-handed",5,10,0,15,0.333333333
5,"welterweight",36,"right-handed",18,9,2,29,0.655172414
5,"middleweight",32,"right-handed",6,0,0,6,1
5,"super bantamweight",28,"right-handed",4,6,2,12,0.416666667
5,"super welterweight",28,"right-handed",5,12,5,22,0.340909091
5,"lightweight",28,"right-handed",10,4,1,15,0.7
5,"super lightweight",45,"right-handed",12,13,2,27,0.481481481
5,"heavyweight",48,"right-handed",6,0,0,6,1
5,"flyweight",29,"right-handed",21,45,2,68,0.323529412
4,"welterweight",30,"right-handed",32,14,0,46,0.695652174
4,"welterweight",42,"right-handed",8,33,4,45,0.222222222
4,"super featherweight",29,"right-handed",18,9,2,29,0.655172414
4,"super bantamweight",20,"right-handed",3,1,0,4,0.75
4,"lightweight",25,"right-handed",8,3,0,11,0.727272727
4,"super middleweight",39,"right-handed",4,6,1,11,0.409090909
4,"super welterweight",33,"right-handed",3,12,6,21,0.285714286
4,"super welterweight",33,"right-handed",7,1,0,8,0.875
4,"light heavyweight",25,"right-handed",2,1,0,3,0.666666667
4,"lightweight",27,"right-handed",6,7,0,13,0.461538462
4,"super flyweight",35,"right-handed",15,21,3,39,0.423076923
4,"welterweight",28,"right-handed",2,3,0,5,0.4
4,"heavyweight",26,"right-handed",2,0,0,2,1
4,"super middleweight",34,"right-handed",5,5,0,10,0.5
4,"cruiserweight",27,"right-handed",5,7,1,13,0.423076923
4,"super welterweight",33,"right-handed",20,27,3,50,0.43
4,"super welterweight",26,"right-handed",13,13,1,27,0.5
4,"welterweight",29,"right-handed",10,9,1,20,0.525
4,"lightweight",30,"right-handed",4,0,1,5,0.9
4,"super featherweight",26,"right-handed",3,3,0,6,0.5
4,"featherweight",30,"right-handed",6,3,0,9,0.666666667
4,"welterweight",32,"right-handed",7,3,0,10,0.7
4,"super welterweight",20,"right-handed",2,0,0,2,1
4,"lightweight",36,"right-handed",14,13,0,27,0.518518519
4,"middleweight",23,"right-handed",2,1,1,4,0.625
4,"super welterweight",35,"right-handed",5,4,0,9,0.555555556
4,"light heavyweight",30,"right-handed",11,8,2,21,0.571428571
4,"super lightweight",34,"right-handed",7,7,2,16,0.5
4,"light heavyweight",NA,"right-handed",5,1,0,6,0.833333333
4,"super flyweight",23,"right-handed",5,4,2,11,0.545454545
4,"lightweight",25,"right-handed",1,1,0,2,0.5
4,"super welterweight",38,"right-handed",2,6,0,8,0.25
4,"lightweight",31,"right-handed",14,22,0,36,0.388888889
4,"middleweight",22,"right-handed",5,5,0,10,0.5
4,"heavyweight",44,"right-handed",2,8,0,10,0.2
4,"welterweight",26,"right-handed",23,27,3,53,0.462264151
4,"super featherweight",19,"right-handed",3,1,0,4,0.75
4,"bantamweight",25,"right-handed",5,9,1,15,0.366666667
4,"welterweight",31,"right-handed",3,1,0,4,0.75
4,"middleweight",22,"right-handed",8,8,0,16,0.5
4,"super flyweight",19,"right-handed",4,1,2,7,0.714285714
4,"cruiserweight",27,"right-handed",1,0,0,1,1
4,"super bantamweight",21,"right-handed",5,3,2,10,0.6
4,"cruiserweight",NA,"right-handed",4,0,0,4,1
4,"middleweight",29,"right-handed",4,18,1,23,0.195652174
4,"super welterweight",35,"right-handed",15,38,3,56,0.294642857
4,"super lightweight",20,"right-handed",1,0,0,1,1
4,"super featherweight",37,"right-handed",9,15,1,25,0.38
4,"light flyweight",26,"right-handed",8,5,0,13,0.615384615
4,"heavyweight",39,"right-handed",11,23,0,34,0.323529412
4,"super welterweight",29,"right-handed",1,1,0,2,0.5
4,"super middleweight",24,"right-handed",23,25,1,49,0.479591837
4,"welterweight",22,"right-handed",1,1,0,2,0.5
4,"super welterweight",34,"right-handed",4,6,2,12,0.416666667
4,"heavyweight",36,"right-handed",5,1,2,8,0.75
4,"welterweight",24,"right-handed",3,1,0,4,0.75
4,"middleweight",24,"right-handed",9,31,6,46,0.260869565
4,"super lightweight",22,"right-handed",2,0,0,2,1
4,"super welterweight",30,"right-handed",7,14,4,25,0.36
4,"super featherweight",27,"right-handed",4,3,0,7,0.571428571
4,"super welterweight",25,"right-handed",6,0,0,6,1
4,"super featherweight",19,"right-handed",3,1,0,4,0.75
4,"super middleweight",32,"right-handed",3,1,1,5,0.7
4,"super bantamweight",32,"right-handed",8,4,0,12,0.666666667
4,"super lightweight",27,"right-handed",7,1,2,10,0.8
4,"welterweight",26,"right-handed",6,2,0,8,0.75
4,"featherweight",19,"right-handed",2,2,1,5,0.5
4,"bantamweight",23,"right-handed",3,7,1,11,0.318181818
4,"bantamweight",24,"right-handed",4,10,0,14,0.285714286
4,"super flyweight",NA,"right-handed",1,0,0,1,1
4,"bantamweight",30,"right-handed",3,1,0,4,0.75
4,"super flyweight",25,"right-handed",2,3,0,5,0.4
4,"bantamweight",27,"right-handed",1,0,0,1,1
4,"lightweight",19,"right-handed",1,0,0,1,1
4,"super lightweight",29,"right-handed",7,3,1,11,0.681818182
4,"middleweight",24,"right-handed",6,3,0,9,0.666666667
4,"super welterweight",27,"right-handed",6,4,0,10,0.6
4,"flyweight",34,"right-handed",5,13,3,21,0.30952381
4,"super middleweight",20,"right-handed",5,0,0,5,1
4,"lightweight",35,"right-handed",10,15,1,26,0.403846154
4,"light heavyweight",25,"right-handed",2,2,0,4,0.5
4,"cruiserweight",31,"right-handed",3,1,1,5,0.7
4,"lightweight",26,"right-handed",1,0,0,1,1
4,"super welterweight",33,"right-handed",5,12,1,18,0.305555556
4,"middleweight",50,"right-handed",9,9,1,19,0.5
4,"super flyweight",27,"right-handed",3,2,0,5,0.6
4,"super welterweight",NA,"right-handed",10,4,0,14,0.714285714
4,"super featherweight",NA,"right-handed",7,12,0,19,0.368421053
4,"welterweight",30,"right-handed",4,16,1,21,0.214285714
4,"super middleweight",36,"right-handed",7,7,1,15,0.5
4,"super lightweight",30,"right-handed",15,16,3,34,0.485294118
4,"middleweight",24,"right-handed",1,0,0,1,1
4,"super middleweight",25,"right-handed",2,1,0,3,0.666666667
4,"super bantamweight",23,"right-handed",3,4,0,7,0.428571429
4,"super lightweight",22,"right-handed",4,0,0,4,1
4,"cruiserweight",31,"right-handed",4,1,0,5,0.8
4,"middleweight",31,"right-handed",3,2,0,5,0.6
4,"super featherweight",27,"right-handed",5,3,3,11,0.590909091
4,"super featherweight",23,"right-handed",5,5,0,10,0.5
4,"light heavyweight",34,"right-handed",5,0,0,5,1
4,"super lightweight",27,"right-handed",3,1,1,5,0.7
4,"super featherweight",29,"right-handed",4,3,0,7,0.571428571
4,"super flyweight",23,"right-handed",8,7,1,16,0.53125
4,"super middleweight",31,"right-handed",3,8,0,11,0.272727273
4,"super lightweight",32,"right-handed",4,6,2,12,0.416666667
4,"featherweight",23,"right-handed",9,9,0,18,0.5
4,"super welterweight",37,"right-handed",10,7,1,18,0.583333333
4,"super welterweight",30,"right-handed",8,17,4,29,0.344827586
4,"super middleweight",26,"right-handed",3,4,0,7,0.428571429
4,"super flyweight",NA,"right-handed",2,0,0,2,1
4,"light heavyweight",42,"right-handed",19,84,4,107,0.196261682
4,"super middleweight",24,"right-handed",2,0,0,2,1
4,"heavyweight",27,"right-handed",1,10,0,11,0.090909091
4,"super welterweight",25,"right-handed",4,0,0,4,1
4,"featherweight",28,"right-handed",10,13,0,23,0.434782609
4,"middleweight",22,"right-handed",3,3,0,6,0.5
4,"flyweight",18,"right-handed",4,2,1,7,0.642857143
4,"super lightweight",26,"right-handed",5,8,0,13,0.384615385
4,"super welterweight",27,"right-handed",5,3,0,8,0.625
4,"super welterweight",27,"right-handed",5,6,1,12,0.458333333
4,"flyweight",38,"right-handed",8,5,2,15,0.6
4,"lightweight",30,"right-handed",5,2,0,7,0.714285714
4,"super middleweight",42,"right-handed",15,26,4,45,0.377777778
4,"featherweight",20,"right-handed",3,5,0,8,0.375
4,"super welterweight",26,"right-handed",2,0,1,3,0.833333333
4,"super bantamweight",22,"right-handed",1,3,1,5,0.3
4,"featherweight",NA,"right-handed",3,2,0,5,0.6
4,"middleweight",20,"right-handed",3,1,0,4,0.75
4,"super featherweight",31,"right-handed",27,35,3,65,0.438461538
4,"super featherweight",22,"right-handed",3,1,0,4,0.75
4,"welterweight",25,"right-handed",10,11,6,27,0.481481481
4,"super lightweight",24,"right-handed",4,2,0,6,0.666666667
4,"bantamweight",22,"right-handed",2,0,0,2,1
4,"super featherweight",21,"right-handed",4,0,2,6,0.833333333
4,"super welterweight",27,"right-handed",6,18,3,27,0.277777778
4,"super bantamweight",22,"right-handed",2,0,0,2,1
4,"super flyweight",26,"right-handed",4,3,0,7,0.571428571
4,"welterweight",27,"right-handed",6,9,1,16,0.40625
4,"lightweight",32,"right-handed",4,4,1,9,0.5
4,"super featherweight",NA,"right-handed",5,6,1,12,0.458333333
4,"flyweight",30,"right-handed",2,2,1,5,0.5
4,"super bantamweight",20,"right-handed",2,0,1,3,0.833333333
4,"super lightweight",29,"right-handed",7,14,0,21,0.333333333
4,"heavyweight",23,"right-handed",8,15,0,23,0.347826087
4,"super welterweight",26,"right-handed",4,5,2,11,0.454545455
4,"lightweight",21,"right-handed",3,0,0,3,1
4,"bantamweight",34,"right-handed",17,22,4,43,0.441860465
4,"heavyweight",37,"right-handed",21,21,3,45,0.5
4,"super middleweight",30,"right-handed",6,24,0,30,0.2
4,"flyweight",17,"right-handed",1,0,0,1,1
4,"featherweight",40,"right-handed",10,17,0,27,0.37037037
4,"featherweight",25,"right-handed",10,6,0,16,0.625
4,"super featherweight",26,"right-handed",9,7,0,16,0.5625
4,"heavyweight",37,"right-handed",8,7,1,16,0.53125
4,"super bantamweight",26,"right-handed",10,29,1,40,0.2625
4,"featherweight",25,"right-handed",9,3,0,12,0.75
4,"welterweight",23,"right-handed",4,2,0,6,0.666666667
4,"lightweight",41,"right-handed",12,19,1,32,0.390625
4,"super lightweight",29,"right-handed",5,7,1,13,0.423076923
4,"super welterweight",25,"right-handed",4,0,0,4,1
4,"lightweight",25,"right-handed",3,6,0,9,0.333333333
4,"cruiserweight",NA,"right-handed",2,0,0,2,1
4,"featherweight",20,"right-handed",2,0,1,3,0.833333333
4,"middleweight",22,"right-handed",4,3,0,7,0.571428571
4,"super welterweight",29,"right-handed",2,3,1,6,0.416666667
4,"light heavyweight",23,"right-handed",4,3,0,7,0.571428571
4,"welterweight",27,"right-handed",3,5,1,9,0.388888889
4,"featherweight",35,"right-handed",7,7,0,14,0.5
4,"lightweight",28,"right-handed",36,34,2,72,0.513888889
4,"heavyweight",27,"right-handed",3,0,0,3,1
4,"welterweight",23,"right-handed",4,2,0,6,0.666666667
4,"super lightweight",31,"right-handed",11,21,2,34,0.352941176
4,"heavyweight",27,"right-handed",6,3,0,9,0.666666667
4,"middleweight",59,"right-handed",17,7,0,24,0.708333333
4,"bantamweight",NA,"right-handed",2,3,0,5,0.4
4,"middleweight",35,"right-handed",2,1,0,3,0.666666667
4,"super lightweight",28,"right-handed",10,8,0,18,0.555555556
4,"cruiserweight",34,"right-handed",1,5,0,6,0.166666667
4,"heavyweight",24,"right-handed",4,7,0,11,0.363636364
4,"heavyweight",22,"right-handed",4,0,0,4,1
4,"light flyweight",28,"right-handed",6,0,0,6,1
4,"heavyweight",37,"right-handed",15,3,0,18,0.833333333
4,"super lightweight",27,"right-handed",5,10,0,15,0.333333333
4,"super featherweight",28,"right-handed",3,1,0,4,0.75
4,"bantamweight",22,"right-handed",1,0,1,2,0.75
4,"featherweight",18,"right-handed",2,1,0,3,0.666666667
4,"super welterweight",35,"right-handed",3,3,1,7,0.5
4,"featherweight",NA,"right-handed",1,0,0,1,1
4,"welterweight",NA,"right-handed",2,1,1,4,0.625
4,"super welterweight",38,"right-handed",13,6,1,20,0.675
4,"super bantamweight",28,"right-handed",6,10,0,16,0.375
4,"cruiserweight",34,"right-handed",9,3,1,13,0.730769231
4,"super featherweight",21,"right-handed",13,9,1,23,0.586956522
4,"super lightweight",20,"right-handed",2,0,0,2,1
4,"lightweight",24,"right-handed",3,1,0,4,0.75
4,"middleweight",28,"right-handed",12,54,9,75,0.22
4,"super middleweight",29,"right-handed",7,1,1,9,0.833333333
4,"welterweight",41,"right-handed",8,24,0,32,0.25
4,"super bantamweight",22,"right-handed",3,3,0,6,0.5
4,"minimumweight",23,"right-handed",1,0,0,1,1
4,"middleweight",29,"right-handed",4,1,0,5,0.8
4,"welterweight",27,"right-handed",7,3,1,11,0.681818182
4,"flyweight",24,"right-handed",2,3,0,5,0.4
4,"featherweight",22,"right-handed",3,2,0,5,0.6
4,"super welterweight",34,"right-handed",3,3,0,6,0.5
4,"middleweight",27,"right-handed",4,0,0,4,1
4,"lightweight",31,"right-handed",8,6,2,16,0.5625
4,"heavyweight",34,"right-handed",12,8,1,21,0.595238095
4,"lightweight",36,"right-handed",2,0,0,2,1
4,"super welterweight",21,"right-handed",4,0,0,4,1
4,"bantamweight",33,"right-handed",6,6,3,15,0.5
4,"super welterweight",21,"right-handed",1,0,0,1,1
4,"cruiserweight",24,"right-handed",9,11,0,20,0.45
4,"super featherweight",24,"right-handed",2,4,1,7,0.357142857
4,"heavyweight",37,"right-handed",9,14,1,24,0.395833333
4,"flyweight",29,"right-handed",3,3,1,7,0.5
4,"super middleweight",30,"right-handed",20,14,5,39,0.576923077
4,"super welterweight",29,"right-handed",3,2,0,5,0.6
4,"bantamweight",22,"right-handed",2,1,1,4,0.625
4,"bantamweight",27,"right-handed",4,9,0,13,0.307692308
4,"lightweight",30,"right-handed",5,7,0,12,0.416666667
4,"super flyweight",32,"right-handed",4,7,2,13,0.384615385
4,"super welterweight",34,"right-handed",22,22,1,45,0.5
4,"middleweight",27,"right-handed",5,1,1,7,0.785714286
4,"super lightweight",37,"right-handed",14,11,0,25,0.56
4,"middleweight",35,"right-handed",5,0,0,5,1
4,"heavyweight",33,"right-handed",2,4,0,6,0.333333333
4,"super featherweight",26,"right-handed",5,7,0,12,0.416666667
4,"light heavyweight",25,"right-handed",9,7,1,17,0.558823529
4,"super featherweight",21,"right-handed",2,1,0,3,0.666666667
4,"bantamweight",NA,"right-handed",14,12,1,27,0.537037037
4,"super lightweight",19,"right-handed",3,1,0,4,0.75
4,"super welterweight",21,"right-handed",3,3,3,9,0.5
4,"super flyweight",29,"right-handed",17,11,1,29,0.603448276
4,"lightweight",22,"right-handed",4,5,1,10,0.45
4,"super featherweight",24,"right-handed",2,1,1,4,0.625
4,"super featherweight",27,"right-handed",4,3,2,9,0.555555556
4,"super lightweight",37,"right-handed",11,13,1,25,0.46
4,"bantamweight",31,"right-handed",5,12,0,17,0.294117647
4,"flyweight",20,"right-handed",1,0,0,1,1
4,"middleweight",NA,"right-handed",4,5,2,11,0.454545455
4,"welterweight",36,"right-handed",11,10,0,21,0.523809524
4,"bantamweight",35,"right-handed",15,27,8,50,0.38
4,"featherweight",23,"right-handed",2,2,0,4,0.5
4,"light heavyweight",33,"right-handed",7,33,3,43,0.197674419
4,"super middleweight",29,"right-handed",4,6,1,11,0.409090909
4,"featherweight",31,"right-handed",18,19,1,38,0.486842105
4,"super welterweight",24,"right-handed",2,0,0,2,1
4,"lightweight",25,"right-handed",1,1,1,3,0.5
4,"middleweight",27,"right-handed",2,1,0,3,0.666666667
4,"super bantamweight",18,"right-handed",4,0,0,4,1
4,"super featherweight",20,"right-handed",3,0,0,3,1
4,"super featherweight",26,"right-handed",3,2,1,6,0.583333333
4,"light heavyweight",31,"right-handed",1,10,1,12,0.125
4,"super lightweight",NA,"right-handed",2,2,1,5,0.5
4,"super middleweight",24,"right-handed",4,0,0,4,1
4,"lightweight",NA,"right-handed",3,3,1,7,0.5
4,"light heavyweight",26,"right-handed",1,1,0,2,0.5
4,"light heavyweight",44,"right-handed",1,2,1,4,0.375
4,"middleweight",41,"right-handed",12,4,0,16,0.75
4,"super middleweight",27,"right-handed",3,0,0,3,1
4,"welterweight",28,"right-handed",2,1,0,3,0.666666667
4,"super bantamweight",18,"right-handed",3,0,1,4,0.875
4,"middleweight",28,"right-handed",4,0,0,4,1
4,"light flyweight",25,"right-handed",2,4,2,8,0.375
4,"welterweight",NA,"right-handed",5,5,0,10,0.5
4,"super bantamweight",28,"right-handed",6,6,3,15,0.5
4,"bantamweight",28,"right-handed",5,4,1,10,0.55
4,"featherweight",21,"right-handed",3,1,1,5,0.7
4,"super featherweight",22,"right-handed",5,1,0,6,0.833333333
4,"bantamweight",20,"right-handed",5,1,0,6,0.833333333
4,"lightweight",21,"right-handed",1,0,0,1,1
4,"super welterweight",30,"right-handed",2,2,0,4,0.5
4,"super featherweight",27,"right-handed",3,0,1,4,0.875
4,"lightweight",20,"right-handed",2,0,0,2,1
4,"super welterweight",28,"right-handed",1,0,0,1,1
4,"super lightweight",34,"right-handed",13,11,2,26,0.538461538
4,"lightweight",28,"right-handed",3,0,0,3,1
4,"lightweight",34,"right-handed",14,12,0,26,0.538461538
4,"lightweight",23,"right-handed",2,0,0,2,1
4,"light heavyweight",29,"right-handed",2,2,2,6,0.5
4,"super bantamweight",NA,"right-handed",1,0,0,1,1
4,"super featherweight",22,"right-handed",2,2,0,4,0.5
4,"super bantamweight",27,"right-handed",2,1,0,3,0.666666667
4,"super welterweight",23,"right-handed",6,1,0,7,0.857142857
4,"super flyweight",22,"right-handed",2,0,0,2,1
4,"super middleweight",35,"right-handed",10,5,0,15,0.666666667
4,"super featherweight",29,"right-handed",7,18,3,28,0.303571429
4,"heavyweight",NA,"right-handed",4,6,0,10,0.4
4,"minimumweight",33,"right-handed",2,1,0,3,0.666666667
4,"super middleweight",29,"right-handed",25,40,6,71,0.394366197
4,"light heavyweight",35,"right-handed",21,18,0,39,0.538461538
4,"light heavyweight",38,"right-handed",16,7,0,23,0.695652174
4,"super lightweight",31,"right-handed",2,5,0,7,0.285714286
4,"super featherweight",31,"right-handed",5,8,1,14,0.392857143
4,"super middleweight",32,"right-handed",2,0,0,2,1
4,"super lightweight",20,"right-handed",3,0,0,3,1
4,"super bantamweight",25,"right-handed",3,0,0,3,1
4,"bantamweight",22,"right-handed",5,3,0,8,0.625
4,"welterweight",28,"right-handed",7,8,0,15,0.466666667
4,"light heavyweight",32,"right-handed",7,9,0,16,0.4375
4,"super welterweight",22,"right-handed",2,1,0,3,0.666666667
4,"bantamweight",26,"right-handed",4,6,0,10,0.4
4,"bantamweight",21,"right-handed",2,1,1,4,0.625
4,"super flyweight",35,"right-handed",13,8,3,24,0.604166667
4,"super middleweight",21,"right-handed",2,0,0,2,1
4,"super featherweight",33,"right-handed",3,4,2,9,0.444444444
4,"lightweight",24,"right-handed",1,2,0,3,0.333333333
4,"lightweight",33,"right-handed",9,17,2,28,0.357142857
4,"super lightweight",21,"right-handed",4,1,0,5,0.8
4,"lightweight",34,"right-handed",2,0,0,2,1
4,"cruiserweight",34,"right-handed",4,0,0,4,1
4,"super lightweight",37,"right-handed",9,12,1,22,0.431818182
4,"super middleweight",21,"right-handed",16,17,0,33,0.484848485
4,"middleweight",52,"right-handed",10,14,2,26,0.423076923
4,"light flyweight",29,"right-handed",13,13,0,26,0.5
4,"super featherweight",28,"right-handed",5,10,2,17,0.352941176
4,"minimumweight",23,"right-handed",3,3,1,7,0.5
4,"super lightweight",24,"right-handed",6,2,0,8,0.75
4,"lightweight",34,"right-handed",1,1,0,2,0.5
4,"welterweight",30,"right-handed",3,4,1,8,0.4375
4,"welterweight",28,"right-handed",4,0,0,4,1
4,"welterweight",30,"right-handed",5,25,1,31,0.177419355
4,"featherweight",25,"right-handed",5,6,0,11,0.454545455
4,"super lightweight",31,"right-handed",8,8,0,16,0.5
4,"super bantamweight",34,"right-handed",14,10,1,25,0.58
4,"middleweight",26,"right-handed",2,0,0,2,1
4,"middleweight",NA,"right-handed",5,8,0,13,0.384615385
4,"super lightweight",21,"right-handed",2,2,0,4,0.5
4,"super lightweight",22,"right-handed",2,1,0,3,0.666666667
4,"super featherweight",22,"right-handed",3,0,0,3,1
4,"bantamweight",26,"right-handed",4,5,2,11,0.454545455
4,"super middleweight",24,"right-handed",6,10,1,17,0.382352941
4,"heavyweight",28,"right-handed",3,2,1,6,0.583333333
4,"light flyweight",31,"right-handed",7,15,1,23,0.326086957
4,"super bantamweight",31,"right-handed",26,12,1,39,0.679487179
4,"super welterweight",30,"right-handed",2,1,0,3,0.666666667
4,"light heavyweight",31,"right-handed",4,3,1,8,0.5625
4,"cruiserweight",25,"right-handed",6,8,3,17,0.441176471
4,"lightweight",28,"right-handed",6,13,1,20,0.325
4,"super welterweight",31,"right-handed",7,4,1,12,0.625
4,"featherweight",26,"right-handed",3,3,0,6,0.5
4,"cruiserweight",25,"right-handed",3,12,0,15,0.2
4,"super featherweight",33,"right-handed",3,2,0,5,0.6
4,"super bantamweight",30,"right-handed",6,11,0,17,0.352941176
4,"super featherweight",28,"right-handed",6,3,0,9,0.666666667
4,"light heavyweight",31,"right-handed",3,1,1,5,0.7
4,"cruiserweight",NA,"right-handed",3,3,0,6,0.5
4,"light heavyweight",31,"right-handed",5,8,4,17,0.411764706
4,"super featherweight",21,"right-handed",2,4,1,7,0.357142857
4,"lightweight",29,"right-handed",4,4,0,8,0.5
4,"super lightweight",27,"right-handed",2,0,0,2,1
4,"flyweight",24,"right-handed",8,10,2,20,0.45
4,"lightweight",23,"right-handed",1,0,0,1,1
4,"super lightweight",25,"right-handed",4,2,0,6,0.666666667
4,"super middleweight",29,"right-handed",6,3,0,9,0.666666667
4,"lightweight",24,"right-handed",6,2,0,8,0.75
4,"super flyweight",24,"right-handed",6,7,2,15,0.466666667
4,"super bantamweight",21,"right-handed",3,2,0,5,0.6
4,"welterweight",39,"right-handed",25,21,0,46,0.543478261
4,"welterweight",37,"right-handed",4,0,0,4,1
4,"lightweight",27,"right-handed",9,5,0,14,0.642857143
4,"super bantamweight",22,"right-handed",4,2,0,6,0.666666667
4,"super bantamweight",20,"right-handed",2,1,1,4,0.625
4,"super lightweight",23,"right-handed",2,2,3,7,0.5
4,"middleweight",20,"right-handed",2,0,0,2,1
4,"super welterweight",28,"right-handed",11,17,3,31,0.403225806
4,"super middleweight",28,"right-handed",8,15,0,23,0.347826087
4,"welterweight",24,"right-handed",3,0,0,3,1
4,"super bantamweight",24,"right-handed",5,6,1,12,0.458333333
4,"super bantamweight",29,"right-handed",18,30,0,48,0.375
4,"lightweight",37,"right-handed",5,3,1,9,0.611111111
4,"lightweight",20,"right-handed",4,0,0,4,1
4,"flyweight",33,"right-handed",2,18,0,20,0.1
4,"heavyweight",24,"right-handed",1,0,0,1,1
4,"super lightweight",19,"right-handed",7,0,0,7,1
4,"middleweight",34,"right-handed",5,3,0,8,0.625
4,"super featherweight",28,"right-handed",8,7,1,16,0.53125
3,"super lightweight",32,"right-handed",1,1,0,2,0.5
3,"featherweight",28,"right-handed",4,0,0,4,1
3,"super bantamweight",29,"right-handed",4,8,2,14,0.357142857
3,"super lightweight",36,"right-handed",10,21,2,33,0.333333333
3,"super middleweight",21,"right-handed",3,1,0,4,0.75
3,"super welterweight",24,"right-handed",1,0,0,1,1
3,"super bantamweight",20,"right-handed",4,6,3,13,0.423076923
3,"featherweight",21,"right-handed",3,1,0,4,0.75
3,"heavyweight",NA,"right-handed",5,0,1,6,0.916666667
3,"cruiserweight",26,"right-handed",2,0,0,2,1
3,"bantamweight",18,"right-handed",3,2,0,5,0.6
3,"heavyweight",40,"right-handed",2,1,1,4,0.625
3,"super middleweight",33,"right-handed",5,4,0,9,0.555555556
3,"super bantamweight",32,"right-handed",6,3,1,10,0.65
3,"super featherweight",22,"right-handed",9,16,0,25,0.36
3,"middleweight",NA,"right-handed",1,0,0,1,1
3,"middleweight",NA,"right-handed",6,7,0,13,0.461538462
3,"super lightweight",25,"right-handed",1,0,0,1,1
3,"welterweight",34,"right-handed",4,4,0,8,0.5
3,"bantamweight",26,"right-handed",5,7,1,13,0.423076923
3,"cruiserweight",28,"right-handed",7,4,0,11,0.636363636
3,"light flyweight",33,"right-handed",1,2,0,3,0.333333333
3,"bantamweight",35,"right-handed",3,2,0,5,0.6
3,"welterweight",23,"right-handed",3,1,0,4,0.75
3,"light heavyweight",27,"right-handed",1,0,0,1,1
3,"middleweight",23,"right-handed",3,0,0,3,1
3,"super featherweight",27,"right-handed",8,7,1,16,0.53125
3,"welterweight",27,"right-handed",3,2,0,5,0.6
3,"bantamweight",29,"right-handed",8,16,3,27,0.351851852
3,"cruiserweight",23,"right-handed",2,1,1,4,0.625
3,"welterweight",22,"right-handed",3,0,0,3,1
3,"super welterweight",24,"right-handed",3,0,0,3,1
3,"middleweight",42,"right-handed",23,47,2,72,0.333333333
3,"super flyweight",28,"right-handed",4,11,5,20,0.325
3,"super lightweight",34,"right-handed",11,25,1,37,0.310810811
3,"super lightweight",24,"right-handed",4,1,0,5,0.8
3,"light flyweight",34,"right-handed",7,12,4,23,0.391304348
3,"bantamweight",19,"right-handed",4,0,0,4,1
3,"super middleweight",32,"right-handed",7,3,1,11,0.681818182
3,"super flyweight",19,"right-handed",3,0,1,4,0.875
3,"welterweight",28,"right-handed",2,3,0,5,0.4
3,"super welterweight",NA,"right-handed",6,2,0,8,0.75
3,"light heavyweight",39,"right-handed",33,18,0,51,0.647058824
3,"middleweight",31,"right-handed",2,1,0,3,0.666666667
3,"heavyweight",32,"right-handed",4,2,0,6,0.666666667
3,"super bantamweight",18,"right-handed",2,0,0,2,1
3,"super welterweight",37,"right-handed",10,11,1,22,0.477272727
3,"light heavyweight",25,"right-handed",2,1,1,4,0.625
3,"lightweight",27,"right-handed",1,0,0,1,1
3,"super flyweight",36,"right-handed",3,8,0,11,0.272727273
3,"middleweight",31,"right-handed",1,0,0,1,1
3,"light heavyweight",NA,"right-handed",2,0,0,2,1
3,"heavyweight",29,"right-handed",6,6,0,12,0.5
3,"featherweight",27,"right-handed",9,5,1,15,0.633333333
3,"super lightweight",23,"right-handed",1,0,2,3,0.666666667
3,"bantamweight",33,"right-handed",14,29,6,49,0.346938776
3,"welterweight",30,"right-handed",2,0,0,2,1
3,"featherweight",43,"right-handed",17,8,0,25,0.68
3,"super lightweight",19,"right-handed",3,1,1,5,0.7
3,"super lightweight",28,"right-handed",1,0,0,1,1
3,"welterweight",34,"right-handed",4,2,1,7,0.642857143
3,"bantamweight",47,"right-handed",20,19,1,40,0.5125
3,"welterweight",30,"right-handed",3,3,0,6,0.5
3,"super welterweight",29,"right-handed",2,2,0,4,0.5
3,"super middleweight",29,"right-handed",1,2,0,3,0.333333333
3,"welterweight",26,"right-handed",6,7,3,16,0.46875
3,"cruiserweight",28,"right-handed",7,0,0,7,1
3,"super featherweight",32,"right-handed",3,6,0,9,0.333333333
3,"featherweight",22,"right-handed",4,1,4,9,0.666666667
3,"light heavyweight",21,"right-handed",23,18,1,42,0.55952381
3,"super welterweight",19,"right-handed",4,1,0,5,0.8
3,"light heavyweight",37,"right-handed",19,16,0,35,0.542857143
3,"lightweight",NA,"right-handed",2,0,0,2,1
3,"middleweight",20,"right-handed",1,0,0,1,1
3,"super bantamweight",29,"right-handed",11,24,0,35,0.314285714
3,"light flyweight",24,"right-handed",3,1,0,4,0.75
3,"lightweight",21,"right-handed",2,0,0,2,1
3,"super welterweight",25,"right-handed",22,15,2,39,0.58974359
3,"super welterweight",43,"right-handed",21,13,0,34,0.617647059
3,"featherweight",21,"right-handed",2,2,2,6,0.5
3,"welterweight",34,"right-handed",13,19,1,33,0.409090909
3,"middleweight",24,"right-handed",2,1,0,3,0.666666667
3,"heavyweight",40,"right-handed",28,17,2,47,0.617021277
3,"lightweight",26,"right-handed",6,6,3,15,0.5
3,"welterweight",26,"right-handed",2,4,1,7,0.357142857
3,"super bantamweight",25,"right-handed",3,0,1,4,0.875
3,"heavyweight",38,"right-handed",14,11,0,25,0.56
3,"super welterweight",24,"right-handed",2,0,0,2,1
3,"featherweight",30,"right-handed",17,21,2,40,0.45
3,"welterweight",29,"right-handed",8,24,1,33,0.257575758
3,"middleweight",26,"right-handed",2,3,0,5,0.4
3,"lightweight",31,"right-handed",29,10,4,43,0.720930233
3,"super middleweight",29,"right-handed",2,0,0,2,1
3,"light flyweight",32,"right-handed",25,22,1,48,0.53125
3,"heavyweight",38,"right-handed",10,12,3,25,0.46
3,"welterweight",25,"right-handed",2,2,2,6,0.5
3,"middleweight",24,"right-handed",2,0,0,2,1
3,"super welterweight",NA,"right-handed",3,2,0,5,0.6
3,"cruiserweight",33,"right-handed",3,7,0,10,0.3
3,"super bantamweight",NA,"right-handed",4,1,0,5,0.8
3,"welterweight",24,"right-handed",3,1,0,4,0.75
3,"flyweight",22,"right-handed",3,2,0,5,0.6
3,"middleweight",35,"right-handed",11,14,1,26,0.442307692
3,"super lightweight",32,"right-handed",5,12,0,17,0.294117647
3,"lightweight",24,"right-handed",6,16,4,26,0.307692308
3,"lightweight",27,"right-handed",3,2,0,5,0.6
3,"super flyweight",34,"right-handed",5,8,2,15,0.4
3,"welterweight",38,"right-handed",28,23,0,51,0.549019608
3,"heavyweight",34,"right-handed",12,6,0,18,0.666666667
3,"welterweight",20,"right-handed",2,2,0,4,0.5
3,"bantamweight",34,"right-handed",21,24,0,45,0.466666667
3,"bantamweight",20,"right-handed",2,0,0,2,1
3,"welterweight",27,"right-handed",4,2,0,6,0.666666667
3,"super featherweight",33,"right-handed",4,7,2,13,0.384615385
3,"middleweight",29,"right-handed",3,2,0,5,0.6
3,"welterweight",22,"right-handed",3,4,0,7,0.428571429
3,"super lightweight",24,"right-handed",2,1,0,3,0.666666667
3,"middleweight",35,"right-handed",9,5,0,14,0.642857143
3,"lightweight",23,"right-handed",6,12,1,19,0.342105263
3,"bantamweight",30,"right-handed",22,39,3,64,0.3671875
3,"super welterweight",29,"right-handed",2,1,3,6,0.583333333
3,"super lightweight",33,"right-handed",4,3,0,7,0.571428571
3,"welterweight",28,"right-handed",3,9,1,13,0.269230769
3,"super lightweight",23,"right-handed",2,0,0,2,1
3,"welterweight",NA,"right-handed",2,0,0,2,1
3,"super middleweight",33,"right-handed",8,18,0,26,0.307692308
3,"super welterweight",22,"right-handed",4,1,1,6,0.75
3,"featherweight",27,"right-handed",4,6,0,10,0.4
3,"super featherweight",27,"right-handed",3,0,0,3,1
3,"super flyweight",22,"right-handed",3,2,1,6,0.583333333
3,"flyweight",NA,"right-handed",3,1,0,4,0.75
3,"featherweight",24,"right-handed",5,7,1,13,0.423076923
3,"welterweight",40,"right-handed",5,18,0,23,0.217391304
3,"minimumweight",17,"right-handed",4,5,0,9,0.444444444
3,"super lightweight",33,"right-handed",15,12,2,29,0.551724138
3,"welterweight",27,"right-handed",5,3,2,10,0.6
3,"middleweight",27,"right-handed",4,2,0,6,0.666666667
3,"lightweight",NA,"right-handed",1,0,0,1,1
3,"featherweight",29,"right-handed",3,2,0,5,0.6
3,"heavyweight",32,"right-handed",28,12,5,45,0.677777778
3,"heavyweight",26,"right-handed",2,0,0,2,1
3,"flyweight",32,"right-handed",1,1,1,3,0.5
3,"featherweight",25,"right-handed",1,0,0,1,1
3,"featherweight",18,"right-handed",1,0,0,1,1
3,"light heavyweight",30,"right-handed",5,6,1,12,0.458333333
3,"light flyweight",33,"right-handed",6,14,2,22,0.318181818
3,"lightweight",22,"right-handed",6,3,1,10,0.65
3,"middleweight",33,"right-handed",27,23,0,50,0.54
3,"bantamweight",23,"right-handed",11,32,0,43,0.255813953
3,"lightweight",35,"right-handed",11,16,0,27,0.407407407
3,"super lightweight",26,"right-handed",2,0,1,3,0.833333333
3,"lightweight",33,"right-handed",4,10,5,19,0.342105263
3,"lightweight",35,"right-handed",7,14,4,25,0.36
3,"super middleweight",29,"right-handed",38,23,0,61,0.62295082
3,"lightweight",34,"right-handed",5,17,3,25,0.26
3,"flyweight",23,"right-handed",2,2,0,4,0.5
3,"flyweight",22,"right-handed",3,2,1,6,0.583333333
3,"cruiserweight",28,"right-handed",1,0,0,1,1
3,"super lightweight",28,"right-handed",6,5,3,14,0.535714286
3,"welterweight",NA,"right-handed",2,1,0,3,0.666666667
3,"super welterweight",23,"right-handed",4,4,0,8,0.5
3,"cruiserweight",40,"right-handed",2,3,0,5,0.4
3,"light heavyweight",35,"right-handed",7,23,2,32,0.25
3,"welterweight",28,"right-handed",2,0,0,2,1
3,"heavyweight",31,"right-handed",14,5,1,20,0.725
3,"featherweight",21,"right-handed",2,0,1,3,0.833333333
3,"super middleweight",32,"right-handed",3,15,1,19,0.184210526
3,"featherweight",22,"right-handed",2,1,0,3,0.666666667
3,"lightweight",23,"right-handed",2,0,1,3,0.833333333
3,"super lightweight",28,"right-handed",1,1,0,2,0.5
3,"super middleweight",31,"right-handed",6,7,0,13,0.461538462
3,"welterweight",32,"right-handed",12,10,2,24,0.541666667
3,"heavyweight",36,"right-handed",4,4,0,8,0.5
3,"super welterweight",24,"right-handed",2,0,0,2,1
3,"light flyweight",20,"right-handed",4,2,1,7,0.642857143
3,"flyweight",21,"right-handed",6,1,1,8,0.8125
3,"super featherweight",35,"right-handed",1,0,0,1,1
3,"middleweight",21,"right-handed",0,0,1,1,0.5
3,"super welterweight",48,"right-handed",16,14,0,30,0.533333333
3,"super flyweight",29,"right-handed",18,12,0,30,0.6
3,"super middleweight",24,"right-handed",6,5,0,11,0.545454545
3,"super welterweight",23,"right-handed",5,5,1,11,0.5
3,"featherweight",27,"right-handed",1,1,0,2,0.5
3,"middleweight",34,"right-handed",3,8,1,12,0.291666667
3,"heavyweight",43,"right-handed",3,20,2,25,0.16
3,"middleweight",NA,"right-handed",2,41,1,44,0.056818182
3,"super featherweight",33,"right-handed",11,9,0,20,0.55
3,"welterweight",25,"right-handed",4,1,1,6,0.75
3,"welterweight",39,"right-handed",5,11,1,17,0.323529412
3,"heavyweight",29,"right-handed",8,2,0,10,0.8
3,"featherweight",27,"right-handed",3,0,0,3,1
3,"welterweight",28,"right-handed",11,16,0,27,0.407407407
3,"middleweight",39,"right-handed",2,0,0,2,1
3,"middleweight",19,"right-handed",2,0,0,2,1
3,"minimumweight",30,"right-handed",2,0,0,2,1
3,"cruiserweight",31,"right-handed",2,0,0,2,1
3,"light heavyweight",NA,"right-handed",2,0,0,2,1
3,"light heavyweight",31,"right-handed",2,0,0,2,1
3,"lightweight",22,"right-handed",2,0,0,2,1
3,"heavyweight",25,"right-handed",5,10,1,16,0.34375
3,"featherweight",NA,"right-handed",2,3,0,5,0.4
3,"super welterweight",25,"right-handed",2,0,0,2,1
3,"super welterweight",28,"right-handed",2,0,0,2,1
3,"welterweight",23,"right-handed",2,0,0,2,1
3,"heavyweight",26,"right-handed",2,0,0,2,1
3,"heavyweight",31,"right-handed",2,0,0,2,1
3,"cruiserweight",24,"right-handed",2,0,0,2,1
3,"featherweight",31,"right-handed",11,16,0,27,0.407407407
3,"super welterweight",18,"right-handed",1,0,1,2,0.75
3,"super bantamweight",27,"right-handed",2,13,2,17,0.176470588
3,"super lightweight",26,"right-handed",2,6,0,8,0.25
3,"middleweight",20,"right-handed",4,21,5,30,0.216666667
3,"super flyweight",20,"right-handed",3,3,0,6,0.5
3,"cruiserweight",33,"right-handed",3,7,1,11,0.318181818
3,"flyweight",26,"right-handed",2,1,2,5,0.6
3,"super welterweight",20,"right-handed",4,1,0,5,0.8
3,"cruiserweight",NA,"right-handed",2,5,0,7,0.285714286
3,"lightweight",24,"right-handed",4,2,0,6,0.666666667
3,"light flyweight",21,"right-handed",2,2,0,4,0.5
3,"featherweight",29,"right-handed",5,3,0,8,0.625
3,"super featherweight",19,"right-handed",2,2,1,5,0.5
3,"heavyweight",46,"right-handed",10,13,1,24,0.4375
3,"featherweight",31,"right-handed",5,5,2,12,0.5
3,"super lightweight",22,"right-handed",1,0,0,1,1
3,"super flyweight",18,"right-handed",2,0,1,3,0.833333333
3,"heavyweight",34,"right-handed",5,6,0,11,0.454545455
3,"middleweight",23,"right-handed",1,0,1,2,0.75
3,"featherweight",35,"right-handed",2,2,0,4,0.5
3,"light heavyweight",27,"right-handed",11,6,1,18,0.638888889
3,"flyweight",NA,"right-handed",1,0,0,1,1
3,"lightweight",29,"right-handed",3,6,1,10,0.35
3,"bantamweight",22,"right-handed",8,2,2,12,0.75
3,"featherweight",NA,"right-handed",3,2,2,7,0.571428571
3,"welterweight",29,"right-handed",1,0,0,1,1
3,"middleweight",31,"right-handed",5,19,1,25,0.22
3,"super welterweight",37,"right-handed",12,6,1,19,0.657894737
3,"heavyweight",25,"right-handed",3,1,0,4,0.75
3,"cruiserweight",39,"right-handed",8,18,0,26,0.307692308
3,"super bantamweight",22,"right-handed",1,11,0,12,0.083333333
3,"middleweight",22,"right-handed",3,2,1,6,0.583333333
3,"flyweight",25,"right-handed",5,11,4,20,0.35
3,"cruiserweight",34,"right-handed",9,18,4,31,0.35483871
3,"super welterweight",24,"right-handed",4,4,1,9,0.5
3,"welterweight",26,"right-handed",1,8,0,9,0.111111111
3,"super bantamweight",23,"right-handed",1,3,0,4,0.25
3,"light flyweight",19,"right-handed",2,4,0,6,0.333333333
3,"bantamweight",20,"right-handed",2,2,1,5,0.5
3,"featherweight",29,"right-handed",4,0,0,4,1
3,"super bantamweight",44,"right-handed",8,14,0,22,0.363636364
3,"super lightweight",21,"right-handed",2,1,0,3,0.666666667
3,"heavyweight",43,"right-handed",43,28,1,72,0.604166667
3,"lightweight",27,"right-handed",3,3,0,6,0.5
3,"super bantamweight",32,"right-handed",7,11,2,20,0.4
3,"cruiserweight",22,"right-handed",6,11,0,17,0.352941176
3,"featherweight",27,"right-handed",3,1,1,5,0.7
3,"light heavyweight",28,"right-handed",12,13,0,25,0.48
3,"flyweight",24,"right-handed",3,7,4,14,0.357142857
3,"super middleweight",27,"right-handed",8,7,1,16,0.53125
3,"cruiserweight",26,"right-handed",8,10,0,18,0.444444444
3,"cruiserweight",31,"right-handed",2,1,0,3,0.666666667
3,"super bantamweight",26,"right-handed",1,3,1,5,0.3
3,"light heavyweight",40,"right-handed",12,23,0,35,0.342857143
3,"bantamweight",31,"right-handed",8,27,1,36,0.236111111
3,"light flyweight",28,"right-handed",13,15,2,30,0.466666667
3,"welterweight",37,"right-handed",1,3,1,5,0.3
3,"lightweight",33,"right-handed",1,1,0,2,0.5
3,"minimumweight",36,"right-handed",3,6,1,10,0.35
3,"light heavyweight",32,"right-handed",9,13,0,22,0.409090909
3,"super middleweight",27,"right-handed",7,9,3,19,0.447368421
3,"welterweight",22,"right-handed",6,7,0,13,0.461538462
3,"super welterweight",28,"right-handed",1,0,0,1,1
3,"super welterweight",22,"right-handed",1,0,0,1,1
3,"welterweight",40,"right-handed",4,11,4,19,0.315789474
3,"featherweight",22,"right-handed",6,3,0,9,0.666666667
3,"welterweight",20,"right-handed",1,1,0,2,0.5
3,"super lightweight",36,"right-handed",4,17,2,23,0.217391304
3,"super featherweight",21,"right-handed",1,0,0,1,1
3,"super bantamweight",25,"right-handed",3,6,0,9,0.333333333
3,"bantamweight",23,"right-handed",6,7,1,14,0.464285714
3,"super middleweight",34,"right-handed",6,13,2,21,0.333333333
3,"super lightweight",24,"right-handed",8,21,1,30,0.283333333
3,"super welterweight",31,"right-handed",7,5,3,15,0.566666667
3,"super lightweight",34,"right-handed",12,18,1,31,0.403225806
3,"lightweight",18,"right-handed",3,5,0,8,0.375
3,"light heavyweight",32,"right-handed",1,6,0,7,0.142857143
3,"featherweight",25,"right-handed",4,5,1,10,0.45
3,"super lightweight",30,"right-handed",6,91,0,97,0.06185567
3,"super welterweight",37,"right-handed",8,7,0,15,0.533333333
3,"super welterweight",21,"right-handed",1,0,0,1,1
3,"super flyweight",NA,"right-handed",2,1,0,3,0.666666667
3,"middleweight",22,"right-handed",2,1,1,4,0.625
3,"lightweight",34,"right-handed",10,3,0,13,0.769230769
3,"featherweight",18,"right-handed",6,0,0,6,1
3,"super welterweight",26,"right-handed",6,23,1,30,0.216666667
3,"welterweight",22,"right-handed",1,10,1,12,0.125
3,"super featherweight",32,"right-handed",23,31,2,56,0.428571429
3,"lightweight",22,"right-handed",1,0,0,1,1
3,"super bantamweight",25,"right-handed",3,3,1,7,0.5
3,"bantamweight",32,"right-handed",4,7,0,11,0.363636364
3,"lightweight",23,"right-handed",3,1,0,4,0.75
3,"super featherweight",32,"right-handed",12,33,5,50,0.29
3,"middleweight",28,"right-handed",2,7,0,9,0.222222222
3,"super flyweight",27,"right-handed",4,5,2,11,0.454545455
3,"lightweight",38,"right-handed",2,2,0,4,0.5
3,"flyweight",22,"right-handed",3,1,1,5,0.7
3,"super bantamweight",35,"right-handed",28,16,0,44,0.636363636
3,"welterweight",26,"right-handed",4,5,1,10,0.45
3,"middleweight",28,"right-handed",3,3,0,6,0.5
3,"flyweight",25,"right-handed",1,0,0,1,1
3,"super flyweight",32,"right-handed",5,0,0,5,1
3,"heavyweight",NA,"right-handed",7,1,0,8,0.875
3,"super welterweight",26,"right-handed",1,1,0,2,0.5
3,"heavyweight",41,"right-handed",25,47,2,74,0.351351351
3,"middleweight",34,"right-handed",4,5,0,9,0.444444444
3,"middleweight",29,"right-handed",1,4,0,5,0.2
3,"super lightweight",34,"right-handed",1,5,4,10,0.3
3,"super bantamweight",21,"right-handed",3,2,0,5,0.6
3,"super featherweight",NA,"right-handed",1,2,1,4,0.375
3,"bantamweight",22,"right-handed",1,13,0,14,0.071428571
3,"bantamweight",26,"right-handed",1,1,0,2,0.5
3,"super welterweight",35,"right-handed",2,3,2,7,0.428571429
3,"heavyweight",34,"right-handed",11,13,2,26,0.461538462
3,"super flyweight",29,"right-handed",7,12,2,21,0.380952381
3,"super lightweight",26,"right-handed",2,4,0,6,0.333333333
3,"bantamweight",28,"right-handed",7,8,0,15,0.466666667
3,"welterweight",21,"right-handed",1,0,1,2,0.75
3,"super middleweight",25,"right-handed",12,13,0,25,0.48
3,"super flyweight",27,"right-handed",1,4,0,5,0.2
3,"featherweight",34,"right-handed",17,16,1,34,0.514705882
3,"super flyweight",25,"right-handed",1,0,1,2,0.75
3,"super welterweight",37,"right-handed",3,4,0,7,0.428571429
3,"bantamweight",34,"right-handed",4,6,2,12,0.416666667
3,"light flyweight",34,"right-handed",1,2,0,3,0.333333333
3,"bantamweight",33,"right-handed",9,11,7,27,0.462962963
3,"super bantamweight",22,"right-handed",2,2,0,4,0.5
3,"lightweight",41,"right-handed",3,3,0,6,0.5
3,"light flyweight",NA,"right-handed",1,0,0,1,1
3,"super welterweight",24,"right-handed",3,1,1,5,0.7
3,"super featherweight",38,"right-handed",5,28,1,34,0.161764706
3,"light heavyweight",33,"right-handed",8,13,0,21,0.380952381
3,"super flyweight",24,"right-handed",7,17,7,31,0.338709677
3,"lightweight",23,"right-handed",4,2,0,6,0.666666667
3,"lightweight",29,"right-handed",4,8,0,12,0.333333333
3,"bantamweight",22,"right-handed",9,7,0,16,0.5625
3,"super featherweight",38,"right-handed",5,0,1,6,0.916666667
3,"super bantamweight",26,"right-handed",3,2,0,5,0.6
3,"super featherweight",NA,"right-handed",9,10,1,20,0.475
3,"super welterweight",20,"right-handed",1,0,0,1,1
3,"bantamweight",25,"right-handed",3,5,3,11,0.409090909
3,"featherweight",22,"right-handed",1,2,0,3,0.333333333
3,"cruiserweight",25,"right-handed",4,5,0,9,0.444444444
3,"super welterweight",18,"right-handed",1,2,3,6,0.416666667
3,"heavyweight",32,"right-handed",3,2,0,5,0.6
3,"super featherweight",32,"right-handed",3,3,0,6,0.5
3,"super middleweight",22,"right-handed",1,0,2,3,0.666666667
3,"featherweight",26,"right-handed",2,3,2,7,0.428571429
3,"super lightweight",21,"right-handed",6,5,0,11,0.545454545
3,"cruiserweight",36,"right-handed",21,11,3,35,0.642857143
3,"super middleweight",39,"right-handed",16,14,1,31,0.532258065
3,"flyweight",42,"right-handed",3,9,0,12,0.25
3,"super flyweight",26,"right-handed",1,0,1,2,0.75
3,"super flyweight",28,"right-handed",6,7,0,13,0.461538462
3,"featherweight",37,"right-handed",8,31,2,41,0.219512195
3,"heavyweight",30,"right-handed",15,14,1,30,0.516666667
3,"light heavyweight",34,"right-handed",2,0,0,2,1
3,"super featherweight",36,"right-handed",7,9,0,16,0.4375
3,"welterweight",24,"right-handed",2,10,0,12,0.166666667
3,"super middleweight",31,"right-handed",6,19,3,28,0.267857143
3,"super bantamweight",31,"right-handed",10,28,0,38,0.263157895
3,"super lightweight",29,"right-handed",5,6,1,12,0.458333333
3,"featherweight",34,"right-handed",27,26,3,56,0.508928571
3,"super welterweight",29,"right-handed",8,1,0,9,0.888888889
3,"lightweight",32,"right-handed",4,15,2,21,0.238095238
3,"cruiserweight",31,"right-handed",4,5,1,10,0.45
3,"cruiserweight",34,"right-handed",15,6,2,23,0.695652174
3,"welterweight",31,"right-handed",2,4,0,6,0.333333333
3,"heavyweight",NA,"right-handed",3,2,0,5,0.6
3,"super middleweight",34,"right-handed",13,34,3,50,0.29
3,"super lightweight",23,"right-handed",4,4,1,9,0.5
3,"welterweight",24,"right-handed",1,1,0,2,0.5
3,"light flyweight",27,"right-handed",8,7,2,17,0.529411765
3,"welterweight",23,"right-handed",2,2,0,4,0.5
3,"welterweight",24,"right-handed",1,0,1,2,0.75
3,"super flyweight",31,"right-handed",4,6,2,12,0.416666667
3,"bantamweight",22,"right-handed",3,2,1,6,0.583333333
3,"super lightweight",22,"right-handed",1,1,1,3,0.5
3,"middleweight",27,"right-handed",5,7,0,12,0.416666667
3,"welterweight",NA,"right-handed",8,7,1,16,0.53125
3,"bantamweight",20,"right-handed",1,0,1,2,0.75
3,"welterweight",37,"right-handed",5,12,1,18,0.305555556
3,"super bantamweight",28,"right-handed",4,7,0,11,0.363636364
3,"middleweight",24,"right-handed",1,0,0,1,1
3,"super middleweight",NA,"right-handed",1,0,0,1,1
3,"cruiserweight",33,"right-handed",1,0,0,1,1
3,"super welterweight",24,"right-handed",1,0,0,1,1
3,"super welterweight",25,"right-handed",1,0,0,1,1
3,"super bantamweight",21,"right-handed",1,0,0,1,1
3,"super lightweight",29,"right-handed",1,0,0,1,1
3,"lightweight",27,"right-handed",1,0,0,1,1
3,"super welterweight",33,"right-handed",1,0,0,1,1
3,"middleweight",22,"right-handed",1,0,0,1,1
3,"lightweight",29,"right-handed",1,0,0,1,1
3,"super middleweight",33,"right-handed",1,0,0,1,1
3,"welterweight",19,"right-handed",1,0,0,1,1
3,"featherweight",20,"right-handed",1,0,0,1,1
3,"middleweight",22,"right-handed",1,0,0,1,1
3,"welterweight",NA,"right-handed",1,0,0,1,1
3,"cruiserweight",46,"right-handed",1,0,0,1,1
3,"super featherweight",30,"right-handed",1,0,0,1,1
3,"bantamweight",19,"right-handed",1,0,0,1,1
3,"light heavyweight",25,"right-handed",1,0,0,1,1
3,"super welterweight",29,"right-handed",1,0,0,1,1
3,"heavyweight",33,"right-handed",1,0,0,1,1
3,"heavyweight",28,"right-handed",1,0,0,1,1
3,"middleweight",NA,"right-handed",1,0,0,1,1
3,"super bantamweight",NA,"right-handed",1,0,0,1,1
3,"lightweight",NA,"right-handed",1,0,0,1,1
3,"welterweight",24,"right-handed",1,0,0,1,1
3,"super middleweight",26,"right-handed",1,0,0,1,1
3,"heavyweight",39,"right-handed",1,0,0,1,1
3,"cruiserweight",22,"right-handed",1,0,0,1,1
3,"minimumweight",NA,"right-handed",2,2,0,4,0.5
3,"lightweight",31,"right-handed",2,2,0,4,0.5
3,"flyweight",30,"right-handed",1,1,0,2,0.5
3,"featherweight",23,"right-handed",1,1,0,2,0.5
3,"super middleweight",24,"right-handed",1,1,0,2,0.5
3,"featherweight",21,"right-handed",1,1,0,2,0.5
3,"flyweight",22,"right-handed",1,1,0,2,0.5
3,"super welterweight",29,"right-handed",1,1,0,2,0.5
3,"super flyweight",22,"right-handed",1,1,0,2,0.5
3,"super bantamweight",NA,"right-handed",1,1,0,2,0.5
3,"super featherweight",23,"right-handed",1,1,0,2,0.5
3,"cruiserweight",33,"right-handed",1,1,0,2,0.5
3,"welterweight",18,"right-handed",1,1,0,2,0.5
3,"super welterweight",40,"right-handed",13,15,1,29,0.465517241
3,"lightweight",18,"right-handed",1,0,2,3,0.666666667
3,"featherweight",28,"right-handed",1,2,0,3,0.333333333
3,"bantamweight",20,"right-handed",1,2,0,3,0.333333333
3,"bantamweight",23,"right-handed",1,2,0,3,0.333333333
3,"bantamweight",21,"right-handed",1,2,0,3,0.333333333
3,"super featherweight",25,"right-handed",2,4,2,8,0.375
3,"super featherweight",27,"right-handed",1,2,1,4,0.375
3,"minimumweight",23,"right-handed",1,3,1,5,0.3
3,"cruiserweight",24,"right-handed",1,6,0,7,0.142857143
3,"super middleweight",NA,"right-handed",2,39,0,41,0.048780488
3,"heavyweight",36,"right-handed",17,19,0,36,0.472222222
3,"super featherweight",21,"right-handed",3,3,1,7,0.5
3,"super bantamweight",37,"right-handed",10,10,1,21,0.5
3,"super welterweight",35,"right-handed",16,13,2,31,0.548387097
3,"heavyweight",29,"right-handed",7,8,1,16,0.46875
3,"featherweight",26,"right-handed",2,3,0,5,0.4
3,"featherweight",22,"right-handed",2,1,0,3,0.666666667
3,"super lightweight",30,"right-handed",2,5,2,9,0.333333333
3,"welterweight",26,"right-handed",7,1,1,9,0.833333333
3,"lightweight",27,"right-handed",7,10,1,18,0.416666667
1090,"welterweight",31,"left-handed",34,0,0,34,1
846,"lightweight",30,"left-handed",12,1,0,13,0.923076923
826,"cruiserweight",31,"left-handed",16,0,0,16,1
792,"bantamweight",23,"left-handed",28,0,0,28,1
752,"super flyweight",32,"left-handed",47,4,1,52,0.913461538
551,"welterweight",39,"left-handed",60,7,2,69,0.884057971
549,"welterweight",28,"left-handed",24,0,0,24,1
456,"featherweight",30,"left-handed",29,1,0,30,0.966666667
406,"super middleweight",27,"left-handed",38,0,0,38,1
387,"super lightweight",29,"left-handed",23,0,0,23,1
382,"super featherweight",24,"left-handed",20,0,0,20,1
360,"super lightweight",27,"left-handed",14,0,0,14,1
349,"super featherweight",28,"left-handed",21,0,0,21,1
321,"middleweight",29,"left-handed",26,0,0,26,1
307,"super welterweight",35,"left-handed",25,3,2,30,0.866666667
275,"light heavyweight",41,"left-handed",29,2,1,32,0.921875
266,"bantamweight",30,"left-handed",28,3,0,31,0.903225806
265,"lightweight",31,"left-handed",19,2,0,21,0.904761905
262,"cruiserweight",32,"left-handed",31,1,0,32,0.96875
246,"super bantamweight",27,"left-handed",25,1,0,26,0.961538462
239,"super featherweight",24,"left-handed",13,0,0,13,1
223,"middleweight",30,"left-handed",26,0,0,26,1
222,"super lightweight",31,"left-handed",21,2,0,23,0.913043478
216,"super flyweight",26,"left-handed",30,1,2,33,0.939393939
210,"featherweight",26,"left-handed",27,1,0,28,0.964285714
197,"light heavyweight",28,"left-handed",22,0,0,22,1
196,"super bantamweight",31,"left-handed",25,5,2,32,0.8125
193,"super middleweight",32,"left-handed",25,2,1,28,0.910714286
187,"super featherweight",31,"left-handed",28,3,0,31,0.903225806
177,"super lightweight",35,"left-handed",22,2,0,24,0.916666667
175,"heavyweight",39,"left-handed",30,1,0,31,0.967741935
174,"lightweight",29,"left-handed",33,2,1,36,0.930555556
170,"super bantamweight",32,"left-handed",20,0,0,20,1
170,"super featherweight",28,"left-handed",27,4,1,32,0.859375
166,"super lightweight",25,"left-handed",23,0,0,23,1
166,"bantamweight",31,"left-handed",16,2,0,18,0.888888889
165,"cruiserweight",39,"left-handed",32,2,0,34,0.941176471
162,"minimumweight",24,"left-handed",16,3,0,19,0.842105263
151,"super middleweight",30,"left-handed",27,4,0,31,0.870967742
151,"flyweight",37,"left-handed",35,8,0,43,0.813953488
146,"lightweight",29,"left-handed",30,1,0,31,0.967741935
142,"featherweight",25,"left-handed",22,0,0,22,1
138,"cruiserweight",26,"left-handed",21,1,0,22,0.954545455
138,"middleweight",31,"left-handed",23,3,0,26,0.884615385
137,"super lightweight",29,"left-handed",33,2,0,35,0.942857143
135,"light heavyweight",33,"left-handed",22,2,0,24,0.916666667
135,"bantamweight",35,"left-handed",35,4,0,39,0.897435897
133,"super bantamweight",28,"left-handed",25,3,0,28,0.892857143
133,"light flyweight",28,"left-handed",24,14,0,38,0.631578947
132,"super flyweight",32,"left-handed",21,5,0,26,0.807692308
131,"featherweight",25,"left-handed",18,2,0,20,0.9
131,"featherweight",26,"left-handed",31,2,0,33,0.939393939
131,"bantamweight",32,"left-handed",14,0,0,14,1
130,"super welterweight",33,"left-handed",31,5,0,36,0.861111111
124,"super welterweight",28,"left-handed",29,1,0,30,0.966666667
119,"super featherweight",22,"left-handed",12,0,0,12,1
118,"cruiserweight",30,"left-handed",23,2,0,25,0.92
118,"bantamweight",34,"left-handed",20,2,0,22,0.909090909
113,"bantamweight",43,"left-handed",48,3,2,53,0.924528302
113,"super middleweight",35,"left-handed",26,3,0,29,0.896551724
110,"cruiserweight",33,"left-handed",24,3,1,28,0.875
105,"light flyweight",26,"left-handed",13,0,5,18,0.861111111
103,"super lightweight",27,"left-handed",21,1,1,23,0.934782609
102,"light heavyweight",32,"left-handed",28,3,1,32,0.890625
102,"super featherweight",33,"left-handed",40,4,1,45,0.9
101,"featherweight",29,"left-handed",23,2,0,25,0.92
98,"super lightweight",32,"left-handed",33,7,1,41,0.817073171
98,"featherweight",32,"left-handed",8,0,0,8,1
96,"minimumweight",25,"left-handed",14,3,1,18,0.805555556
96,"super welterweight",23,"left-handed",19,1,0,20,0.95
95,"cruiserweight",30,"left-handed",20,5,0,25,0.8
91,"heavyweight",32,"left-handed",25,2,1,28,0.910714286
91,"flyweight",20,"left-handed",17,0,0,17,1
91,"super lightweight",25,"left-handed",33,2,0,35,0.942857143
90,"light flyweight",31,"left-handed",28,3,1,32,0.890625
88,"super lightweight",33,"left-handed",30,3,0,33,0.909090909
88,"super featherweight",23,"left-handed",12,0,0,12,1
87,"lightweight",31,"left-handed",32,2,2,36,0.916666667
87,"welterweight",29,"left-handed",34,4,2,40,0.875
87,"minimumweight",29,"left-handed",21,6,6,33,0.727272727
86,"super featherweight",38,"left-handed",50,16,1,67,0.753731343
85,"super lightweight",27,"left-handed",14,0,0,14,1
85,"light heavyweight",27,"left-handed",16,0,1,17,0.970588235
84,"super featherweight",21,"left-handed",9,0,0,9,1
84,"welterweight",34,"left-handed",19,3,0,22,0.863636364
84,"super flyweight",NA,"left-handed",11,2,0,13,0.846153846
83,"super lightweight",26,"left-handed",12,0,0,12,1
83,"super bantamweight",25,"left-handed",24,0,0,24,1
82,"super welterweight",32,"left-handed",27,2,1,30,0.916666667
82,"welterweight",31,"left-handed",26,2,1,29,0.913793103
82,"super lightweight",30,"left-handed",15,2,1,18,0.861111111
81,"bantamweight",26,"left-handed",28,2,1,31,0.919354839
81,"super featherweight",35,"left-handed",46,1,1,48,0.96875
79,"bantamweight",30,"left-handed",4,1,0,5,0.8
78,"super lightweight",27,"left-handed",5,0,0,5,1
78,"super flyweight",33,"left-handed",18,2,0,20,0.9
78,"super welterweight",33,"left-handed",46,3,0,49,0.93877551
77,"featherweight",28,"left-handed",13,1,0,14,0.928571429
76,"super featherweight",26,"left-handed",16,0,1,17,0.970588235
76,"welterweight",35,"left-handed",34,6,1,41,0.841463415
76,"heavyweight",37,"left-handed",19,0,0,19,1
76,"middleweight",28,"left-handed",22,0,0,22,1
76,"super bantamweight",25,"left-handed",19,2,0,21,0.904761905
75,"flyweight",27,"left-handed",28,0,0,28,1
75,"welterweight",31,"left-handed",27,5,1,33,0.833333333
75,"super bantamweight",24,"left-handed",5,0,0,5,1
75,"cruiserweight",25,"left-handed",25,1,0,26,0.961538462
74,"super featherweight",26,"left-handed",18,0,1,19,0.973684211
74,"featherweight",28,"left-handed",26,2,1,29,0.913793103
73,"cruiserweight",48,"left-handed",44,8,3,55,0.827272727
73,"cruiserweight",23,"left-handed",16,0,0,16,1
72,"welterweight",27,"left-handed",24,0,0,24,1
71,"middleweight",30,"left-handed",16,0,0,16,1
70,"heavyweight",28,"left-handed",20,0,0,20,1
70,"middleweight",32,"left-handed",19,2,0,21,0.904761905
70,"super lightweight",26,"left-handed",12,0,0,12,1
70,"super lightweight",30,"left-handed",22,5,3,30,0.783333333
69,"minimumweight",22,"left-handed",13,2,0,15,0.866666667
69,"welterweight",37,"left-handed",38,7,0,45,0.844444444
68,"super middleweight",27,"left-handed",29,3,0,32,0.90625
68,"lightweight",25,"left-handed",18,1,0,19,0.947368421
67,"cruiserweight",25,"left-handed",16,0,0,16,1
67,"heavyweight",29,"left-handed",22,3,0,25,0.88
67,"flyweight",24,"left-handed",18,8,0,26,0.692307692
66,"light heavyweight",30,"left-handed",14,0,0,14,1
66,"lightweight",42,"left-handed",36,0,1,37,0.986486486
65,"welterweight",33,"left-handed",26,4,0,30,0.866666667
64,"featherweight",30,"left-handed",23,0,0,23,1
63,"flyweight",27,"left-handed",22,2,1,25,0.9
63,"featherweight",26,"left-handed",25,2,0,27,0.925925926
62,"welterweight",25,"left-handed",20,3,0,23,0.869565217
62,"light heavyweight",28,"left-handed",17,0,0,17,1
61,"super featherweight",31,"left-handed",8,1,2,11,0.818181818
61,"super middleweight",33,"left-handed",15,1,0,16,0.9375
61,"super lightweight",27,"left-handed",21,2,0,23,0.913043478
60,"featherweight",26,"left-handed",15,0,0,15,1
60,"welterweight",31,"left-handed",32,6,3,41,0.817073171
60,"lightweight",34,"left-handed",23,2,0,25,0.92
59,"super lightweight",26,"left-handed",17,0,0,17,1
59,"super middleweight",30,"left-handed",22,6,0,28,0.785714286
58,"minimumweight",35,"left-handed",23,9,3,35,0.7
58,"featherweight",19,"left-handed",8,0,0,8,1
58,"super welterweight",25,"left-handed",16,0,0,16,1
57,"lightweight",33,"left-handed",18,2,0,20,0.9
56,"super featherweight",26,"left-handed",31,1,0,32,0.96875
56,"super flyweight",27,"left-handed",21,8,3,32,0.703125
56,"light flyweight",23,"left-handed",16,0,0,16,1
56,"welterweight",29,"left-handed",15,1,0,16,0.9375
56,"super featherweight",33,"left-handed",21,4,2,27,0.814814815
56,"super featherweight",28,"left-handed",28,3,1,32,0.890625
56,"middleweight",NA,"left-handed",13,4,2,19,0.736842105
56,"super middleweight",36,"left-handed",28,1,0,29,0.965517241
56,"lightweight",32,"left-handed",31,2,0,33,0.939393939
55,"super lightweight",26,"left-handed",14,0,0,14,1
55,"lightweight",NA,"left-handed",13,2,0,15,0.866666667
55,"lightweight",36,"left-handed",31,6,2,39,0.820512821
54,"lightweight",23,"left-handed",36,3,0,39,0.923076923
53,"light heavyweight",31,"left-handed",20,4,0,24,0.833333333
53,"super lightweight",28,"left-handed",17,1,1,19,0.921052632
53,"light flyweight",28,"left-handed",18,1,2,21,0.904761905
53,"super lightweight",27,"left-handed",6,0,0,6,1
52,"bantamweight",25,"left-handed",48,0,0,48,1
52,"middleweight",29,"left-handed",14,0,0,14,1
52,"super welterweight",33,"left-handed",37,7,0,44,0.840909091
52,"super bantamweight",25,"left-handed",19,1,1,21,0.928571429
51,"lightweight",26,"left-handed",17,3,1,21,0.833333333
51,"super bantamweight",23,"left-handed",20,2,2,24,0.875
50,"lightweight",29,"left-handed",19,2,2,23,0.869565217
50,"featherweight",24,"left-handed",16,6,0,22,0.727272727
50,"super flyweight",38,"left-handed",28,4,4,36,0.833333333
50,"light flyweight",26,"left-handed",19,3,0,22,0.863636364
50,"super welterweight",30,"left-handed",22,1,0,23,0.956521739
50,"welterweight",25,"left-handed",28,1,0,29,0.965517241
50,"heavyweight",35,"left-handed",20,0,0,20,1
50,"super featherweight",28,"left-handed",13,0,0,13,1
50,"super featherweight",27,"left-handed",18,1,0,19,0.947368421
50,"light heavyweight",29,"left-handed",16,1,0,17,0.941176471
49,"super featherweight",27,"left-handed",29,1,2,32,0.9375
49,"minimumweight",24,"left-handed",11,2,0,13,0.846153846
49,"welterweight",27,"left-handed",16,0,0,16,1
49,"super lightweight",32,"left-handed",21,4,1,26,0.826923077
48,"super bantamweight",30,"left-handed",26,7,2,35,0.771428571
48,"super welterweight",30,"left-handed",9,0,0,9,1
48,"super welterweight",27,"left-handed",22,0,0,22,1
47,"super bantamweight",27,"left-handed",16,4,3,23,0.760869565
47,"super featherweight",29,"left-handed",16,1,0,17,0.941176471
47,"welterweight",29,"left-handed",15,2,0,17,0.882352941
47,"lightweight",35,"left-handed",36,6,0,42,0.857142857
47,"super welterweight",28,"left-handed",11,0,1,12,0.958333333
46,"minimumweight",26,"left-handed",10,0,0,10,1
46,"light heavyweight",30,"left-handed",22,7,2,31,0.741935484
46,"super welterweight",28,"left-handed",16,2,0,18,0.888888889
46,"super lightweight",22,"left-handed",15,0,0,15,1
46,"welterweight",32,"left-handed",24,3,0,27,0.888888889
46,"welterweight",28,"left-handed",18,1,0,19,0.947368421
45,"super featherweight",30,"left-handed",25,0,0,25,1
45,"light heavyweight",35,"left-handed",28,1,0,29,0.965517241
45,"super welterweight",29,"left-handed",12,0,1,13,0.961538462
45,"super bantamweight",28,"left-handed",12,0,0,12,1
45,"light flyweight",35,"left-handed",27,5,0,32,0.84375
45,"welterweight",23,"left-handed",16,2,0,18,0.888888889
44,"middleweight",21,"left-handed",14,2,0,16,0.875
44,"cruiserweight",30,"left-handed",28,2,2,32,0.90625
44,"super lightweight",25,"left-handed",23,2,0,25,0.92
44,"welterweight",24,"left-handed",15,0,0,15,1
44,"super middleweight",32,"left-handed",25,2,0,27,0.925925926
44,"welterweight",29,"left-handed",15,2,0,17,0.882352941
44,"minimumweight",25,"left-handed",9,1,0,10,0.9
43,"super flyweight",25,"left-handed",19,3,0,22,0.863636364
43,"cruiserweight",32,"left-handed",29,6,1,36,0.819444444
43,"super welterweight",25,"left-handed",13,0,0,13,1
43,"super lightweight",22,"left-handed",13,0,0,13,1
43,"super lightweight",35,"left-handed",20,3,2,25,0.84
43,"super lightweight",28,"left-handed",11,2,1,14,0.821428571
43,"lightweight",22,"left-handed",15,0,0,15,1
42,"flyweight",29,"left-handed",18,2,2,22,0.863636364
42,"cruiserweight",31,"left-handed",20,6,0,26,0.769230769
42,"super bantamweight",27,"left-handed",36,9,3,48,0.78125
42,"super lightweight",24,"left-handed",22,11,1,34,0.661764706
42,"super welterweight",25,"left-handed",14,0,0,14,1
41,"super middleweight",25,"left-handed",17,0,1,18,0.972222222
41,"welterweight",29,"left-handed",22,3,0,25,0.88
41,"super middleweight",27,"left-handed",14,1,0,15,0.933333333
41,"super welterweight",20,"left-handed",11,0,0,11,1
41,"super bantamweight",28,"left-handed",12,1,0,13,0.923076923
41,"super featherweight",37,"left-handed",31,3,0,34,0.911764706
41,"super welterweight",24,"left-handed",13,1,0,14,0.928571429
41,"lightweight",25,"left-handed",6,0,0,6,1
40,"lightweight",32,"left-handed",18,1,0,19,0.947368421
40,"super lightweight",30,"left-handed",19,2,0,21,0.904761905
40,"featherweight",21,"left-handed",14,0,0,14,1
40,"super featherweight",23,"left-handed",15,2,1,18,0.861111111
40,"super lightweight",34,"left-handed",18,3,0,21,0.857142857
40,"light flyweight",26,"left-handed",29,3,1,33,0.893939394
40,"lightweight",NA,"left-handed",6,0,1,7,0.928571429
40,"super welterweight",31,"left-handed",14,1,0,15,0.933333333
40,"super welterweight",30,"left-handed",18,1,0,19,0.947368421
40,"cruiserweight",33,"left-handed",21,7,0,28,0.75
40,"super lightweight",33,"left-handed",35,4,3,42,0.869047619
39,"bantamweight",21,"left-handed",9,2,3,14,0.75
39,"lightweight",27,"left-handed",12,7,1,20,0.625
39,"bantamweight",32,"left-handed",26,3,1,30,0.883333333
39,"super lightweight",20,"left-handed",14,2,0,16,0.875
39,"super middleweight",40,"left-handed",32,10,3,45,0.744444444
39,"welterweight",25,"left-handed",17,0,0,17,1
39,"bantamweight",30,"left-handed",18,1,3,22,0.886363636
39,"bantamweight",26,"left-handed",16,1,3,20,0.875
38,"flyweight",27,"left-handed",11,2,5,18,0.75
38,"bantamweight",26,"left-handed",17,8,1,26,0.673076923
38,"lightweight",26,"left-handed",26,2,1,29,0.913793103
38,"super lightweight",24,"left-handed",17,0,1,18,0.972222222
38,"middleweight",27,"left-handed",9,6,0,15,0.6
38,"middleweight",37,"left-handed",21,0,1,22,0.977272727
38,"featherweight",22,"left-handed",9,0,0,9,1
37,"bantamweight",27,"left-handed",10,2,1,13,0.807692308
37,"light heavyweight",32,"left-handed",28,4,3,35,0.842857143
37,"super welterweight",32,"left-handed",20,4,1,25,0.82
37,"super bantamweight",27,"left-handed",25,3,0,28,0.892857143
37,"welterweight",21,"left-handed",12,0,0,12,1
37,"bantamweight",25,"left-handed",6,0,0,6,1
37,"flyweight",21,"left-handed",10,1,1,12,0.875
37,"welterweight",31,"left-handed",18,0,0,18,1
37,"bantamweight",25,"left-handed",17,0,1,18,0.972222222
37,"heavyweight",46,"left-handed",23,3,1,27,0.87037037
37,"featherweight",27,"left-handed",24,6,1,31,0.790322581
37,"cruiserweight",30,"left-handed",11,2,1,14,0.821428571
36,"cruiserweight",28,"left-handed",21,4,0,25,0.84
36,"super welterweight",38,"left-handed",43,17,5,65,0.7
36,"super lightweight",23,"left-handed",11,0,1,12,0.958333333
36,"super bantamweight",35,"left-handed",34,9,0,43,0.790697674
36,"heavyweight",37,"left-handed",34,10,0,44,0.772727273
36,"lightweight",34,"left-handed",28,3,1,32,0.890625
36,"featherweight",24,"left-handed",10,0,1,11,0.954545455
36,"featherweight",33,"left-handed",34,3,1,38,0.907894737
36,"welterweight",25,"left-handed",20,0,1,21,0.976190476
36,"light heavyweight",30,"left-handed",10,0,0,10,1
36,"super flyweight",33,"left-handed",16,6,3,25,0.7
36,"super middleweight",25,"left-handed",13,0,0,13,1
36,"bantamweight",30,"left-handed",11,1,0,12,0.916666667
35,"featherweight",28,"left-handed",12,0,0,12,1
35,"super flyweight",25,"left-handed",16,0,1,17,0.970588235
35,"welterweight",41,"left-handed",44,9,0,53,0.830188679
35,"super featherweight",37,"left-handed",25,7,2,34,0.764705882
35,"flyweight",27,"left-handed",20,1,0,21,0.952380952
35,"super bantamweight",39,"left-handed",47,12,1,60,0.791666667
35,"bantamweight",24,"left-handed",14,0,1,15,0.966666667
35,"middleweight",28,"left-handed",10,1,1,12,0.875
35,"featherweight",27,"left-handed",19,4,0,23,0.826086957
35,"lightweight",31,"left-handed",21,9,1,31,0.693548387
35,"super middleweight",24,"left-handed",10,1,1,12,0.875
35,"lightweight",25,"left-handed",17,3,1,21,0.833333333
35,"super lightweight",27,"left-handed",16,2,0,18,0.888888889
35,"light heavyweight",26,"left-handed",12,1,0,13,0.923076923
35,"light heavyweight",26,"left-handed",11,0,0,11,1
34,"super welterweight",34,"left-handed",7,3,0,10,0.7
34,"light heavyweight",29,"left-handed",9,2,0,11,0.818181818
34,"middleweight",27,"left-handed",17,1,0,18,0.944444444
34,"bantamweight",23,"left-handed",13,6,3,22,0.659090909
34,"welterweight",28,"left-handed",15,1,0,16,0.9375
34,"featherweight",23,"left-handed",21,1,0,22,0.954545455
34,"super flyweight",33,"left-handed",16,3,1,20,0.825
33,"super bantamweight",27,"left-handed",12,4,0,16,0.75
33,"super welterweight",27,"left-handed",17,1,0,18,0.944444444
33,"welterweight",35,"left-handed",8,0,2,10,0.9
33,"welterweight",27,"left-handed",9,0,0,9,1
33,"super featherweight",31,"left-handed",22,4,2,28,0.821428571
33,"flyweight",25,"left-handed",13,1,0,14,0.928571429
33,"featherweight",27,"left-handed",20,2,1,23,0.891304348
33,"super bantamweight",24,"left-handed",13,1,1,15,0.9
33,"super bantamweight",30,"left-handed",13,4,2,19,0.736842105
33,"super bantamweight",27,"left-handed",12,0,0,12,1
33,"bantamweight",19,"left-handed",11,0,0,11,1
32,"welterweight",31,"left-handed",30,8,0,38,0.789473684
32,"super lightweight",27,"left-handed",14,0,1,15,0.966666667
32,"super featherweight",27,"left-handed",11,2,0,13,0.846153846
32,"lightweight",27,"left-handed",16,0,0,16,1
32,"super featherweight",30,"left-handed",15,1,1,17,0.911764706
32,"flyweight",24,"left-handed",21,1,2,24,0.916666667
32,"lightweight",21,"left-handed",13,1,0,14,0.928571429
32,"middleweight",28,"left-handed",15,2,1,18,0.861111111
32,"light heavyweight",30,"left-handed",21,8,3,32,0.703125
32,"featherweight",29,"left-handed",12,2,1,15,0.833333333
31,"middleweight",27,"left-handed",13,0,0,13,1
31,"super lightweight",26,"left-handed",30,6,5,41,0.792682927
31,"flyweight",30,"left-handed",14,7,1,22,0.659090909
31,"super featherweight",33,"left-handed",17,2,0,19,0.894736842
31,"welterweight",31,"left-handed",25,4,2,31,0.838709677
31,"featherweight",28,"left-handed",16,4,1,21,0.785714286
31,"super lightweight",26,"left-handed",16,3,0,19,0.842105263
31,"cruiserweight",34,"left-handed",9,1,1,11,0.863636364
31,"super middleweight",25,"left-handed",4,0,0,4,1
30,"super bantamweight",27,"left-handed",17,9,3,29,0.637931034
30,"bantamweight",31,"left-handed",33,7,1,41,0.817073171
30,"super middleweight",26,"left-handed",11,0,0,11,1
30,"featherweight",32,"left-handed",16,9,2,27,0.62962963
30,"flyweight",27,"left-handed",22,10,0,32,0.6875
30,"heavyweight",28,"left-handed",13,0,0,13,1
30,"featherweight",20,"left-handed",13,5,0,18,0.722222222
30,"super bantamweight",29,"left-handed",24,5,0,29,0.827586207
30,"lightweight",21,"left-handed",19,1,2,22,0.909090909
30,"welterweight",27,"left-handed",5,0,0,5,1
30,"featherweight",22,"left-handed",9,1,1,11,0.863636364
30,"middleweight",28,"left-handed",16,7,0,23,0.695652174
30,"super featherweight",25,"left-handed",14,0,1,15,0.966666667
30,"super flyweight",24,"left-handed",12,1,1,14,0.892857143
30,"middleweight",28,"left-handed",15,0,1,16,0.96875
30,"featherweight",28,"left-handed",12,1,2,15,0.866666667
30,"middleweight",24,"left-handed",14,1,2,17,0.882352941
30,"super featherweight",24,"left-handed",15,0,0,15,1
29,"super featherweight",28,"left-handed",18,4,2,24,0.791666667
29,"super featherweight",32,"left-handed",11,1,3,15,0.833333333
29,"super welterweight",29,"left-handed",10,3,0,13,0.769230769
29,"super flyweight",30,"left-handed",43,10,2,55,0.8
29,"welterweight",28,"left-handed",21,1,1,23,0.934782609
29,"middleweight",26,"left-handed",13,0,0,13,1
29,"welterweight",23,"left-handed",10,3,1,14,0.75
29,"super welterweight",28,"left-handed",9,6,2,17,0.588235294
29,"flyweight",23,"left-handed",6,1,0,7,0.857142857
28,"middleweight",31,"left-handed",8,0,1,9,0.944444444
28,"light heavyweight",24,"left-handed",8,0,0,8,1
28,"super lightweight",24,"left-handed",5,1,0,6,0.833333333
28,"flyweight",25,"left-handed",10,0,0,10,1
28,"flyweight",42,"left-handed",41,17,4,62,0.693548387
28,"featherweight",23,"left-handed",8,0,0,8,1
28,"super lightweight",36,"left-handed",17,0,0,17,1
28,"bantamweight",33,"left-handed",69,2,1,72,0.965277778
28,"super featherweight",28,"left-handed",17,3,0,20,0.85
28,"heavyweight",29,"left-handed",13,0,0,13,1
28,"flyweight",22,"left-handed",11,4,0,15,0.733333333
28,"super middleweight",38,"left-handed",33,9,0,42,0.785714286
28,"bantamweight",31,"left-handed",17,12,1,30,0.583333333
28,"heavyweight",31,"left-handed",17,0,1,18,0.972222222
28,"welterweight",27,"left-handed",14,1,0,15,0.933333333
27,"featherweight",30,"left-handed",27,4,1,32,0.859375
27,"welterweight",30,"left-handed",15,0,0,15,1
27,"heavyweight",30,"left-handed",20,2,0,22,0.909090909
27,"bantamweight",26,"left-handed",26,12,2,40,0.675
27,"cruiserweight",NA,"left-handed",8,0,0,8,1
27,"lightweight",29,"left-handed",9,0,0,9,1
27,"lightweight",22,"left-handed",7,0,0,7,1
27,"super welterweight",26,"left-handed",7,0,0,7,1
27,"bantamweight",26,"left-handed",15,7,1,23,0.673913043
27,"flyweight",21,"left-handed",8,1,1,10,0.85
27,"heavyweight",28,"left-handed",14,0,0,14,1
27,"super welterweight",20,"left-handed",13,0,0,13,1
27,"super flyweight",32,"left-handed",10,4,0,14,0.714285714
27,"super middleweight",44,"left-handed",40,9,0,49,0.816326531
27,"light heavyweight",34,"left-handed",15,2,0,17,0.882352941
27,"super featherweight",26,"left-handed",9,0,0,9,1
26,"lightweight",31,"left-handed",10,8,0,18,0.555555556
26,"light heavyweight",26,"left-handed",14,0,0,14,1
26,"welterweight",24,"left-handed",9,1,2,12,0.833333333
26,"featherweight",27,"left-handed",14,0,0,14,1
26,"lightweight",35,"left-handed",45,4,1,50,0.91
25,"bantamweight",30,"left-handed",6,1,0,7,0.857142857
25,"super welterweight",26,"left-handed",12,1,0,13,0.923076923
25,"lightweight",23,"left-handed",9,1,0,10,0.9
25,"super bantamweight",29,"left-handed",22,2,1,25,0.9
25,"lightweight",22,"left-handed",11,0,0,11,1
25,"super featherweight",23,"left-handed",15,5,0,20,0.75
25,"super lightweight",24,"left-handed",14,0,0,14,1
25,"lightweight",29,"left-handed",36,2,1,39,0.935897436
25,"super middleweight",27,"left-handed",15,7,1,23,0.673913043
25,"bantamweight",23,"left-handed",16,1,0,17,0.941176471
25,"super bantamweight",29,"left-handed",21,4,0,25,0.84
25,"welterweight",34,"left-handed",13,0,0,13,1
25,"lightweight",23,"left-handed",14,2,0,16,0.875
24,"super lightweight",23,"left-handed",23,10,0,33,0.696969697
24,"featherweight",23,"left-handed",10,1,0,11,0.909090909
24,"super lightweight",29,"left-handed",20,4,1,25,0.82
24,"flyweight",33,"left-handed",8,9,1,18,0.472222222
24,"super lightweight",28,"left-handed",13,1,0,14,0.928571429
24,"light heavyweight",36,"left-handed",17,4,1,22,0.795454545
24,"light flyweight",22,"left-handed",9,0,1,10,0.95
24,"super welterweight",31,"left-handed",16,5,0,21,0.761904762
24,"heavyweight",24,"left-handed",4,0,0,4,1
24,"super featherweight",22,"left-handed",12,0,0,12,1
24,"super bantamweight",22,"left-handed",14,0,1,15,0.966666667
24,"lightweight",23,"left-handed",16,1,0,17,0.941176471
24,"super featherweight",33,"left-handed",9,1,0,10,0.9
24,"middleweight",33,"left-handed",17,3,1,21,0.833333333
24,"lightweight",24,"left-handed",12,4,1,17,0.735294118
24,"middleweight",23,"left-handed",11,0,1,12,0.958333333
24,"lightweight",33,"left-handed",12,2,1,15,0.833333333
24,"super lightweight",24,"left-handed",12,5,0,17,0.705882353
24,"welterweight",32,"left-handed",10,6,0,16,0.625
24,"minimumweight",24,"left-handed",17,2,0,19,0.894736842
24,"welterweight",29,"left-handed",9,0,0,9,1
24,"super welterweight",23,"left-handed",10,2,0,12,0.833333333
23,"light heavyweight",35,"left-handed",11,3,1,15,0.766666667
23,"welterweight",33,"left-handed",28,8,1,37,0.77027027
23,"lightweight",25,"left-handed",16,4,1,21,0.785714286
23,"super bantamweight",38,"left-handed",39,3,0,42,0.928571429
23,"cruiserweight",29,"left-handed",11,0,0,11,1
23,"lightweight",22,"left-handed",7,1,1,9,0.833333333
23,"super bantamweight",24,"left-handed",7,0,0,7,1
23,"super welterweight",19,"left-handed",8,0,0,8,1
23,"bantamweight",20,"left-handed",7,0,0,7,1
23,"light heavyweight",33,"left-handed",21,0,1,22,0.977272727
23,"super welterweight",29,"left-handed",13,1,0,14,0.928571429
23,"bantamweight",27,"left-handed",13,4,1,18,0.75
23,"super lightweight",23,"left-handed",9,0,0,9,1
23,"super lightweight",27,"left-handed",9,0,0,9,1
23,"cruiserweight",41,"left-handed",25,9,0,34,0.735294118
23,"welterweight",31,"left-handed",15,3,1,19,0.815789474
23,"super bantamweight",36,"left-handed",15,7,1,23,0.673913043
23,"super bantamweight",30,"left-handed",9,3,0,12,0.75
23,"super lightweight",28,"left-handed",7,4,1,12,0.625
23,"welterweight",29,"left-handed",16,2,0,18,0.888888889
23,"super lightweight",28,"left-handed",7,1,0,8,0.875
23,"lightweight",20,"left-handed",7,0,0,7,1
23,"featherweight",26,"left-handed",14,5,0,19,0.736842105
23,"featherweight",25,"left-handed",8,1,1,10,0.85
22,"featherweight",23,"left-handed",8,0,1,9,0.944444444
22,"super middleweight",30,"left-handed",11,1,0,12,0.916666667
22,"welterweight",28,"left-handed",10,3,1,14,0.75
22,"welterweight",30,"left-handed",7,2,0,9,0.777777778
22,"light flyweight",34,"left-handed",27,6,1,34,0.808823529
22,"super middleweight",28,"left-handed",13,0,0,13,1
22,"minimumweight",22,"left-handed",11,1,0,12,0.916666667
22,"bantamweight",30,"left-handed",10,1,0,11,0.909090909
22,"super flyweight",30,"left-handed",11,3,2,16,0.75
22,"middleweight",33,"left-handed",16,5,0,21,0.761904762
22,"super lightweight",28,"left-handed",14,1,1,16,0.90625
22,"lightweight",21,"left-handed",11,0,0,11,1
22,"super featherweight",23,"left-handed",8,3,0,11,0.727272727
22,"super bantamweight",26,"left-handed",9,2,0,11,0.818181818
22,"light flyweight",18,"left-handed",8,0,0,8,1
22,"lightweight",24,"left-handed",12,6,1,19,0.657894737
22,"light flyweight",30,"left-handed",11,2,2,15,0.8
22,"middleweight",33,"left-handed",7,0,0,7,1
22,"light heavyweight",31,"left-handed",14,0,0,14,1
22,"super flyweight",21,"left-handed",14,0,0,14,1
22,"bantamweight",24,"left-handed",5,0,0,5,1
22,"super bantamweight",28,"left-handed",17,1,0,18,0.944444444
22,"super bantamweight",29,"left-handed",13,13,0,26,0.5
22,"lightweight",25,"left-handed",7,1,0,8,0.875
22,"flyweight",20,"left-handed",14,4,3,21,0.738095238
22,"middleweight",32,"left-handed",15,2,0,17,0.882352941
22,"featherweight",28,"left-handed",7,0,0,7,1
22,"minimumweight",21,"left-handed",13,4,1,18,0.75
22,"super lightweight",20,"left-handed",13,1,1,15,0.9
22,"featherweight",22,"left-handed",12,9,2,23,0.565217391
21,"super flyweight",25,"left-handed",20,6,5,31,0.725806452
21,"light flyweight",25,"left-handed",25,10,4,39,0.692307692
21,"super bantamweight",26,"left-handed",11,1,1,13,0.884615385
21,"super welterweight",32,"left-handed",12,0,0,12,1
21,"super featherweight",21,"left-handed",9,1,0,10,0.9
21,"middleweight",34,"left-handed",27,4,1,32,0.859375
21,"featherweight",26,"left-handed",13,0,0,13,1
21,"middleweight",24,"left-handed",8,0,0,8,1
21,"lightweight",25,"left-handed",16,3,3,22,0.795454545
21,"lightweight",22,"left-handed",10,0,0,10,1
21,"lightweight",25,"left-handed",19,0,0,19,1
21,"bantamweight",29,"left-handed",29,6,6,41,0.780487805
21,"super featherweight",28,"left-handed",14,2,0,16,0.875
21,"super welterweight",33,"left-handed",6,0,0,6,1
21,"middleweight",32,"left-handed",6,1,1,8,0.8125
21,"super welterweight",29,"left-handed",5,0,0,5,1
21,"heavyweight",38,"left-handed",16,2,0,18,0.888888889
21,"light heavyweight",31,"left-handed",7,1,0,8,0.875
21,"lightweight",33,"left-handed",16,4,0,20,0.8
21,"welterweight",31,"left-handed",14,2,0,16,0.875
20,"cruiserweight",36,"left-handed",16,6,3,25,0.7
20,"lightweight",27,"left-handed",8,1,0,9,0.888888889
20,"super flyweight",29,"left-handed",12,5,3,20,0.675
20,"flyweight",19,"left-handed",9,0,0,9,1
20,"heavyweight",34,"left-handed",35,5,1,41,0.865853659
20,"super middleweight",25,"left-handed",7,0,0,7,1
20,"super flyweight",22,"left-handed",8,1,1,10,0.85
20,"super flyweight",24,"left-handed",10,3,0,13,0.769230769
20,"super bantamweight",19,"left-handed",6,0,0,6,1
20,"super welterweight",34,"left-handed",10,2,0,12,0.833333333
20,"super lightweight",35,"left-handed",13,4,1,18,0.75
20,"super welterweight",33,"left-handed",13,5,0,18,0.722222222
20,"super flyweight",24,"left-handed",6,3,3,12,0.625
20,"middleweight",34,"left-handed",19,3,0,22,0.863636364
20,"super bantamweight",27,"left-handed",12,4,2,18,0.722222222
20,"super lightweight",33,"left-handed",6,1,1,8,0.8125
20,"cruiserweight",35,"left-handed",12,2,0,14,0.857142857
20,"welterweight",28,"left-handed",9,1,0,10,0.9
20,"flyweight",23,"left-handed",14,4,0,18,0.777777778
19,"flyweight",21,"left-handed",6,2,1,9,0.722222222
19,"lightweight",28,"left-handed",9,5,0,14,0.642857143
19,"featherweight",20,"left-handed",7,0,0,7,1
19,"super bantamweight",26,"left-handed",14,2,3,19,0.815789474
19,"super featherweight",27,"left-handed",7,4,0,11,0.636363636
19,"super lightweight",21,"left-handed",7,0,0,7,1
19,"bantamweight",23,"left-handed",9,5,1,15,0.633333333
19,"middleweight",27,"left-handed",10,1,2,13,0.846153846
19,"minimumweight",NA,"left-handed",10,4,1,15,0.7
19,"super featherweight",26,"left-handed",12,0,1,13,0.961538462
19,"welterweight",23,"left-handed",20,3,0,23,0.869565217
19,"super lightweight",44,"left-handed",51,32,1,84,0.613095238
19,"middleweight",35,"left-handed",22,11,3,36,0.652777778
19,"light flyweight",NA,"left-handed",16,6,3,25,0.7
19,"super lightweight",28,"left-handed",16,7,1,24,0.6875
19,"super middleweight",26,"left-handed",8,0,0,8,1
19,"light flyweight",23,"left-handed",15,0,0,15,1
19,"middleweight",26,"left-handed",12,3,0,15,0.8
19,"cruiserweight",45,"left-handed",32,3,0,35,0.914285714
19,"super bantamweight",29,"left-handed",9,0,0,9,1
19,"super bantamweight",24,"left-handed",12,4,0,16,0.75
19,"light heavyweight",31,"left-handed",8,3,1,12,0.708333333
19,"super bantamweight",37,"left-handed",19,4,0,23,0.826086957
19,"light heavyweight",31,"left-handed",12,1,0,13,0.923076923
19,"light heavyweight",29,"left-handed",5,0,0,5,1
19,"minimumweight",19,"left-handed",8,3,0,11,0.727272727
19,"flyweight",34,"left-handed",20,18,2,40,0.525
18,"light flyweight",25,"left-handed",12,4,3,19,0.710526316
18,"lightweight",25,"left-handed",5,2,2,9,0.666666667
18,"bantamweight",32,"left-handed",19,7,1,27,0.722222222
18,"super welterweight",35,"left-handed",20,7,6,33,0.696969697
18,"featherweight",NA,"left-handed",13,7,1,21,0.642857143
18,"super featherweight",21,"left-handed",7,1,0,8,0.875
18,"bantamweight",25,"left-handed",15,5,4,24,0.708333333
18,"super welterweight",25,"left-handed",8,1,0,9,0.888888889
18,"super lightweight",32,"left-handed",11,2,2,15,0.8
18,"heavyweight",32,"left-handed",6,3,0,9,0.666666667
18,"light heavyweight",31,"left-handed",17,5,0,22,0.772727273
18,"super welterweight",30,"left-handed",21,6,0,27,0.777777778
18,"super flyweight",21,"left-handed",8,4,1,13,0.653846154
18,"super middleweight",30,"left-handed",8,0,0,8,1
18,"featherweight",25,"left-handed",15,6,2,23,0.695652174
18,"super featherweight",22,"left-handed",6,0,0,6,1
18,"super featherweight",26,"left-handed",6,0,0,6,1
18,"super lightweight",30,"left-handed",13,1,1,15,0.9
18,"welterweight",24,"left-handed",9,8,5,22,0.522727273
18,"super welterweight",26,"left-handed",9,1,0,10,0.9
18,"middleweight",36,"left-handed",19,0,0,19,1
18,"super flyweight",29,"left-handed",10,6,1,17,0.617647059
18,"bantamweight",21,"left-handed",6,0,3,9,0.833333333
18,"super flyweight",23,"left-handed",11,5,1,17,0.676470588
18,"flyweight",24,"left-handed",8,14,6,28,0.392857143
18,"super middleweight",25,"left-handed",13,0,0,13,1
18,"middleweight",41,"left-handed",50,9,5,64,0.8203125
18,"super middleweight",36,"left-handed",27,3,1,31,0.887096774
18,"heavyweight",28,"left-handed",15,2,1,18,0.861111111
18,"lightweight",21,"left-handed",8,3,0,11,0.727272727
18,"light heavyweight",24,"left-handed",13,2,0,15,0.866666667
18,"welterweight",28,"left-handed",9,1,1,11,0.863636364
18,"flyweight",28,"left-handed",11,26,2,39,0.307692308
17,"light heavyweight",32,"left-handed",14,2,1,17,0.852941176
17,"heavyweight",35,"left-handed",8,1,1,10,0.85
17,"featherweight",22,"left-handed",18,2,0,20,0.9
17,"super bantamweight",41,"left-handed",91,5,2,98,0.93877551
17,"super flyweight",29,"left-handed",15,17,0,32,0.46875
17,"super welterweight",29,"left-handed",9,1,0,10,0.9
17,"flyweight",23,"left-handed",11,0,0,11,1
17,"welterweight",28,"left-handed",5,1,1,7,0.785714286
17,"super middleweight",29,"left-handed",12,1,0,13,0.923076923
17,"light flyweight",25,"left-handed",9,5,2,16,0.625
17,"super lightweight",40,"left-handed",26,8,1,35,0.757142857
17,"super welterweight",27,"left-handed",8,0,0,8,1
17,"welterweight",24,"left-handed",10,5,0,15,0.666666667
17,"super bantamweight",31,"left-handed",11,5,1,17,0.676470588
17,"middleweight",25,"left-handed",3,1,0,4,0.75
17,"middleweight",38,"left-handed",17,3,0,20,0.85
17,"heavyweight",33,"left-handed",22,5,1,28,0.803571429
17,"flyweight",25,"left-handed",13,2,0,15,0.866666667
17,"lightweight",32,"left-handed",16,1,1,18,0.916666667
17,"featherweight",21,"left-handed",8,0,1,9,0.944444444
17,"super featherweight",26,"left-handed",11,0,1,12,0.958333333
17,"super lightweight",26,"left-handed",5,0,0,5,1
17,"welterweight",31,"left-handed",16,9,1,26,0.634615385
17,"flyweight",22,"left-handed",8,0,1,9,0.944444444
17,"super lightweight",23,"left-handed",8,0,0,8,1
17,"super lightweight",32,"left-handed",14,0,2,16,0.9375
17,"super bantamweight",25,"left-handed",8,3,1,12,0.708333333
17,"super lightweight",21,"left-handed",8,0,1,9,0.944444444
17,"featherweight",22,"left-handed",8,0,1,9,0.944444444
17,"super middleweight",38,"left-handed",25,8,1,34,0.75
16,"super middleweight",29,"left-handed",5,0,1,6,0.916666667
16,"heavyweight",33,"left-handed",11,2,1,14,0.821428571
16,"super middleweight",23,"left-handed",11,0,1,12,0.958333333
16,"super welterweight",20,"left-handed",4,0,0,4,1
16,"super welterweight",26,"left-handed",11,2,1,14,0.821428571
16,"super welterweight",24,"left-handed",11,2,1,14,0.821428571
16,"super bantamweight",26,"left-handed",10,7,1,18,0.583333333
16,"super middleweight",38,"left-handed",18,6,0,24,0.75
16,"super featherweight",31,"left-handed",27,8,1,36,0.763888889
16,"super bantamweight",37,"left-handed",24,5,0,29,0.827586207
16,"welterweight",38,"left-handed",26,8,3,37,0.743243243
16,"featherweight",25,"left-handed",10,1,1,12,0.875
16,"super flyweight",32,"left-handed",13,7,2,22,0.636363636
16,"bantamweight",31,"left-handed",24,3,0,27,0.888888889
16,"flyweight",23,"left-handed",5,1,2,8,0.75
16,"super lightweight",35,"left-handed",35,9,3,47,0.776595745
16,"cruiserweight",27,"left-handed",8,0,0,8,1
16,"super bantamweight",23,"left-handed",6,0,0,6,1
16,"light heavyweight",32,"left-handed",13,5,2,20,0.7
16,"super middleweight",30,"left-handed",33,7,2,42,0.80952381
16,"super lightweight",28,"left-handed",12,5,4,21,0.666666667
16,"lightweight",33,"left-handed",7,5,0,12,0.583333333
16,"welterweight",25,"left-handed",10,4,0,14,0.714285714
16,"featherweight",25,"left-handed",23,10,2,35,0.685714286
15,"super featherweight",37,"left-handed",21,6,0,27,0.777777778
15,"super featherweight",35,"left-handed",11,1,0,12,0.916666667
15,"heavyweight",28,"left-handed",6,0,0,6,1
15,"welterweight",23,"left-handed",6,0,0,6,1
15,"super lightweight",34,"left-handed",16,4,2,22,0.772727273
15,"minimumweight",32,"left-handed",8,3,0,11,0.727272727
15,"lightweight",24,"left-handed",3,0,0,3,1
15,"super lightweight",32,"left-handed",15,0,0,15,1
15,"super bantamweight",33,"left-handed",15,7,0,22,0.681818182
15,"flyweight",20,"left-handed",6,0,0,6,1
15,"bantamweight",29,"left-handed",11,4,2,17,0.705882353
15,"middleweight",22,"left-handed",21,1,0,22,0.954545455
15,"super featherweight",24,"left-handed",16,5,0,21,0.761904762
15,"welterweight",28,"left-handed",9,0,1,10,0.95
13,"super flyweight",26,"left-handed",12,7,3,22,0.613636364
13,"super featherweight",26,"left-handed",8,2,1,11,0.772727273
13,"lightweight",19,"left-handed",4,0,1,5,0.9
13,"super welterweight",NA,"left-handed",16,8,0,24,0.666666667
13,"super welterweight",26,"left-handed",9,1,1,11,0.863636364
13,"welterweight",33,"left-handed",12,2,1,15,0.833333333
13,"welterweight",26,"left-handed",8,7,0,15,0.533333333
13,"bantamweight",18,"left-handed",9,1,1,11,0.863636364
13,"welterweight",28,"left-handed",10,4,0,14,0.714285714
13,"middleweight",27,"left-handed",20,5,2,27,0.777777778
13,"heavyweight",31,"left-handed",14,2,1,17,0.852941176
13,"super lightweight",24,"left-handed",4,1,0,5,0.8
13,"super featherweight",NA,"left-handed",6,3,0,9,0.666666667
13,"super welterweight",24,"left-handed",7,0,0,7,1
13,"super lightweight",34,"left-handed",12,9,3,24,0.5625
13,"featherweight",23,"left-handed",9,1,0,10,0.9
13,"bantamweight",34,"left-handed",5,7,4,16,0.4375
13,"welterweight",NA,"left-handed",5,2,0,7,0.714285714
13,"super featherweight",24,"left-handed",9,3,2,14,0.714285714
13,"featherweight",27,"left-handed",10,6,2,18,0.611111111
13,"flyweight",33,"left-handed",8,11,3,22,0.431818182
13,"lightweight",25,"left-handed",6,2,0,8,0.75
13,"super featherweight",29,"left-handed",27,12,4,43,0.674418605
13,"light flyweight",19,"left-handed",5,0,0,5,1
13,"super flyweight",26,"left-handed",9,6,0,15,0.6
13,"light flyweight",23,"left-handed",5,1,0,6,0.833333333
13,"super flyweight",20,"left-handed",5,0,1,6,0.916666667
13,"featherweight",33,"left-handed",31,8,0,39,0.794871795
13,"super lightweight",26,"left-handed",9,3,3,15,0.7
12,"super bantamweight",22,"left-handed",7,0,0,7,1
12,"flyweight",26,"left-handed",32,1,0,33,0.96969697
12,"bantamweight",43,"left-handed",20,15,2,37,0.567567568
12,"light heavyweight",22,"left-handed",6,1,1,8,0.8125
12,"super flyweight",27,"left-handed",18,11,5,34,0.602941176
12,"super welterweight",30,"left-handed",7,5,2,14,0.571428571
12,"super lightweight",26,"left-handed",5,0,0,5,1
12,"super welterweight",23,"left-handed",5,0,0,5,1
12,"super welterweight",40,"left-handed",16,6,0,22,0.727272727
12,"super welterweight",19,"left-handed",4,0,0,4,1
12,"super bantamweight",33,"left-handed",18,18,1,37,0.5
12,"super middleweight",34,"left-handed",15,9,1,25,0.62
12,"heavyweight",23,"left-handed",7,0,0,7,1
12,"super lightweight",23,"left-handed",6,0,0,6,1
12,"middleweight",34,"left-handed",17,6,0,23,0.739130435
12,"middleweight",NA,"left-handed",7,1,0,8,0.875
12,"super lightweight",22,"left-handed",6,2,0,8,0.75
12,"cruiserweight",33,"left-handed",8,1,0,9,0.888888889
12,"middleweight",22,"left-handed",7,0,0,7,1
12,"super lightweight",24,"left-handed",13,3,0,16,0.8125
12,"featherweight",33,"left-handed",9,10,3,22,0.477272727
12,"featherweight",NA,"left-handed",11,12,2,25,0.48
12,"lightweight",30,"left-handed",9,9,2,20,0.5
12,"welterweight",NA,"left-handed",8,3,2,13,0.692307692
12,"light heavyweight",28,"left-handed",20,3,0,23,0.869565217
12,"featherweight",23,"left-handed",5,1,0,6,0.833333333
12,"super featherweight",29,"left-handed",11,7,1,19,0.605263158
12,"super lightweight",35,"left-handed",6,0,0,6,1
12,"super welterweight",27,"left-handed",10,4,0,14,0.714285714
12,"lightweight",22,"left-handed",8,0,0,8,1
12,"lightweight",22,"left-handed",7,1,0,8,0.875
12,"heavyweight",34,"left-handed",9,0,0,9,1
12,"cruiserweight",33,"left-handed",5,3,0,8,0.625
12,"super lightweight",28,"left-handed",9,2,0,11,0.818181818
12,"super lightweight",28,"left-handed",19,6,0,25,0.76
12,"super welterweight",29,"left-handed",12,2,1,15,0.833333333
12,"super welterweight",26,"left-handed",19,8,0,27,0.703703704
12,"super welterweight",21,"left-handed",5,0,0,5,1
12,"super bantamweight",26,"left-handed",16,9,1,26,0.634615385
12,"super bantamweight",25,"left-handed",4,0,0,4,1
12,"light flyweight",21,"left-handed",8,1,1,10,0.85
12,"super lightweight",34,"left-handed",23,20,2,45,0.533333333
12,"super bantamweight",28,"left-handed",5,6,0,11,0.454545455
12,"super middleweight",31,"left-handed",26,17,0,43,0.604651163
12,"middleweight",19,"left-handed",5,0,1,6,0.916666667
12,"welterweight",32,"left-handed",21,10,2,33,0.666666667
12,"bantamweight",38,"left-handed",22,6,3,31,0.758064516
12,"welterweight",29,"left-handed",9,8,2,19,0.526315789
12,"featherweight",24,"left-handed",7,5,1,13,0.576923077
12,"lightweight",24,"left-handed",18,1,1,20,0.925
11,"super flyweight",24,"left-handed",3,2,7,12,0.541666667
11,"featherweight",24,"left-handed",5,2,1,8,0.6875
11,"super welterweight",29,"left-handed",7,4,0,11,0.636363636
11,"super middleweight",33,"left-handed",6,1,2,9,0.777777778
11,"lightweight",37,"left-handed",38,18,3,59,0.669491525
11,"lightweight",20,"left-handed",6,0,0,6,1
11,"super lightweight",25,"left-handed",5,0,0,5,1
11,"super welterweight",28,"left-handed",8,1,1,10,0.85
11,"super middleweight",28,"left-handed",10,1,0,11,0.909090909
11,"featherweight",23,"left-handed",11,1,2,14,0.857142857
11,"lightweight",35,"left-handed",9,12,1,22,0.431818182
11,"welterweight",36,"left-handed",13,10,2,25,0.56
11,"light flyweight",26,"left-handed",7,3,3,13,0.653846154
11,"super bantamweight",23,"left-handed",2,0,0,2,1
11,"light flyweight",24,"left-handed",1,1,0,2,0.5
11,"super flyweight",35,"left-handed",6,8,3,17,0.441176471
11,"super lightweight",30,"left-handed",16,5,1,22,0.75
11,"super featherweight",21,"left-handed",6,0,0,6,1
11,"cruiserweight",23,"left-handed",6,0,0,6,1
11,"super lightweight",31,"left-handed",25,10,0,35,0.714285714
11,"super welterweight",29,"left-handed",14,2,1,17,0.852941176
11,"lightweight",26,"left-handed",12,8,0,20,0.6
11,"flyweight",21,"left-handed",6,1,2,9,0.777777778
11,"middleweight",32,"left-handed",14,3,1,18,0.805555556
11,"super featherweight",42,"left-handed",20,1,1,22,0.931818182
11,"super featherweight",21,"left-handed",4,0,0,4,1
11,"featherweight",22,"left-handed",11,6,0,17,0.647058824
11,"lightweight",40,"left-handed",27,13,0,40,0.675
11,"middleweight",34,"left-handed",13,6,0,19,0.684210526
11,"super bantamweight",21,"left-handed",5,1,1,7,0.785714286
11,"super bantamweight",32,"left-handed",20,14,3,37,0.581081081
11,"heavyweight",25,"left-handed",9,4,1,14,0.678571429
11,"featherweight",23,"left-handed",5,0,0,5,1
11,"minimumweight",27,"left-handed",6,27,2,35,0.2
11,"featherweight",23,"left-handed",9,4,0,13,0.692307692
11,"super middleweight",33,"left-handed",21,15,1,37,0.581081081
11,"cruiserweight",29,"left-handed",5,0,0,5,1
11,"cruiserweight",29,"left-handed",4,0,0,4,1
11,"super welterweight",36,"left-handed",26,4,2,32,0.84375
11,"light heavyweight",27,"left-handed",10,7,0,17,0.588235294
11,"lightweight",28,"left-handed",13,6,0,19,0.684210526
11,"lightweight",22,"left-handed",8,8,2,18,0.5
11,"bantamweight",27,"left-handed",8,10,1,19,0.447368421
11,"super flyweight",18,"left-handed",6,0,2,8,0.875
11,"featherweight",22,"left-handed",4,1,1,6,0.75
11,"welterweight",25,"left-handed",6,1,0,7,0.857142857
11,"middleweight",20,"left-handed",6,1,1,8,0.8125
11,"super lightweight",22,"left-handed",17,1,0,18,0.944444444
11,"super welterweight",26,"left-handed",6,2,0,8,0.75
11,"lightweight",36,"left-handed",17,3,0,20,0.85
11,"super featherweight",37,"left-handed",16,3,1,20,0.825
11,"super middleweight",36,"left-handed",15,8,3,26,0.634615385
11,"cruiserweight",45,"left-handed",13,3,0,16,0.8125
11,"middleweight",28,"left-handed",4,0,0,4,1
11,"super bantamweight",27,"left-handed",9,12,1,22,0.431818182
10,"super featherweight",34,"left-handed",11,2,4,17,0.764705882
10,"featherweight",22,"left-handed",3,1,0,4,0.75
10,"middleweight",30,"left-handed",5,0,0,5,1
10,"heavyweight",29,"left-handed",12,4,0,16,0.75
10,"super middleweight",24,"left-handed",4,13,0,17,0.235294118
10,"welterweight",21,"left-handed",3,0,0,3,1
10,"super lightweight",29,"left-handed",5,0,0,5,1
10,"super lightweight",34,"left-handed",5,5,1,11,0.5
10,"super middleweight",28,"left-handed",5,0,0,5,1
10,"lightweight",20,"left-handed",6,2,2,10,0.7
10,"super featherweight",29,"left-handed",5,2,2,9,0.666666667
10,"super featherweight",37,"left-handed",20,6,0,26,0.769230769
10,"cruiserweight",29,"left-handed",4,0,0,4,1
10,"flyweight",25,"left-handed",10,8,2,20,0.55
10,"featherweight",26,"left-handed",10,1,0,11,0.909090909
10,"middleweight",36,"left-handed",16,19,2,37,0.459459459
10,"super bantamweight",18,"left-handed",5,0,0,5,1
10,"featherweight",24,"left-handed",4,1,2,7,0.714285714
10,"super lightweight",33,"left-handed",7,1,1,9,0.833333333
10,"super bantamweight",25,"left-handed",5,2,1,8,0.6875
10,"super featherweight",25,"left-handed",9,2,0,11,0.818181818
10,"lightweight",32,"left-handed",9,3,0,12,0.75
10,"heavyweight",45,"left-handed",6,0,0,6,1
10,"middleweight",23,"left-handed",5,0,0,5,1
10,"featherweight",30,"left-handed",9,10,0,19,0.473684211
10,"heavyweight",34,"left-handed",18,11,1,30,0.616666667
10,"super lightweight",40,"left-handed",28,16,1,45,0.633333333
10,"heavyweight",NA,"left-handed",6,0,1,7,0.928571429
10,"welterweight",26,"left-handed",10,3,0,13,0.769230769
10,"light flyweight",18,"left-handed",5,0,2,7,0.857142857
10,"welterweight",30,"left-handed",12,5,2,19,0.684210526
10,"flyweight",28,"left-handed",19,4,1,24,0.8125
10,"lightweight",26,"left-handed",3,0,0,3,1
10,"super lightweight",23,"left-handed",4,0,0,4,1
10,"welterweight",NA,"left-handed",6,5,2,13,0.538461538
10,"super lightweight",37,"left-handed",10,3,2,15,0.733333333
10,"super flyweight",28,"left-handed",11,2,0,13,0.846153846
10,"super featherweight",22,"left-handed",8,1,1,10,0.85
10,"super middleweight",21,"left-handed",2,0,0,2,1
10,"flyweight",27,"left-handed",5,5,0,10,0.5
10,"bantamweight",23,"left-handed",2,0,0,2,1
10,"super flyweight",31,"left-handed",31,11,1,43,0.73255814
10,"super flyweight",NA,"left-handed",6,0,1,7,0.928571429
10,"middleweight",30,"left-handed",16,4,0,20,0.8
10,"featherweight",24,"left-handed",4,0,0,4,1
10,"super featherweight",23,"left-handed",10,11,2,23,0.47826087
10,"super middleweight",37,"left-handed",12,2,2,16,0.8125
10,"super flyweight",30,"left-handed",20,7,3,30,0.716666667
10,"middleweight",39,"left-handed",29,12,1,42,0.702380952
9,"flyweight",22,"left-handed",8,2,1,11,0.772727273
9,"super welterweight",29,"left-handed",5,2,1,8,0.6875
9,"super lightweight",23,"left-handed",10,4,0,14,0.714285714
9,"cruiserweight",NA,"left-handed",6,0,2,8,0.875
9,"middleweight",20,"left-handed",4,1,0,5,0.8
9,"bantamweight",46,"left-handed",26,17,1,44,0.602272727
9,"super featherweight",38,"left-handed",42,18,7,67,0.679104478
9,"light flyweight",21,"left-handed",6,1,0,7,0.857142857
9,"lightweight",28,"left-handed",6,0,2,8,0.875
9,"welterweight",27,"left-handed",6,1,2,9,0.777777778
9,"light heavyweight",30,"left-handed",20,12,1,33,0.621212121
9,"flyweight",NA,"left-handed",20,12,3,35,0.614285714
9,"flyweight",26,"left-handed",4,4,1,9,0.5
9,"super bantamweight",20,"left-handed",7,0,0,7,1
9,"super middleweight",36,"left-handed",32,13,2,47,0.70212766
9,"light flyweight",18,"left-handed",4,0,0,4,1
9,"super middleweight",27,"left-handed",17,9,0,26,0.653846154
9,"lightweight",NA,"left-handed",4,6,0,10,0.4
9,"welterweight",32,"left-handed",13,6,0,19,0.684210526
9,"welterweight",42,"left-handed",14,13,1,28,0.517857143
9,"welterweight",24,"left-handed",9,2,0,11,0.818181818
9,"welterweight",33,"left-handed",8,2,0,10,0.8
9,"bantamweight",22,"left-handed",5,2,0,7,0.714285714
9,"lightweight",25,"left-handed",13,4,0,17,0.764705882
9,"bantamweight",21,"left-handed",3,1,0,4,0.75
9,"middleweight",27,"left-handed",5,1,0,6,0.833333333
9,"light heavyweight",23,"left-handed",3,7,1,11,0.318181818
9,"welterweight",30,"left-handed",7,0,0,7,1
9,"lightweight",30,"left-handed",7,1,0,8,0.875
9,"lightweight",23,"left-handed",5,2,0,7,0.714285714
9,"lightweight",24,"left-handed",9,3,0,12,0.75
9,"super bantamweight",26,"left-handed",9,17,4,30,0.366666667
9,"super welterweight",38,"left-handed",27,17,1,45,0.611111111
9,"super featherweight",NA,"left-handed",17,6,2,25,0.72
9,"light heavyweight",NA,"left-handed",4,1,0,5,0.8
9,"super welterweight",25,"left-handed",5,0,0,5,1
9,"middleweight",27,"left-handed",8,2,0,10,0.8
9,"lightweight",29,"left-handed",4,0,0,4,1
9,"super flyweight",25,"left-handed",8,4,2,14,0.642857143
9,"bantamweight",NA,"left-handed",6,6,3,15,0.5
9,"super bantamweight",38,"left-handed",26,10,1,37,0.716216216
9,"super bantamweight",22,"left-handed",2,0,0,2,1
9,"welterweight",26,"left-handed",5,1,0,6,0.833333333
9,"super featherweight",30,"left-handed",3,1,0,4,0.75
9,"super lightweight",34,"left-handed",14,4,1,19,0.763157895
9,"heavyweight",27,"left-handed",8,3,0,11,0.727272727
9,"bantamweight",NA,"left-handed",11,8,1,20,0.575
9,"welterweight",33,"left-handed",12,7,1,20,0.625
9,"super welterweight",30,"left-handed",2,2,2,6,0.5
9,"cruiserweight",NA,"left-handed",12,28,7,47,0.329787234
8,"super bantamweight",24,"left-handed",6,4,0,10,0.6
8,"welterweight",26,"left-handed",4,0,0,4,1
8,"lightweight",29,"left-handed",10,3,0,13,0.769230769
8,"super featherweight",22,"left-handed",2,0,0,2,1
8,"bantamweight",NA,"left-handed",17,14,4,35,0.542857143
8,"super lightweight",32,"left-handed",24,16,3,43,0.593023256
8,"super featherweight",24,"left-handed",3,0,0,3,1
8,"super welterweight",38,"left-handed",25,39,4,68,0.397058824
8,"super welterweight",27,"left-handed",4,0,1,5,0.9
8,"lightweight",24,"left-handed",3,3,0,6,0.5
8,"super featherweight",33,"left-handed",19,15,0,34,0.558823529
8,"bantamweight",18,"left-handed",6,0,0,6,1
8,"super middleweight",NA,"left-handed",5,0,0,5,1
8,"welterweight",37,"left-handed",22,43,4,69,0.347826087
8,"super bantamweight",32,"left-handed",18,23,4,45,0.444444444
8,"welterweight",22,"left-handed",3,0,0,3,1
8,"lightweight",29,"left-handed",9,7,1,17,0.558823529
8,"super flyweight",31,"left-handed",7,1,1,9,0.833333333
8,"flyweight",20,"left-handed",7,1,2,10,0.8
8,"bantamweight",23,"left-handed",4,1,0,5,0.8
8,"flyweight",23,"left-handed",2,0,0,2,1
8,"light heavyweight",28,"left-handed",4,0,0,4,1
8,"super featherweight",28,"left-handed",7,8,0,15,0.466666667
8,"minimumweight",23,"left-handed",0,1,0,1,0
8,"super flyweight",23,"left-handed",6,6,0,12,0.5
8,"super featherweight",36,"left-handed",15,13,1,29,0.534482759
8,"heavyweight",33,"left-handed",8,2,1,11,0.772727273
8,"super lightweight",20,"left-handed",6,4,1,11,0.590909091
8,"flyweight",28,"left-handed",8,16,1,25,0.34
8,"heavyweight",29,"left-handed",13,25,3,41,0.353658537
8,"middleweight",40,"left-handed",31,23,4,58,0.568965517
8,"super welterweight",33,"left-handed",29,8,0,37,0.783783784
8,"flyweight",19,"left-handed",5,0,0,5,1
8,"super welterweight",31,"left-handed",20,4,0,24,0.833333333
8,"super lightweight",24,"left-handed",3,0,0,3,1
8,"lightweight",28,"left-handed",6,4,0,10,0.6
8,"super bantamweight",29,"left-handed",8,6,4,18,0.555555556
8,"welterweight",32,"left-handed",12,9,1,22,0.568181818
8,"flyweight",23,"left-handed",5,6,3,14,0.464285714
8,"light heavyweight",30,"left-handed",11,7,1,19,0.605263158
8,"light flyweight",23,"left-handed",6,2,0,8,0.75
8,"middleweight",25,"left-handed",6,3,0,9,0.666666667
8,"super flyweight",33,"left-handed",6,4,0,10,0.6
8,"heavyweight",24,"left-handed",3,0,0,3,1
8,"featherweight",NA,"left-handed",3,0,1,4,0.875
8,"super middleweight",35,"left-handed",4,1,2,7,0.714285714
8,"heavyweight",33,"left-handed",9,4,3,16,0.65625
8,"super flyweight",23,"left-handed",3,0,0,3,1
8,"lightweight",23,"left-handed",5,0,0,5,1
8,"bantamweight",22,"left-handed",8,5,0,13,0.615384615
8,"cruiserweight",21,"left-handed",4,0,0,4,1
8,"flyweight",29,"left-handed",4,1,0,5,0.8
8,"super lightweight",37,"left-handed",26,13,0,39,0.666666667
8,"light flyweight",21,"left-handed",3,0,0,3,1
8,"cruiserweight",30,"left-handed",4,3,1,8,0.5625
7,"heavyweight",41,"left-handed",5,3,1,9,0.611111111
7,"welterweight",29,"left-handed",20,11,1,32,0.640625
7,"welterweight",27,"left-handed",6,3,0,9,0.666666667
7,"super welterweight",33,"left-handed",6,10,2,18,0.388888889
7,"welterweight",20,"left-handed",7,0,0,7,1
7,"light flyweight",19,"left-handed",5,1,1,7,0.785714286
7,"featherweight",22,"left-handed",4,1,0,5,0.8
7,"middleweight",24,"left-handed",9,2,0,11,0.818181818
7,"super featherweight",22,"left-handed",4,1,1,6,0.75
7,"middleweight",27,"left-handed",2,0,0,2,1
7,"super bantamweight",30,"left-handed",8,8,2,18,0.5
7,"super featherweight",27,"left-handed",11,18,4,33,0.393939394
7,"featherweight",25,"left-handed",11,7,0,18,0.611111111
7,"super lightweight",25,"left-handed",19,6,1,26,0.75
7,"super middleweight",40,"left-handed",12,7,0,19,0.631578947
7,"super welterweight",25,"left-handed",3,2,0,5,0.6
7,"welterweight",38,"left-handed",6,4,2,12,0.583333333
7,"super bantamweight",29,"left-handed",5,5,1,11,0.5
7,"lightweight",25,"left-handed",9,11,0,20,0.45
7,"super flyweight",19,"left-handed",12,2,0,14,0.857142857
7,"minimumweight",20,"left-handed",5,2,1,8,0.6875
7,"super bantamweight",26,"left-handed",13,19,4,36,0.416666667
7,"super lightweight",31,"left-handed",11,6,1,18,0.638888889
7,"super bantamweight",20,"left-handed",4,0,0,4,1
7,"cruiserweight",35,"left-handed",7,2,1,10,0.75
7,"cruiserweight",43,"left-handed",50,24,1,75,0.673333333
7,"middleweight",34,"left-handed",36,10,1,47,0.776595745
7,"lightweight",37,"left-handed",16,11,0,27,0.592592593
7,"lightweight",26,"left-handed",6,10,4,20,0.4
7,"super flyweight",31,"left-handed",17,20,1,38,0.460526316
7,"super featherweight",32,"left-handed",28,11,3,42,0.702380952
7,"super welterweight",27,"left-handed",3,0,0,3,1
7,"super bantamweight",25,"left-handed",2,2,0,4,0.5
7,"welterweight",27,"left-handed",10,7,1,18,0.583333333
7,"super lightweight",31,"left-handed",3,3,0,6,0.5
7,"lightweight",32,"left-handed",9,4,0,13,0.692307692
7,"super welterweight",28,"left-handed",4,1,0,5,0.8
7,"featherweight",30,"left-handed",20,11,0,31,0.64516129
7,"super welterweight",NA,"left-handed",3,0,0,3,1
7,"light flyweight",20,"left-handed",3,1,0,4,0.75
7,"lightweight",24,"left-handed",2,1,1,4,0.625
7,"super bantamweight",20,"left-handed",1,0,0,1,1
7,"heavyweight",25,"left-handed",13,7,0,20,0.65
7,"super bantamweight",22,"left-handed",6,8,2,16,0.4375
7,"super welterweight",32,"left-handed",6,29,4,39,0.205128205
7,"super welterweight",30,"left-handed",19,11,0,30,0.633333333
7,"featherweight",25,"left-handed",4,1,2,7,0.714285714
7,"lightweight",38,"left-handed",6,4,0,10,0.6
7,"middleweight",34,"left-handed",11,3,0,14,0.785714286
7,"flyweight",19,"left-handed",6,3,0,9,0.666666667
7,"flyweight",19,"left-handed",4,2,0,6,0.666666667
7,"bantamweight",23,"left-handed",5,4,0,9,0.555555556
7,"super featherweight",29,"left-handed",8,9,2,19,0.473684211
7,"middleweight",20,"left-handed",3,0,1,4,0.875
7,"cruiserweight",33,"left-handed",13,6,0,19,0.684210526
7,"super bantamweight",19,"left-handed",3,0,1,4,0.875
7,"super welterweight",27,"left-handed",2,0,0,2,1
7,"super middleweight",29,"left-handed",5,11,2,18,0.333333333
7,"super featherweight",30,"left-handed",4,3,2,9,0.555555556
7,"light flyweight",NA,"left-handed",6,13,3,22,0.340909091
7,"lightweight",26,"left-handed",6,1,0,7,0.857142857
7,"welterweight",31,"left-handed",9,5,1,15,0.633333333
7,"welterweight",24,"left-handed",11,7,2,20,0.6
7,"lightweight",23,"left-handed",5,3,1,9,0.611111111
7,"lightweight",34,"left-handed",16,3,0,19,0.842105263
6,"super flyweight",24,"left-handed",7,6,2,15,0.533333333
6,"welterweight",32,"left-handed",3,0,0,3,1
6,"welterweight",35,"left-handed",4,3,1,8,0.5625
6,"featherweight",21,"left-handed",5,2,1,8,0.6875
6,"bantamweight",34,"left-handed",8,10,2,20,0.45
6,"bantamweight",29,"left-handed",6,3,0,9,0.666666667
6,"bantamweight",32,"left-handed",6,4,2,12,0.583333333
6,"super welterweight",21,"left-handed",2,0,0,2,1
6,"super lightweight",26,"left-handed",4,4,5,13,0.5
6,"minimumweight",23,"left-handed",6,5,1,12,0.541666667
6,"welterweight",26,"left-handed",24,14,1,39,0.628205128
6,"super lightweight",27,"left-handed",4,0,0,4,1
6,"middleweight",24,"left-handed",7,0,0,7,1
6,"lightweight",22,"left-handed",2,0,0,2,1
6,"super featherweight",33,"left-handed",4,3,0,7,0.571428571
6,"light heavyweight",NA,"left-handed",5,3,2,10,0.6
6,"minimumweight",18,"left-handed",3,1,0,4,0.75
6,"super welterweight",30,"left-handed",7,4,0,11,0.636363636
6,"middleweight",31,"left-handed",13,5,1,19,0.710526316
6,"light flyweight",30,"left-handed",3,5,0,8,0.375
6,"featherweight",24,"left-handed",7,0,0,7,1
6,"flyweight",20,"left-handed",2,1,0,3,0.666666667
6,"light flyweight",18,"left-handed",2,0,2,4,0.75
6,"super welterweight",40,"left-handed",9,35,4,48,0.229166667
6,"lightweight",25,"left-handed",5,4,0,9,0.555555556
6,"super lightweight",29,"left-handed",9,2,1,12,0.791666667
6,"super middleweight",21,"left-handed",4,1,0,5,0.8
6,"super lightweight",37,"left-handed",7,11,1,19,0.394736842
6,"lightweight",NA,"left-handed",2,0,0,2,1
6,"super middleweight",31,"left-handed",6,1,1,8,0.8125
6,"flyweight",25,"left-handed",4,4,0,8,0.5
6,"featherweight",30,"left-handed",8,11,0,19,0.421052632
6,"flyweight",25,"left-handed",3,0,0,3,1
6,"light heavyweight",37,"left-handed",25,16,0,41,0.609756098
6,"middleweight",35,"left-handed",5,2,1,8,0.6875
6,"super lightweight",22,"left-handed",3,2,0,5,0.6
6,"heavyweight",47,"left-handed",14,10,0,24,0.583333333
6,"super welterweight",26,"left-handed",5,0,0,5,1
6,"super welterweight",35,"left-handed",15,12,3,30,0.55
6,"minimumweight",24,"left-handed",4,3,1,8,0.5625
6,"flyweight",22,"left-handed",4,1,1,6,0.75
6,"super welterweight",23,"left-handed",8,5,0,13,0.615384615
6,"middleweight",28,"left-handed",3,3,0,6,0.5
6,"middleweight",23,"left-handed",3,0,0,3,1
6,"super lightweight",24,"left-handed",4,5,0,9,0.444444444
6,"heavyweight",48,"left-handed",9,12,2,23,0.434782609
6,"super featherweight",20,"left-handed",4,0,0,4,1
6,"super middleweight",29,"left-handed",2,0,0,2,1
6,"super middleweight",25,"left-handed",4,1,0,5,0.8
6,"super lightweight",25,"left-handed",9,2,3,14,0.75
6,"flyweight",20,"left-handed",14,8,0,22,0.636363636
6,"lightweight",26,"left-handed",2,1,0,3,0.666666667
6,"super lightweight",21,"left-handed",2,0,0,2,1
6,"cruiserweight",28,"left-handed",4,0,0,4,1
6,"bantamweight",20,"left-handed",3,1,0,4,0.75
6,"welterweight",24,"left-handed",6,6,0,12,0.5
6,"super welterweight",30,"left-handed",4,5,1,10,0.45
6,"super welterweight",33,"left-handed",2,10,0,12,0.166666667
6,"flyweight",31,"left-handed",5,4,1,10,0.55
6,"middleweight",21,"left-handed",2,0,0,2,1
6,"super featherweight",30,"left-handed",25,10,3,38,0.697368421
6,"flyweight",NA,"left-handed",11,11,1,23,0.5
6,"featherweight",NA,"left-handed",3,0,0,3,1
5,"super bantamweight",32,"left-handed",6,8,1,15,0.433333333
5,"lightweight",36,"left-handed",8,18,0,26,0.307692308
5,"flyweight",24,"left-handed",4,4,1,9,0.5
5,"super bantamweight",22,"left-handed",3,0,0,3,1
5,"super flyweight",18,"left-handed",4,0,0,4,1
5,"welterweight",23,"left-handed",6,6,0,12,0.5
5,"super middleweight",26,"left-handed",2,1,0,3,0.666666667
5,"super welterweight",25,"left-handed",5,10,3,18,0.361111111
5,"flyweight",18,"left-handed",2,0,1,3,0.833333333
5,"light heavyweight",29,"left-handed",3,0,0,3,1
5,"super middleweight",30,"left-handed",6,5,1,12,0.541666667
5,"welterweight",32,"left-handed",3,3,0,6,0.5
5,"super middleweight",48,"left-handed",13,14,0,27,0.481481481
5,"super featherweight",31,"left-handed",5,3,0,8,0.625
5,"super bantamweight",28,"left-handed",8,10,0,18,0.444444444
5,"super bantamweight",26,"left-handed",5,7,4,16,0.4375
5,"super bantamweight",20,"left-handed",2,0,0,2,1
5,"super bantamweight",32,"left-handed",3,1,0,4,0.75
5,"featherweight",22,"left-handed",4,1,1,6,0.75
5,"super lightweight",26,"left-handed",3,0,0,3,1
5,"featherweight",42,"left-handed",46,28,1,75,0.62
5,"super featherweight",24,"left-handed",4,0,0,4,1
5,"flyweight",NA,"left-handed",3,1,1,5,0.7
5,"super bantamweight",18,"left-handed",6,1,2,9,0.777777778
5,"lightweight",23,"left-handed",4,7,0,11,0.363636364
5,"lightweight",19,"left-handed",20,9,1,30,0.683333333
5,"heavyweight",42,"left-handed",16,14,0,30,0.533333333
5,"welterweight",24,"left-handed",5,2,0,7,0.714285714
5,"heavyweight",26,"left-handed",3,1,0,4,0.75
5,"super bantamweight",18,"left-handed",1,0,0,1,1
5,"flyweight",25,"left-handed",5,6,1,12,0.458333333
5,"super bantamweight",26,"left-handed",8,9,3,20,0.475
5,"lightweight",32,"left-handed",8,2,0,10,0.8
5,"super welterweight",32,"left-handed",3,1,0,4,0.75
5,"featherweight",26,"left-handed",4,0,0,4,1
5,"lightweight",21,"left-handed",3,0,0,3,1
5,"super lightweight",28,"left-handed",5,5,0,10,0.5
5,"lightweight",25,"left-handed",6,8,1,15,0.433333333
5,"super featherweight",30,"left-handed",4,3,0,7,0.571428571
5,"super lightweight",32,"left-handed",7,11,3,21,0.404761905
5,"featherweight",NA,"left-handed",4,6,1,11,0.409090909
5,"cruiserweight",33,"left-handed",2,0,0,2,1
5,"super featherweight",22,"left-handed",2,0,0,2,1
5,"lightweight",NA,"left-handed",12,4,1,17,0.735294118
5,"flyweight",26,"left-handed",4,0,0,4,1
5,"light heavyweight",26,"left-handed",9,10,0,19,0.473684211
5,"super featherweight",39,"left-handed",11,8,0,19,0.578947368
5,"flyweight",23,"left-handed",10,11,1,22,0.477272727
5,"welterweight",17,"left-handed",1,0,0,1,1
5,"super lightweight",20,"left-handed",1,1,2,4,0.5
5,"super lightweight",26,"left-handed",3,5,0,8,0.375
5,"flyweight",18,"left-handed",2,1,0,3,0.666666667
5,"featherweight",19,"left-handed",3,1,0,4,0.75
5,"bantamweight",30,"left-handed",3,2,2,7,0.571428571
4,"super featherweight",25,"left-handed",2,1,1,4,0.625
4,"featherweight",34,"left-handed",3,5,3,11,0.409090909
4,"super featherweight",26,"left-handed",5,1,0,6,0.833333333
4,"super middleweight",29,"left-handed",4,0,0,4,1
4,"lightweight",32,"left-handed",3,0,1,4,0.875
4,"super bantamweight",24,"left-handed",4,4,1,9,0.5
4,"featherweight",27,"left-handed",2,0,1,3,0.833333333
4,"welterweight",32,"left-handed",2,6,0,8,0.25
4,"super bantamweight",38,"left-handed",22,56,2,80,0.2875
4,"super welterweight",30,"left-handed",5,0,1,6,0.916666667
4,"super middleweight",29,"left-handed",3,2,0,5,0.6
4,"light heavyweight",NA,"left-handed",4,6,0,10,0.4
4,"super lightweight",30,"left-handed",5,3,0,8,0.625
4,"bantamweight",28,"left-handed",10,3,0,13,0.769230769
4,"bantamweight",24,"left-handed",6,5,2,13,0.538461538
4,"super middleweight",27,"left-handed",7,3,0,10,0.7
4,"cruiserweight",34,"left-handed",16,16,4,36,0.5
4,"super flyweight",20,"left-handed",4,2,0,6,0.666666667
4,"super flyweight",23,"left-handed",9,7,0,16,0.5625
4,"light flyweight",30,"left-handed",9,27,1,37,0.256756757
4,"super middleweight",19,"left-handed",7,4,0,11,0.636363636
4,"lightweight",18,"left-handed",1,0,0,1,1
4,"featherweight",28,"left-handed",5,3,0,8,0.625
4,"lightweight",30,"left-handed",6,4,3,13,0.576923077
4,"minimumweight",34,"left-handed",6,5,2,13,0.538461538
4,"cruiserweight",27,"left-handed",8,3,1,12,0.708333333
4,"super lightweight",22,"left-handed",9,4,2,15,0.666666667
4,"super lightweight",34,"left-handed",4,12,1,17,0.264705882
4,"super featherweight",27,"left-handed",8,8,0,16,0.5
4,"heavyweight",39,"left-handed",32,24,2,58,0.568965517
4,"featherweight",27,"left-handed",12,7,0,19,0.631578947
4,"featherweight",37,"left-handed",11,12,1,24,0.479166667
4,"super lightweight",25,"left-handed",2,0,0,2,1
4,"welterweight",32,"left-handed",8,2,0,10,0.8
4,"super lightweight",25,"left-handed",3,1,0,4,0.75
4,"middleweight",33,"left-handed",19,29,4,52,0.403846154
4,"super lightweight",31,"left-handed",1,0,0,1,1
4,"super bantamweight",NA,"left-handed",4,28,2,34,0.147058824
4,"bantamweight",27,"left-handed",8,21,2,31,0.290322581
4,"heavyweight",44,"left-handed",9,10,1,20,0.475
4,"heavyweight",35,"left-handed",2,3,0,5,0.4
4,"super middleweight",27,"left-handed",4,2,0,6,0.666666667
4,"super middleweight",22,"left-handed",4,0,0,4,1
4,"cruiserweight",27,"left-handed",2,0,0,2,1
4,"super lightweight",32,"left-handed",13,19,3,35,0.414285714
4,"welterweight",31,"left-handed",9,14,0,23,0.391304348
4,"super featherweight",30,"left-handed",7,6,1,14,0.535714286
4,"middleweight",NA,"left-handed",4,1,1,6,0.75
4,"light flyweight",25,"left-handed",10,8,1,19,0.552631579
4,"welterweight",27,"left-handed",1,1,0,2,0.5
4,"lightweight",29,"left-handed",16,24,5,45,0.411111111
4,"flyweight",27,"left-handed",2,2,0,4,0.5
4,"",31,"left-handed",4,0,0,4,1
4,"super lightweight",31,"left-handed",12,6,0,18,0.666666667
4,"lightweight",23,"left-handed",3,2,0,5,0.6
4,"super welterweight",40,"left-handed",7,1,0,8,0.875
4,"super bantamweight",31,"left-handed",10,23,1,34,0.308823529
4,"super featherweight",24,"left-handed",3,0,0,3,1
4,"middleweight",33,"left-handed",6,6,2,14,0.5
4,"welterweight",35,"left-handed",5,1,0,6,0.833333333
4,"light flyweight",22,"left-handed",2,1,0,3,0.666666667
4,"super featherweight",22,"left-handed",2,2,0,4,0.5
4,"middleweight",39,"left-handed",17,11,1,29,0.603448276
4,"welterweight",31,"left-handed",7,10,2,19,0.421052632
4,"minimumweight",24,"left-handed",2,1,0,3,0.666666667
4,"lightweight",19,"left-handed",3,1,0,4,0.75
4,"featherweight",23,"left-handed",3,1,1,5,0.7
4,"lightweight",24,"left-handed",4,5,0,9,0.444444444
4,"light heavyweight",31,"left-handed",7,11,1,19,0.394736842
4,"bantamweight",NA,"left-handed",5,5,0,10,0.5
4,"super lightweight",26,"left-handed",3,5,0,8,0.375
4,"super flyweight",31,"left-handed",21,28,4,53,0.433962264
4,"cruiserweight",28,"left-handed",4,5,0,9,0.444444444
4,"super middleweight",30,"left-handed",24,22,0,46,0.52173913
4,"super bantamweight",35,"left-handed",18,22,2,42,0.452380952
4,"super flyweight",NA,"left-handed",8,8,3,19,0.5
3,"lightweight",26,"left-handed",3,12,1,16,0.21875
3,"welterweight",36,"left-handed",1,0,0,1,1
3,"light heavyweight",26,"left-handed",4,5,1,10,0.45
3,"super bantamweight",23,"left-handed",1,0,0,1,1
3,"super bantamweight",18,"left-handed",3,0,0,3,1
3,"super featherweight",24,"left-handed",3,2,0,5,0.6
3,"cruiserweight",28,"left-handed",18,38,7,63,0.341269841
3,"middleweight",23,"left-handed",2,3,0,5,0.4
3,"super flyweight",27,"left-handed",3,14,2,19,0.210526316
3,"super welterweight",33,"left-handed",1,0,1,2,0.75
3,"featherweight",23,"left-handed",1,0,1,2,0.75
3,"cruiserweight",36,"left-handed",6,6,1,13,0.5
3,"super featherweight",42,"left-handed",10,18,1,29,0.362068966
3,"featherweight",NA,"left-handed",2,0,1,3,0.833333333
3,"super featherweight",22,"left-handed",2,3,0,5,0.4
3,"lightweight",24,"left-handed",4,4,0,8,0.5
3,"heavyweight",36,"left-handed",20,13,1,34,0.602941176
3,"lightweight",22,"left-handed",2,0,0,2,1
3,"super bantamweight",NA,"left-handed",1,0,0,1,1
3,"welterweight",NA,"left-handed",4,1,0,5,0.8
3,"super flyweight",19,"left-handed",1,0,0,1,1
3,"featherweight",33,"left-handed",2,2,1,5,0.5
3,"super lightweight",37,"left-handed",25,36,0,61,0.409836066
3,"middleweight",30,"left-handed",2,7,4,13,0.307692308
3,"super featherweight",24,"left-handed",3,0,0,3,1
3,"middleweight",37,"left-handed",17,15,5,37,0.527027027
3,"cruiserweight",41,"left-handed",7,11,1,19,0.394736842
3,"bantamweight",27,"left-handed",1,0,0,1,1
3,"lightweight",21,"left-handed",2,0,0,2,1
3,"super featherweight",38,"left-handed",3,1,0,4,0.75
3,"super middleweight",24,"left-handed",2,0,0,2,1
3,"super bantamweight",25,"left-handed",1,0,0,1,1
3,"featherweight",NA,"left-handed",8,30,4,42,0.238095238
3,"lightweight",19,"left-handed",2,0,0,2,1
3,"cruiserweight",23,"left-handed",2,0,0,2,1
3,"super welterweight",20,"left-handed",5,0,1,6,0.916666667
3,"light heavyweight",38,"left-handed",1,1,1,3,0.5
3,"super lightweight",33,"left-handed",3,3,0,6,0.5
3,"flyweight",25,"left-handed",3,5,0,8,0.375
3,"middleweight",21,"left-handed",2,1,0,3,0.666666667
3,"super welterweight",39,"left-handed",2,1,0,3,0.666666667
3,"cruiserweight",NA,"left-handed",4,1,0,5,0.8
3,"lightweight",23,"left-handed",7,13,0,20,0.35
3,"super featherweight",20,"left-handed",1,5,2,8,0.25
3,"cruiserweight",34,"left-handed",25,19,3,47,0.563829787
3,"welterweight",24,"left-handed",3,2,1,6,0.583333333
3,"super bantamweight",21,"left-handed",1,1,0,2,0.5
3,"super featherweight",31,"left-handed",26,33,1,60,0.441666667
3,"super welterweight",23,"left-handed",1,0,0,1,1
3,"lightweight",33,"left-handed",3,1,1,5,0.7
3,"bantamweight",23,"left-handed",1,0,0,1,1
3,"super welterweight",31,"left-handed",6,22,4,32,0.25
3,"light flyweight",23,"left-handed",4,3,1,8,0.5625
3,"featherweight",28,"left-handed",1,1,2,4,0.5
3,"welterweight",31,"left-handed",4,9,0,13,0.307692308
3,"lightweight",25,"left-handed",3,2,0,5,0.6
3,"super lightweight",NA,"left-handed",1,1,0,2,0.5
3,"super bantamweight",24,"left-handed",4,5,1,10,0.45
3,"welterweight",40,"left-handed",12,17,1,30,0.416666667
3,"light heavyweight",26,"left-handed",2,0,1,3,0.833333333
3,"super featherweight",40,"left-handed",31,35,4,70,0.471428571
3,"super lightweight",33,"left-handed",4,3,0,7,0.571428571
3,"super bantamweight",31,"left-handed",7,7,0,14,0.5
3,"super welterweight",34,"left-handed",4,4,3,11,0.5
3,"featherweight",23,"left-handed",8,7,0,15,0.533333333
3,"light flyweight",25,"left-handed",2,6,2,10,0.3
3,"featherweight",30,"left-handed",3,1,1,5,0.7
3,"super welterweight",37,"left-handed",6,6,0,12,0.5
3,"super lightweight",22,"left-handed",1,0,0,1,1
3,"",NA,"left-handed",1,0,0,1,1
3,"welterweight",27,"left-handed",1,0,0,1,1
3,"super welterweight",28,"left-handed",1,0,0,1,1
3,"lightweight",20,"left-handed",1,0,0,1,1
3,"welterweight",NA,"left-handed",1,0,0,1,1
3,"bantamweight",35,"left-handed",5,12,0,17,0.294117647
3,"flyweight",36,"left-handed",2,5,1,8,0.3125
3,"flyweight",26,"left-handed",2,2,1,5,0.5
3,"super welterweight",27,"left-handed",7,4,0,11,0.636363636
3,"super lightweight",32,"left-handed",4,6,0,10,0.4
0.032,"light heavyweight",10,"left-handed",2,19,0,21,0.0952380952380952
0.032,"middleweight",32,"left-handed",0,18,0,18,0
0.032,"super featherweight",22,"left-handed",5,23,3,31,0.209677419354839
0.032,"super featherweight",25,"left-handed",1,20,1,22,0.0681818181818182
0.029,"super middleweight",20,"left-handed",8,26,2,36,0.25
0.028,"light heavyweight",29,"left-handed",2,30,1,33,0.0757575757575758
0.025,"welterweight",17,"left-handed",0,26,0,26,0
0.024,"cruiserweight",24,"left-handed",10,32,1,43,0.244186046511628
0.024,"welterweight",24,"left-handed",0,28,4,32,0.0625
0.019,"super middleweight",18,"left-handed",4,40,0,44,0.0909090909090909
0.019,"welterweight",13,"left-handed",0,32,2,34,0.0294117647058824
0.016,"super middleweight",13,"left-handed",5,50,0,55,0.0909090909090909
0.016,"cruiserweight",32,"left-handed",0,34,0,34,0
0.015,"light heavyweight",21,"left-handed",15,102,5,122,0.14344262295082
0.014,"heavyweight",28,"left-handed",6,51,1,58,0.112068965517241
0.009,"light heavyweight",23,"left-handed",10,104,3,117,0.0982905982905983
0.009,"super welterweight",24,"left-handed",2,49,3,54,0.0648148148148148
0.043,"welterweight",14,"left-handed",3,25,0,28,0.107142857142857
0.042,"welterweight",14,"left-handed",7,19,1,27,0.277777777777778
0.042,"super middleweight",12,"left-handed",8,8,0,16,0.5
0.042,"heavyweight",14,"left-handed",7,12,0,19,0.368421052631579
0.042,"cruiserweight",15,"left-handed",3,8,1,12,0.291666666666667
0.042,"super flyweight",9,"left-handed",3,9,1,13,0.269230769230769
0.042,"super middleweight",25,"left-handed",1,11,1,13,0.115384615384615
0.042,"heavyweight",9,"left-handed",5,23,2,30,0.2
0.042,"lightweight",8,"left-handed",1,11,0,12,0.0833333333333333
0.042,"welterweight",24,"left-handed",11,40,1,52,0.221153846153846
0.041,"featherweight",9,"left-handed",8,10,0,18,0.444444444444444
0.041,"heavyweight",16,"left-handed",7,13,0,20,0.35
0.041,"super featherweight",17,"left-handed",4,9,0,13,0.307692307692308
0.041,"flyweight",14,"left-handed",2,5,0,7,0.285714285714286
0.041,"super flyweight",NA,"left-handed",3,18,0,21,0.142857142857143
0.041,"light heavyweight",21,"left-handed",0,9,1,10,0.05
0.041,"lightweight",13,"left-handed",0,9,0,9,0
0.041,"cruiserweight",23,"left-handed",16,49,3,68,0.257352941176471
0.04,"super featherweight",13,"left-handed",5,12,0,17,0.294117647058824
0.04,"flyweight",13,"left-handed",11,14,0,25,0.44
0.04,"super lightweight",22,"left-handed",2,9,0,11,0.181818181818182
0.04,"light heavyweight",33,"left-handed",2,28,0,30,0.0666666666666667
0.04,"super lightweight",14,"left-handed",3,9,0,12,0.25
0.04,"middleweight",23,"left-handed",1,12,0,13,0.0769230769230769
0.04,"flyweight",18,"left-handed",0,10,2,12,0.0833333333333333
0.039,"middleweight",22,"left-handed",10,87,3,100,0.115
0.039,"super featherweight",NA,"left-handed",4,18,3,25,0.22
0.039,"cruiserweight",23,"left-handed",2,11,2,15,0.2
0.039,"middleweight",NA,"left-handed",1,11,1,13,0.115384615384615
0.039,"super featherweight",28,"left-handed",1,23,1,25,0.06
0.039,"lightweight",17,"left-handed",0,11,0,11,0
0.038,"super middleweight",20,"left-handed",3,11,0,14,0.214285714285714
0.038,"welterweight",20,"left-handed",5,21,0,26,0.192307692307692
0.038,"flyweight",13,"left-handed",2,14,3,19,0.184210526315789
0.038,"lightweight",19,"left-handed",1,25,2,28,0.0714285714285714
0.037,"welterweight",22,"left-handed",8,40,2,50,0.18
0.037,"flyweight",NA,"left-handed",3,14,1,18,0.194444444444444
0.037,"bantamweight",13,"left-handed",2,13,0,15,0.133333333333333
0.037,"super flyweight",18,"left-handed",0,13,0,13,0
0.037,"super bantamweight",15,"left-handed",1,13,0,14,0.0714285714285714
0.036,"super lightweight",17,"left-handed",1,12,0,13,0.0769230769230769
0.036,"super welterweight",18,"left-handed",11,30,0,41,0.268292682926829
0.036,"featherweight",11,"left-handed",0,14,0,14,0
0.035,"heavyweight",24,"left-handed",10,70,6,86,0.151162790697674
0.035,"super lightweight",17,"left-handed",0,15,0,15,0
0.034,"flyweight",14,"left-handed",3,18,2,23,0.173913043478261
0.034,"super welterweight",9,"left-handed",9,15,1,25,0.38
0.034,"flyweight",21,"left-handed",6,22,2,30,0.233333333333333
0.034,"super featherweight",17,"left-handed",7,47,2,56,0.142857142857143
0.033,"light heavyweight",16,"left-handed",2,18,1,21,0.119047619047619
0.046,"super featherweight",4,"left-handed",2,4,0,6,0.333333333333333
0.046,"featherweight",10,"left-handed",1,4,0,5,0.2
0.046,"welterweight",12,"left-handed",0,4,0,4,0
0.046,"super lightweight",19,"left-handed",0,4,0,4,0
0.046,"featherweight",6,"left-handed",0,4,0,4,0
0.046,"lightweight",19,"left-handed",0,3,0,3,0
0.046,"super welterweight",19,"left-handed",0,4,0,4,0
0.046,"super featherweight",NA,"left-handed",0,4,0,4,0
0.046,"super bantamweight",10,"left-handed",2,5,2,9,0.333333333333333
0.046,"super lightweight",14,"left-handed",6,5,1,12,0.541666666666667
0.046,"super flyweight",13,"left-handed",3,14,3,20,0.225
0.046,"super welterweight",25,"left-handed",5,26,1,32,0.171875
0.045,"bantamweight",NA,"left-handed",11,9,1,21,0.547619047619048
0.045,"featherweight",NA,"left-handed",3,6,1,10,0.35
0.045,"featherweight",NA,"left-handed",3,9,0,12,0.25
0.045,"cruiserweight",15,"left-handed",4,26,3,33,0.166666666666667
0.045,"super lightweight",20,"left-handed",3,7,0,10,0.3
0.045,"light flyweight",13,"left-handed",2,8,0,10,0.2
0.045,"cruiserweight",14,"left-handed",2,5,0,7,0.285714285714286
0.045,"welterweight",8,"left-handed",1,5,0,6,0.166666666666667
0.045,"cruiserweight",26,"left-handed",5,32,2,39,0.153846153846154
0.045,"featherweight",18,"left-handed",1,9,0,10,0.1
0.045,"lightweight",10,"left-handed",1,6,0,7,0.142857142857143
0.045,"middleweight",18,"left-handed",1,11,0,12,0.0833333333333333
0.045,"super middleweight",12,"left-handed",1,5,0,6,0.166666666666667
0.045,"welterweight",13,"left-handed",0,5,0,5,0
0.045,"lightweight",13,"left-handed",0,5,0,5,0
0.045,"welterweight",26,"left-handed",0,5,0,5,0
0.045,"middleweight",16,"left-handed",1,6,0,7,0.142857142857143
0.045,"super welterweight",28,"left-handed",3,16,3,22,0.204545454545455
0.045,"lightweight",NA,"left-handed",3,10,1,14,0.25
0.044,"super lightweight",12,"left-handed",5,7,0,12,0.416666666666667
0.044,"cruiserweight",8,"left-handed",1,1,0,2,0.5
0.044,"welterweight",5,"left-handed",6,8,1,15,0.433333333333333
0.044,"featherweight",13,"left-handed",4,6,0,10,0.4
0.044,"super lightweight",18,"left-handed",1,6,0,7,0.142857142857143
0.044,"bantamweight",8,"left-handed",1,9,0,10,0.1
0.044,"welterweight",22,"left-handed",1,6,0,7,0.142857142857143
0.044,"featherweight",NA,"left-handed",0,6,0,6,0
0.044,"middleweight",10,"left-handed",0,6,0,6,0
0.044,"super lightweight",24,"left-handed",3,10,0,13,0.230769230769231
0.043,"super middleweight",24,"left-handed",5,18,2,25,0.24
0.043,"featherweight",13,"left-handed",4,8,0,12,0.333333333333333
0.043,"super welterweight",20,"left-handed",7,21,0,28,0.25
0.043,"cruiserweight",19,"left-handed",9,21,0,30,0.3
0.043,"heavyweight",31,"left-handed",6,8,1,15,0.433333333333333
0.043,"lightweight",15,"left-handed",2,7,0,9,0.222222222222222
0.043,"super featherweight",9,"left-handed",1,9,0,10,0.1
0.043,"super welterweight",20,"left-handed",1,7,0,8,0.125
0.043,"bantamweight",9,"left-handed",0,7,0,7,0
0.047,"bantamweight",22,"left-handed",2,3,0,5,0.4
0.047,"flyweight",9,"left-handed",1,5,1,7,0.214285714285714
0.047,"super lightweight",9,"left-handed",1,3,0,4,0.25
0.047,"flyweight",11,"left-handed",1,8,0,9,0.111111111111111
0.047,"cruiserweight",14,"left-handed",1,6,1,8,0.1875
0.047,"lightweight",8,"left-handed",1,5,0,6,0.166666666666667
0.047,"super featherweight",16,"left-handed",0,3,0,3,0
0.047,"super featherweight",14,"left-handed",0,3,0,3,0
0.047,"super lightweight",9,"left-handed",0,3,0,3,0
0.047,"welterweight",14,"left-handed",0,3,0,3,0
0.047,"super welterweight",12,"left-handed",0,3,0,3,0
0.047,"lightweight",NA,"left-handed",0,3,0,3,0
0.047,"super lightweight",12,"left-handed",0,3,0,3,0
0.047,"featherweight",13,"left-handed",0,3,0,3,0
0.047,"heavyweight",11,"left-handed",0,3,0,3,0
0.047,"super featherweight",NA,"left-handed",0,3,0,3,0
0.047,"light flyweight",9,"left-handed",0,3,0,3,0
0.047,"lightweight",15,"left-handed",0,3,0,3,0
0.047,"welterweight",11,"left-handed",0,3,0,3,0
0.047,"light flyweight",7,"left-handed",0,3,0,3,0
0.047,"heavyweight",9,"left-handed",0,2,0,2,0
0.047,"featherweight",NA,"left-handed",0,3,0,3,0
0.047,"super welterweight",14,"left-handed",0,3,0,3,0
0.047,"super welterweight",NA,"left-handed",0,3,0,3,0
0.047,"featherweight",NA,"left-handed",0,3,0,3,0
0.047,"cruiserweight",20,"left-handed",3,25,1,29,0.120689655172414
0.047,"light flyweight",NA,"left-handed",0,3,0,3,0
0.047,"super lightweight",17,"left-handed",0,2,1,3,0.166666666666667
0.047,"super middleweight",19,"left-handed",0,3,0,3,0
0.047,"super bantamweight",10,"left-handed",0,3,0,3,0
0.047,"flyweight",6,"left-handed",14,8,0,22,0.636363636363636
0.047,"middleweight",17,"left-handed",1,6,2,9,0.222222222222222
0.047,"lightweight",21,"left-handed",16,4,0,20,0.8
0.047,"lightweight",5,"left-handed",19,10,1,30,0.65
0.046,"cruiserweight",14,"left-handed",7,5,0,12,0.583333333333333
0.046,"light heavyweight",13,"left-handed",4,5,1,10,0.45
0.046,"super lightweight",31,"left-handed",5,5,1,11,0.5
0.046,"super featherweight",11,"left-handed",1,8,1,10,0.15
0.046,"super featherweight",13,"left-handed",7,10,1,18,0.416666666666667
0.046,"featherweight",NA,"left-handed",3,5,0,8,0.375
0.046,"super welterweight",23,"left-handed",3,5,2,10,0.4
0.046,"middleweight",19,"left-handed",3,24,0,27,0.111111111111111
0.046,"super bantamweight",NA,"left-handed",1,4,0,5,0.2
0.046,"light heavyweight",21,"left-handed",1,6,1,8,0.1875
0.046,"middleweight",18,"left-handed",1,4,0,5,0.2
0.046,"light heavyweight",20,"left-handed",1,6,0,7,0.142857142857143
0.046,"cruiserweight",14,"left-handed",1,4,0,5,0.2
0.046,"super lightweight",17,"left-handed",1,1,0,2,0.5
0.046,"super bantamweight",12,"left-handed",2,9,0,11,0.181818181818182
0.046,"super lightweight",10,"left-handed",2,4,1,7,0.357142857142857
0.048,"middleweight",11,"left-handed",2,4,0,6,0.333333333333333
0.048,"featherweight",11,"left-handed",1,2,2,5,0.4
0.048,"super bantamweight",14,"left-handed",1,2,2,5,0.4
0.048,"bantamweight",16,"left-handed",3,2,2,7,0.571428571428571
0.048,"super middleweight",14,"left-handed",1,2,0,3,0.333333333333333
0.048,"middleweight",14,"left-handed",0,2,1,3,0.166666666666667
0.048,"featherweight",13,"left-handed",0,2,2,4,0.25
0.048,"welterweight",20,"left-handed",1,2,0,3,0.333333333333333
0.048,"minimumweight",NA,"left-handed",1,2,0,3,0.333333333333333
0.048,"featherweight",12,"left-handed",1,2,0,3,0.333333333333333
0.048,"super welterweight",23,"left-handed",1,2,0,3,0.333333333333333
0.048,"super bantamweight",11,"left-handed",1,2,0,3,0.333333333333333
0.048,"welterweight",25,"left-handed",0,2,0,2,0
0.048,"light heavyweight",22,"left-handed",0,2,0,2,0
0.048,"featherweight",10,"left-handed",0,2,0,2,0
0.048,"super bantamweight",15,"left-handed",0,2,0,2,0
0.048,"super lightweight",15,"left-handed",0,1,0,1,0
0.048,"welterweight",17,"left-handed",0,2,0,2,0
0.048,"cruiserweight",8,"left-handed",0,2,0,2,0
0.048,"lightweight",9,"left-handed",0,2,0,2,0
0.048,"heavyweight",22,"left-handed",0,2,0,2,0
0.048,"welterweight",16,"left-handed",0,1,0,1,0
0.048,"super featherweight",13,"left-handed",0,2,0,2,0
0.048,"heavyweight",13,"left-handed",0,2,0,2,0
0.048,"super lightweight",16,"left-handed",0,2,0,2,0
0.048,"welterweight",NA,"left-handed",0,2,0,2,0
0.048,"super lightweight",14,"left-handed",0,2,0,2,0
0.048,"cruiserweight",17,"left-handed",0,2,0,2,0
0.048,"middleweight",NA,"left-handed",0,2,0,2,0
0.048,"welterweight",17,"left-handed",4,9,0,13,0.307692307692308
0.048,"heavyweight",17,"left-handed",14,3,1,18,0.805555555555556
0.048,"super lightweight",16,"left-handed",9,2,1,12,0.791666666666667
0.047,"lightweight",18,"left-handed",8,3,0,11,0.727272727272727
0.047,"flyweight",12,"left-handed",5,6,1,12,0.458333333333333
0.047,"flyweight",11,"left-handed",3,5,0,8,0.375
0.047,"flyweight",17,"left-handed",5,4,1,10,0.55
0.047,"super bantamweight",14,"left-handed",4,3,0,7,0.571428571428571
0.047,"featherweight",NA,"left-handed",3,3,0,6,0.5
0.047,"featherweight",15,"left-handed",3,3,0,6,0.5
0.047,"super lightweight",22,"left-handed",2,4,2,8,0.375
0.047,"light flyweight",14,"left-handed",3,8,1,12,0.291666666666667
0.047,"super featherweight",8,"left-handed",2,3,1,6,0.416666666666667
0.047,"middleweight",NA,"left-handed",2,3,0,5,0.4
0.047,"middleweight",NA,"left-handed",3,8,3,14,0.321428571428571
0.047,"super bantamweight",10,"left-handed",4,5,1,10,0.45
0.047,"welterweight",16,"left-handed",3,6,0,9,0.333333333333333
0.047,"welterweight",12,"left-handed",2,7,0,9,0.222222222222222
0.047,"featherweight",11,"left-handed",1,4,0,5,0.2
0.047,"middleweight",10,"left-handed",0,3,2,5,0.2
0.047,"super featherweight",15,"left-handed",2,4,0,6,0.333333333333333
0.049,"super lightweight",21,"left-handed",0,1,0,1,0
0.049,"super lightweight",7,"left-handed",0,1,0,1,0
0.049,"super featherweight",5,"left-handed",0,1,1,2,0.25
0.049,"heavyweight",17,"left-handed",0,1,0,1,0
0.049,"",21,"left-handed",0,1,0,1,0
0.049,"middleweight",15,"left-handed",0,1,0,1,0
0.049,"featherweight",13,"left-handed",0,1,0,1,0
0.049,"super welterweight",NA,"left-handed",0,1,0,1,0
0.049,"super lightweight",8,"left-handed",0,1,0,1,0
0.049,"heavyweight",9,"left-handed",0,1,0,1,0
0.049,"light heavyweight",23,"left-handed",0,1,0,1,0
0.049,"",16,"left-handed",0,1,0,1,0
0.049,"super flyweight",7,"left-handed",0,1,0,1,0
0.049,"middleweight",11,"left-handed",0,1,1,2,0.25
0.049,"heavyweight",22,"left-handed",0,1,0,1,0
0.049,"lightweight",14,"left-handed",0,1,0,1,0
0.049,"welterweight",22,"left-handed",0,1,0,1,0
0.049,"lightweight",6,"left-handed",0,1,0,1,0
0.049,"flyweight",NA,"left-handed",0,1,0,1,0
0.049,"super flyweight",5,"left-handed",0,1,0,1,0
0.049,"bantamweight",5,"left-handed",0,1,0,1,0
0.049,"super lightweight",15,"left-handed",0,1,0,1,0
0.049,"welterweight",22,"left-handed",0,1,0,1,0
0.049,"lightweight",6,"left-handed",0,1,1,2,0.25
0.049,"super bantamweight",9,"left-handed",0,1,0,1,0
0.049,"super welterweight",5,"left-handed",0,1,0,1,0
0.049,"welterweight",15,"left-handed",0,1,0,1,0
0.049,"lightweight",14,"left-handed",0,1,0,1,0
0.049,"featherweight",5,"left-handed",0,1,0,1,0
0.049,"super middleweight",7,"left-handed",0,1,0,1,0
0.049,"lightweight",4,"left-handed",0,1,0,1,0
0.049,"super bantamweight",5,"left-handed",0,1,0,1,0
0.049,"welterweight",7,"left-handed",4,6,2,12,0.416666666666667
0.049,"super welterweight",20,"left-handed",2,2,0,4,0.5
0.049,"super featherweight",10,"left-handed",2,1,1,4,0.625
0.049,"super welterweight",25,"left-handed",2,2,0,4,0.5
0.048,"middleweight",10,"left-handed",2,1,0,3,0.666666666666667
0.048,"super middleweight",6,"left-handed",7,4,0,11,0.636363636363636
0.048,"flyweight",6,"left-handed",5,2,1,8,0.6875
0.048,"super welterweight",33,"left-handed",3,2,1,6,0.583333333333333
0.048,"super welterweight",17,"left-handed",4,10,0,14,0.285714285714286
0.048,"light flyweight",9,"left-handed",4,3,1,8,0.5625
0.048,"flyweight",6,"left-handed",2,2,0,4,0.5
0.048,"super bantamweight",6,"left-handed",2,2,1,5,0.5
0.048,"flyweight",6,"left-handed",2,2,0,4,0.5
0.048,"super lightweight",13,"left-handed",2,2,1,5,0.5
0.048,"super featherweight",11,"left-handed",3,3,0,6,0.5
0.048,"heavyweight",16,"left-handed",2,4,0,6,0.333333333333333
0.048,"lightweight",10,"left-handed",4,5,0,9,0.444444444444444
0.048,"bantamweight",10,"left-handed",3,2,1,6,0.583333333333333
0.049,"super welterweight",13,"left-handed",1,2,0,3,0.333333333333333
0.049,"light flyweight",6,"left-handed",1,1,0,2,0.5
0.049,"minimumweight",8,"left-handed",1,1,1,3,0.5
0.049,"super featherweight",10,"left-handed",1,1,0,2,0.5
0.049,"super bantamweight",9,"left-handed",1,1,1,3,0.5
0.049,"super bantamweight",10,"left-handed",1,1,0,2,0.5
0.049,"middleweight",5,"left-handed",1,1,0,2,0.5
0.049,"super bantamweight",8,"left-handed",1,4,0,5,0.2
0.049,"super welterweight",17,"left-handed",2,9,0,11,0.181818181818182
0.049,"flyweight",14,"left-handed",1,1,0,2,0.5
0.049,"welterweight",4,"left-handed",1,1,0,2,0.5
0.049,"welterweight",5,"left-handed",1,2,0,3,0.333333333333333
0.049,"super featherweight",9,"left-handed",1,1,0,2,0.5
0.049,"super lightweight",13,"left-handed",1,1,0,2,0.5
0.049,"middleweight",NA,"left-handed",1,2,0,3,0.333333333333333
0.049,"super lightweight",9,"left-handed",1,2,0,3,0.333333333333333
0.049,"super flyweight",6,"left-handed",1,1,0,2,0.5
0.049,"middleweight",4,"left-handed",1,1,1,3,0.5
0.049,"super middleweight",13,"left-handed",1,1,0,2,0.5
0.049,"flyweight",13,"left-handed",0,1,0,1,0
0.049,"featherweight",7,"left-handed",0,1,0,1,0
0.049,"middleweight",21,"left-handed",0,1,0,1,0
0.049,"bantamweight",NA,"left-handed",0,1,0,1,0
0.049,"middleweight",NA,"left-handed",0,1,0,1,0
0.049,"super lightweight",11,"left-handed",0,1,0,1,0
0.049,"",13,"left-handed",0,1,0,1,0
0.049,"welterweight",19,"left-handed",0,1,0,1,0
0.049,"welterweight",17,"left-handed",3,3,1,7,0.5
0.049,"super featherweight",11,"left-handed",0,1,0,1,0
0.049,"super welterweight",17,"left-handed",0,1,1,2,0.25
0.049,"flyweight",NA,"left-handed",0,1,0,1,0
0.049,"light heavyweight",24,"left-handed",0,1,0,1,0
0.049,"bantamweight",11,"left-handed",0,1,0,1,0
0.049,"middleweight",8,"left-handed",0,1,0,1,0
0.049,"super bantamweight",20,"left-handed",0,1,0,1,0
0.049,"welterweight",20,"left-handed",0,1,0,1,0
0.049,"super lightweight",13,"left-handed",0,1,0,1,0
0.049,"super middleweight",15,"left-handed",0,1,0,1,0
0.049,"bantamweight",20,"left-handed",0,1,0,1,0
0.049,"super middleweight",8,"left-handed",0,1,0,1,0
0.049,"middleweight",17,"left-handed",0,1,0,1,0
0.049,"light flyweight",11,"left-handed",0,1,0,1,0
0.049,"bantamweight",4,"left-handed",0,1,0,1,0
0.049,"cruiserweight",12,"left-handed",0,1,0,1,0
0.049,"super bantamweight",15,"left-handed",0,1,0,1,0
0.049,"welterweight",15,"left-handed",0,1,0,1,0
0.049,"super flyweight",5,"left-handed",0,1,0,1,0
0.049,"super flyweight",9,"left-handed",0,1,0,1,0
0.049,"flyweight",NA,"left-handed",0,1,0,1,0
0.049,"welterweight",16,"left-handed",0,1,0,1,0
0.049,"lightweight",11,"left-handed",5,5,0,10,0.5
0.049,"lightweight",19,"left-handed",3,1,1,5,0.7
0.049,"super featherweight",10,"left-handed",4,2,0,6,0.666666666666667
0.049,"featherweight",10,"left-handed",3,1,1,5,0.7
0.049,"bantamweight",7,"left-handed",3,1,0,4,0.75
0.049,"featherweight",16,"left-handed",3,1,1,5,0.7
0.049,"super bantamweight",9,"left-handed",4,2,1,7,0.642857142857143
0.049,"super featherweight",5,"left-handed",2,1,0,3,0.666666666666667
0.049,"super middleweight",15,"left-handed",2,1,0,3,0.666666666666667
0.049,"bantamweight",21,"left-handed",5,13,0,18,0.277777777777778
0.049,"middleweight",17,"left-handed",2,2,0,4,0.5
0.049,"cruiserweight",25,"left-handed",2,2,0,4,0.5
0.049,"welterweight",10,"left-handed",3,1,0,4,0.75
0.049,"super middleweight",20,"left-handed",2,1,0,3,0.666666666666667
0.049,"super middleweight",11,"left-handed",2,2,0,4,0.5
0.049,"heavyweight",23,"left-handed",2,2,0,4,0.5
0.049,"welterweight",19,"left-handed",2,3,0,5,0.4
0.049,"light heavyweight",25,"left-handed",1,1,1,3,0.5
0.049,"welterweight",11,"left-handed",2,1,0,3,0.666666666666667
0.049,"super middleweight",17,"left-handed",2,2,0,4,0.5
0.049,"super featherweight",9,"left-handed",2,2,0,4,0.5
0.049,"cruiserweight",24,"left-handed",6,2,1,9,0.722222222222222
0.049,"light flyweight",10,"left-handed",2,1,0,3,0.666666666666667
0.049,"lightweight",15,"left-handed",1,4,2,7,0.285714285714286
0.049,"super featherweight",6,"left-handed",1,5,2,8,0.25
0.049,"lightweight",NA,"left-handed",12,6,1,19,0.657894736842105
0.049,"featherweight",5,"left-handed",2,1,0,3,0.666666666666667
0.049,"featherweight",12,"left-handed",3,3,0,6,0.5
0.049,"super bantamweight",4,"left-handed",2,1,0,3,0.666666666666667
0.049,"super featherweight",13,"left-handed",8,9,0,17,0.470588235294118
0.049,"featherweight",8,"left-handed",2,1,1,4,0.625
0.049,"lightweight",10,"left-handed",2,2,1,5,0.5
0.049,"lightweight",NA,"left-handed",2,1,0,3,0.666666666666667
0.049,"super welterweight",14,"left-handed",2,1,0,3,0.666666666666667
0.049,"minimumweight",11,"left-handed",3,2,0,5,0.6
0.049,"bantamweight",NA,"left-handed",2,1,0,3,0.666666666666667
0.049,"super middleweight",NA,"left-handed",2,1,0,3,0.666666666666667
0.049,"welterweight",24,"left-handed",2,4,1,7,0.357142857142857
0.049,"bantamweight",14,"left-handed",2,1,0,3,0.666666666666667
0.049,"super featherweight",13,"left-handed",2,3,0,5,0.4
0.049,"super featherweight",11,"left-handed",3,4,0,7,0.428571428571429
0.049,"lightweight",9,"left-handed",2,1,0,3,0.666666666666667
0.049,"flyweight",13,"left-handed",2,2,0,4,0.5
0.049,"super featherweight",17,"left-handed",3,2,0,5,0.6
0.049,"super flyweight",6,"left-handed",2,4,0,6,0.333333333333333
0.049,"super lightweight",NA,"left-handed",1,1,0,2,0.5
0.049,"super featherweight",8,"left-handed",1,1,0,2,0.5
0.049,"lightweight",8,"left-handed",1,1,1,3,0.5
0.049,"middleweight",13,"left-handed",1,1,0,2,0.5
0.049,"super lightweight",NA,"left-handed",1,1,0,2,0.5
0.05,"bantamweight",6,"left-handed",1,0,0,1,1
0.05,"super lightweight",12,"left-handed",1,0,0,1,1
0.05,"welterweight",11,"left-handed",1,0,0,1,1
0.05,"super middleweight",12,"left-handed",1,0,0,1,1
0.05,"lightweight",13,"left-handed",1,0,0,1,1
0.05,"welterweight",11,"left-handed",1,0,0,1,1
0.05,"super bantamweight",7,"left-handed",1,0,0,1,1
0.05,"super lightweight",8,"left-handed",1,0,0,1,1
0.05,"heavyweight",11,"left-handed",1,0,0,1,1
0.05,"light heavyweight",9,"left-handed",1,0,0,1,1
0.05,"welterweight",13,"left-handed",1,2,0,3,0.333333333333333
0.05,"super bantamweight",5,"left-handed",1,0,0,1,1
0.05,"bantamweight",NA,"left-handed",1,0,0,1,1
0.05,"middleweight",12,"left-handed",1,0,0,1,1
0.05,"lightweight",21,"left-handed",1,0,0,1,1
0.05,"super welterweight",15,"left-handed",1,0,0,1,1
0.05,"super middleweight",14,"left-handed",1,0,0,1,1
0.05,"light heavyweight",NA,"left-handed",1,0,0,1,1
0.05,"middleweight",5,"left-handed",1,0,1,2,0.75
0.05,"featherweight",4,"left-handed",1,0,0,1,1
0.05,"super welterweight",10,"left-handed",1,0,0,1,1
0.05,"lightweight",NA,"left-handed",0,0,1,1,0.5
0.05,"light heavyweight",13,"left-handed",1,0,0,1,1
0.05,"super bantamweight",7,"left-handed",1,0,0,1,1
0.05,"super flyweight",4,"left-handed",1,1,0,2,0.5
0.05,"bantamweight",6,"left-handed",1,1,0,2,0.5
0.05,"welterweight",8,"left-handed",1,0,0,1,1
0.05,"middleweight",5,"left-handed",1,0,1,2,0.75
0.05,"super welterweight",9,"left-handed",1,0,0,1,1
0.05,"welterweight",NA,"left-handed",1,0,0,1,1
0.05,"welterweight",6,"left-handed",1,0,0,1,1
0.05,"super welterweight",9,"left-handed",1,0,0,1,1
0.05,"minimumweight",7,"left-handed",1,2,0,3,0.333333333333333
0.05,"super lightweight",17,"left-handed",0,0,1,1,0.5
0.05,"super flyweight",NA,"left-handed",0,0,1,1,0.5
0.05,"super bantamweight",14,"left-handed",8,11,0,19,0.421052631578947
0.05,"welterweight",18,"left-handed",3,3,0,6,0.5
0.05,"super flyweight",5,"left-handed",14,2,0,16,0.875
0.05,"featherweight",12,"left-handed",10,1,0,11,0.909090909090909
0.05,"heavyweight",12,"left-handed",13,7,0,20,0.65
0.05,"super flyweight",17,"left-handed",7,1,1,9,0.833333333333333
0.05,"super middleweight",15,"left-handed",8,2,0,10,0.8
0.049,"flyweight",5,"left-handed",4,2,0,6,0.666666666666667
0.049,"super featherweight",25,"left-handed",3,1,0,4,0.75
0.049,"featherweight",8,"left-handed",5,2,0,7,0.714285714285714
0.049,"super bantamweight",NA,"left-handed",7,6,0,13,0.538461538461538
0.049,"lightweight",23,"left-handed",7,4,2,13,0.615384615384615
0.049,"flyweight",5,"left-handed",3,1,1,5,0.7
0.049,"super featherweight",12,"left-handed",4,3,0,7,0.571428571428571
0.049,"super bantamweight",10,"left-handed",4,4,1,9,0.5
0.05,"super welterweight",14,"left-handed",2,0,0,2,1
0.05,"lightweight",7,"left-handed",1,0,0,1,1
0.05,"cruiserweight",NA,"left-handed",2,0,0,2,1
0.05,"featherweight",3,"left-handed",2,0,0,2,1
0.05,"featherweight",10,"left-handed",2,0,0,2,1
0.05,"super bantamweight",4,"left-handed",1,0,0,1,1
0.05,"super welterweight",8,"left-handed",1,0,0,1,1
0.05,"light heavyweight",18,"left-handed",1,0,0,1,1
0.05,"featherweight",12,"left-handed",1,8,0,9,0.111111111111111
0.05,"super bantamweight",3,"left-handed",0,0,1,1,0.5
0.05,"lightweight",11,"left-handed",1,0,0,1,1
0.05,"welterweight",14,"left-handed",1,1,0,2,0.5
0.05,"featherweight",7,"left-handed",1,0,0,1,1
0.05,"featherweight",15,"left-handed",1,0,0,1,1
0.05,"super lightweight",5,"left-handed",1,0,0,1,1
0.05,"welterweight",23,"left-handed",1,0,0,1,1
0.05,"middleweight",11,"left-handed",1,0,0,1,1
0.05,"heavyweight",11,"left-handed",1,1,0,2,0.5
0.05,"super lightweight",5,"left-handed",1,2,0,3,0.333333333333333
0.05,"flyweight",6,"left-handed",1,1,0,2,0.5
0.05,"cruiserweight",13,"left-handed",1,0,0,1,1
0.05,"heavyweight",13,"left-handed",1,0,0,1,1
0.05,"super middleweight",14,"left-handed",1,0,0,1,1
0.05,"super lightweight",9,"left-handed",1,0,1,2,0.75
0.05,"super welterweight",NA,"left-handed",1,0,0,1,1
0.05,"welterweight",NA,"left-handed",1,0,0,1,1
0.05,"lightweight",10,"left-handed",1,0,0,1,1
0.05,"lightweight",9,"left-handed",1,0,0,1,1
0.05,"light flyweight",18,"left-handed",1,1,0,2,0.5
0.05,"super flyweight",NA,"left-handed",1,0,0,1,1
0.05,"super featherweight",12,"left-handed",1,0,0,1,1
0.05,"heavyweight",10,"left-handed",1,0,0,1,1
0.05,"super middleweight",14,"left-handed",1,0,0,1,1
0.05,"middleweight",NA,"left-handed",1,0,0,1,1
0.05,"super flyweight",13,"left-handed",1,0,0,1,1
0.05,"super bantamweight",14,"left-handed",1,0,0,1,1
0.05,"flyweight",5,"left-handed",1,0,0,1,1
0.05,"flyweight",9,"left-handed",1,0,0,1,1
0.05,"super featherweight",12,"left-handed",1,0,0,1,1
0.05,"",6,"left-handed",0,0,1,1,0.5
0.05,"heavyweight",24,"left-handed",1,0,0,1,1
0.05,"super welterweight",8,"left-handed",29,13,1,43,0.686046511627907
0.05,"super welterweight",13,"left-handed",1,0,0,1,1
0.05,"super bantamweight",8,"left-handed",1,0,0,1,1
0.05,"super lightweight",9,"left-handed",1,0,0,1,1
0.05,"heavyweight",16,"left-handed",1,0,0,1,1
0.05,"featherweight",9,"left-handed",1,0,1,2,0.75
0.05,"middleweight",18,"left-handed",1,1,1,3,0.5
0.05,"super welterweight",9,"left-handed",1,0,0,1,1
0.05,"lightweight",10,"left-handed",1,0,0,1,1
0.05,"cruiserweight",15,"left-handed",4,0,0,4,1
0.05,"super welterweight",7,"left-handed",2,0,0,2,1
0.05,"featherweight",7,"left-handed",2,0,0,2,1
0.05,"middleweight",12,"left-handed",2,0,0,2,1
0.05,"super welterweight",8,"left-handed",2,0,0,2,1
0.05,"super bantamweight",NA,"left-handed",2,0,0,2,1
0.05,"super bantamweight",10,"left-handed",2,0,0,2,1
0.05,"super lightweight",3,"left-handed",2,0,0,2,1
0.05,"minimumweight",3,"left-handed",2,0,0,2,1
0.05,"welterweight",11,"left-handed",2,0,0,2,1
0.05,"super middleweight",7,"left-handed",2,0,1,3,0.833333333333333
0.05,"welterweight",7,"left-handed",2,0,0,2,1
0.05,"middleweight",12,"left-handed",2,0,0,2,1
0.05,"middleweight",8,"left-handed",2,0,0,2,1
0.05,"super bantamweight",9,"left-handed",2,0,0,2,1
0.05,"super bantamweight",10,"left-handed",2,2,0,4,0.5
0.05,"super lightweight",8,"left-handed",2,0,0,2,1
0.05,"super featherweight",5,"left-handed",2,0,0,2,1
0.05,"cruiserweight",14,"left-handed",1,0,0,1,1
0.05,"super welterweight",4,"left-handed",2,0,1,3,0.833333333333333
0.05,"flyweight",9,"left-handed",2,0,1,3,0.833333333333333
0.05,"flyweight",4,"left-handed",2,0,1,3,0.833333333333333
0.05,"featherweight",7,"left-handed",2,0,0,2,1
0.05,"super lightweight",14,"left-handed",2,0,0,2,1
0.05,"light flyweight",17,"left-handed",3,5,0,8,0.375
0.05,"super featherweight",8,"left-handed",2,3,0,5,0.4
0.05,"super lightweight",10,"left-handed",3,1,0,4,0.75
0.05,"light flyweight",8,"left-handed",2,1,0,3,0.666666666666667
0.05,"welterweight",8,"left-handed",2,0,0,2,1
0.05,"middleweight",13,"left-handed",2,0,0,2,1
0.05,"heavyweight",15,"left-handed",2,0,0,2,1
0.05,"featherweight",4,"left-handed",2,0,0,2,1
0.05,"super flyweight",5,"left-handed",2,0,0,2,1
0.05,"middleweight",16,"left-handed",2,2,0,4,0.5
0.05,"light flyweight",NA,"left-handed",2,0,1,3,0.833333333333333
0.05,"featherweight",9,"left-handed",2,0,0,2,1
0.05,"super bantamweight",16,"left-handed",2,0,0,2,1
0.05,"featherweight",19,"left-handed",2,2,1,5,0.5
0.05,"super lightweight",9,"left-handed",2,0,0,2,1
0.05,"super flyweight",7,"left-handed",2,0,0,2,1
0.05,"super lightweight",8,"left-handed",2,0,0,2,1
0.05,"lightweight",6,"left-handed",2,0,0,2,1
0.05,"super welterweight",9,"left-handed",2,0,0,2,1
0.05,"featherweight",14,"left-handed",2,0,1,3,0.833333333333333
0.05,"super flyweight",NA,"left-handed",2,0,0,2,1
0.05,"super bantamweight",10,"left-handed",2,0,0,2,1
0.05,"featherweight",13,"left-handed",2,0,0,2,1
0.05,"super lightweight",19,"left-handed",3,3,0,6,0.5
0.05,"super lightweight",8,"left-handed",2,1,0,3,0.666666666666667
0.05,"lightweight",11,"left-handed",2,0,0,2,1
0.051,"super welterweight",27,"left-handed",7,1,0,8,0.875
0.051,"heavyweight",27,"left-handed",7,3,1,11,0.681818181818182
0.051,"flyweight",NA,"left-handed",4,9,0,13,0.307692307692308
0.051,"light heavyweight",NA,"left-handed",6,0,0,6,1
0.05,"super featherweight",12,"left-handed",5,1,0,6,0.833333333333333
0.05,"super bantamweight",6,"left-handed",3,0,0,3,1
0.05,"welterweight",6,"left-handed",5,1,0,6,0.833333333333333
0.05,"middleweight",NA,"left-handed",4,1,1,6,0.75
0.05,"welterweight",7,"left-handed",2,0,0,2,1
0.05,"super lightweight",11,"left-handed",5,1,0,6,0.833333333333333
0.05,"middleweight",18,"left-handed",4,1,0,5,0.8
0.05,"flyweight",5,"left-handed",4,1,0,5,0.8
0.05,"super welterweight",12,"left-handed",1,0,0,1,1
0.05,"lightweight",13,"left-handed",5,0,0,5,1
0.05,"super lightweight",10,"left-handed",3,0,1,4,0.875
0.05,"featherweight",18,"left-handed",5,34,1,40,0.1375
0.05,"light flyweight",18,"left-handed",2,1,1,4,0.625
0.05,"super middleweight",16,"left-handed",2,0,0,2,1
0.05,"super welterweight",13,"left-handed",3,0,1,4,0.875
0.05,"welterweight",11,"left-handed",3,0,0,3,1
0.05,"cruiserweight",9,"left-handed",4,0,0,4,1
0.05,"lightweight",6,"left-handed",2,0,0,2,1
0.05,"super welterweight",6,"left-handed",3,2,0,5,0.6
0.05,"bantamweight",9,"left-handed",4,1,0,5,0.8
0.05,"super featherweight",11,"left-handed",3,0,0,3,1
0.05,"super lightweight",12,"left-handed",3,0,0,3,1
0.05,"featherweight",14,"left-handed",3,1,1,5,0.7
0.05,"bantamweight",21,"left-handed",3,0,0,3,1
0.05,"cruiserweight",20,"left-handed",2,0,0,2,1
0.05,"super bantamweight",4,"left-handed",3,0,0,3,1
0.05,"light heavyweight",14,"left-handed",4,0,0,4,1
0.05,"",17,"left-handed",4,0,0,4,1
0.05,"light heavyweight",14,"left-handed",3,0,0,3,1
0.05,"welterweight",12,"left-handed",3,0,0,3,1
0.05,"cruiserweight",13,"left-handed",4,1,0,5,0.8
0.05,"heavyweight",26,"left-handed",3,0,0,3,1
0.05,"featherweight",8,"left-handed",3,1,0,4,0.75
0.05,"super featherweight",14,"left-handed",3,1,0,4,0.75
0.05,"super middleweight",11,"left-handed",3,0,0,3,1
0.05,"super welterweight",NA,"left-handed",3,0,0,3,1
0.05,"flyweight",5,"left-handed",3,0,0,3,1
0.05,"lightweight",8,"left-handed",3,1,0,4,0.75
0.05,"super featherweight",13,"left-handed",4,0,0,4,1
0.05,"flyweight",15,"left-handed",4,1,0,5,0.8
0.05,"super lightweight",6,"left-handed",3,0,0,3,1
0.05,"super lightweight",9,"left-handed",2,0,0,2,1
0.05,"super lightweight",6,"left-handed",1,1,2,4,0.5
0.05,"lightweight",5,"left-handed",3,1,0,4,0.75
0.05,"light flyweight",9,"left-handed",3,2,1,6,0.583333333333333
0.05,"lightweight",8,"left-handed",3,0,0,3,1
0.051,"super welterweight",10,"left-handed",1,0,1,2,0.75
0.051,"flyweight",NA,"left-handed",3,1,1,5,0.7
0.051,"super lightweight",11,"left-handed",3,0,0,3,1
0.051,"super lightweight",9,"left-handed",4,0,0,4,1
0.051,"heavyweight",16,"left-handed",4,0,0,4,1
0.051,"lightweight",8,"left-handed",3,0,0,3,1
0.051,"super bantamweight",13,"left-handed",3,1,0,4,0.75
0.051,"super lightweight",14,"left-handed",2,0,0,2,1
0.051,"bantamweight",9,"left-handed",2,0,0,2,1
0.051,"super featherweight",5,"left-handed",2,0,0,2,1
0.051,"super lightweight",6,"left-handed",1,0,0,1,1
0.051,"super featherweight",6,"left-handed",1,0,0,1,1
0.051,"welterweight",4,"left-handed",1,0,0,1,1
0.051,"light flyweight",6,"left-handed",6,2,1,9,0.722222222222222
0.051,"featherweight",11,"left-handed",4,1,2,7,0.714285714285714
0.051,"super bantamweight",12,"left-handed",1,0,0,1,1
0.051,"super middleweight",14,"left-handed",3,5,0,8,0.375
0.051,"welterweight",8,"left-handed",6,0,1,7,0.928571428571429
0.051,"cruiserweight",14,"left-handed",5,0,0,5,1
0.051,"welterweight",9,"left-handed",3,0,0,3,1
0.051,"welterweight",21,"left-handed",7,1,0,8,0.875
0.051,"super lightweight",6,"left-handed",1,0,1,2,0.75
0.051,"super middleweight",5,"left-handed",3,0,0,3,1
0.051,"super featherweight",12,"left-handed",5,0,0,5,1
0.051,"light heavyweight",15,"left-handed",3,0,0,3,1
0.051,"featherweight",10,"left-handed",6,4,1,11,0.590909090909091
0.051,"welterweight",13,"left-handed",2,0,0,2,1
0.051,"super middleweight",18,"left-handed",6,1,1,8,0.8125
0.051,"super welterweight",NA,"left-handed",4,0,0,4,1
0.051,"heavyweight",31,"left-handed",13,3,0,16,0.8125
0.051,"super lightweight",14,"left-handed",15,0,0,15,1
0.051,"cruiserweight",NA,"left-handed",6,0,2,8,0.875
0.051,"light flyweight",4,"left-handed",4,0,0,4,1
0.051,"super featherweight",9,"left-handed",2,0,3,5,0.7
0.051,"middleweight",10,"left-handed",11,0,0,11,1
0.051,"super middleweight",14,"left-handed",7,0,0,7,1
0.051,"middleweight",8,"left-handed",2,0,0,2,1
0.051,"super lightweight",11,"left-handed",9,2,3,14,0.75
0.051,"super featherweight",10,"left-handed",8,0,0,8,1
0.051,"super middleweight",35,"left-handed",13,14,0,27,0.481481481481481
0.051,"middleweight",10,"left-handed",4,3,0,7,0.571428571428571
0.051,"lightweight",7,"left-handed",6,0,0,6,1
0.051,"bantamweight",9,"left-handed",6,0,0,6,1
0.051,"super middleweight",8,"left-handed",6,0,0,6,1
0.051,"heavyweight",34,"left-handed",12,12,3,27,0.5
0.051,"super featherweight",8,"left-handed",4,1,0,5,0.8
0.051,"super lightweight",7,"left-handed",6,0,0,6,1
0.051,"super bantamweight",14,"left-handed",2,5,0,7,0.285714285714286
0.051,"welterweight",10,"left-handed",6,2,0,8,0.75
0.051,"cruiserweight",21,"left-handed",7,2,1,10,0.75
0.057,"super middleweight",15,"left-handed",3,2,0,5,0.6
0.056,"flyweight",5,"left-handed",3,0,2,5,0.8
0.056,"super flyweight",15,"left-handed",3,9,2,14,0.285714285714286
0.056,"super welterweight",12,"left-handed",12,27,0,39,0.307692307692308
0.056,"super middleweight",13,"left-handed",7,3,0,10,0.7
0.056,"middleweight",24,"left-handed",17,3,0,20,0.85
0.056,"welterweight",22,"left-handed",4,3,1,8,0.5625
0.055,"flyweight",16,"left-handed",0,8,0,8,0
0.055,"super featherweight",10,"left-handed",4,0,0,4,1
0.055,"light heavyweight",11,"left-handed",6,3,1,10,0.65
0.055,"super lightweight",10,"left-handed",5,0,0,5,1
0.055,"super middleweight",14,"left-handed",5,0,0,5,1
0.055,"super flyweight",7,"left-handed",4,2,0,6,0.666666666666667
0.055,"super middleweight",NA,"left-handed",1,6,0,7,0.142857142857143
0.054,"super welterweight",5,"left-handed",2,5,0,7,0.285714285714286
0.054,"middleweight",9,"left-handed",5,0,0,5,1
0.054,"lightweight",13,"left-handed",3,0,0,3,1
0.054,"super welterweight",14,"left-handed",2,0,0,2,1
0.054,"light heavyweight",14,"left-handed",7,0,0,7,1
0.054,"lightweight",15,"left-handed",7,0,2,9,0.888888888888889
0.054,"super bantamweight",8,"left-handed",7,0,0,7,1
0.053,"welterweight",10,"left-handed",8,0,0,8,1
0.053,"super middleweight",19,"left-handed",15,27,0,42,0.357142857142857
0.053,"super featherweight",9,"left-handed",1,4,1,6,0.25
0.053,"super flyweight",9,"left-handed",5,0,0,5,1
0.053,"super welterweight",26,"left-handed",12,45,2,59,0.220338983050847
0.053,"super bantamweight",6,"left-handed",3,0,1,4,0.875
0.053,"super flyweight",5,"left-handed",4,0,0,4,1
0.053,"super lightweight",21,"left-handed",6,0,0,6,1
0.053,"cruiserweight",19,"left-handed",13,6,0,19,0.684210526315789
0.053,"heavyweight",12,"left-handed",8,1,1,10,0.85
0.052,"cruiserweight",20,"left-handed",2,0,0,2,1
0.052,"super bantamweight",18,"left-handed",3,2,0,5,0.6
0.052,"light heavyweight",23,"left-handed",25,16,0,41,0.609756097560976
0.052,"super lightweight",NA,"left-handed",3,3,0,6,0.5
0.052,"super featherweight",16,"left-handed",4,3,0,7,0.571428571428571
0.052,"super featherweight",28,"left-handed",4,5,1,10,0.45
0.052,"bantamweight",11,"left-handed",2,8,2,12,0.25
0.052,"lightweight",4,"left-handed",1,0,0,1,1
0.052,"super featherweight",7,"left-handed",3,0,2,5,0.8
0.052,"super lightweight",13,"left-handed",6,0,0,6,1
0.052,"super welterweight",13,"left-handed",6,0,0,6,1
0.052,"super lightweight",13,"left-handed",4,0,0,4,1
0.052,"light flyweight",5,"left-handed",7,0,0,7,1
0.052,"super middleweight",18,"left-handed",6,0,0,6,1
0.052,"lightweight",8,"left-handed",3,0,0,3,1
0.052,"middleweight",16,"left-handed",6,0,0,6,1
0.051,"super lightweight",15,"left-handed",6,0,0,6,1
0.051,"light heavyweight",NA,"left-handed",2,8,0,10,0.2
0.051,"super bantamweight",21,"left-handed",3,1,2,6,0.666666666666667
0.075,"super lightweight",17,"left-handed",25,10,0,35,0.714285714285714
0.075,"super welterweight",19,"left-handed",1,0,0,1,1
0.072,"bantamweight",16,"left-handed",7,31,1,39,0.192307692307692
0.072,"super bantamweight",9,"left-handed",3,2,0,5,0.6
0.072,"lightweight",11,"left-handed",7,0,0,7,1
0.072,"super middleweight",12,"left-handed",2,1,0,3,0.666666666666667
0.071,"super featherweight",20,"left-handed",11,2,4,17,0.764705882352941
0.071,"welterweight",18,"left-handed",1,12,2,15,0.133333333333333
0.07,"middleweight",10,"left-handed",9,2,0,11,0.818181818181818
0.07,"super bantamweight",16,"left-handed",7,3,0,10,0.7
0.07,"super lightweight",27,"left-handed",12,16,1,29,0.431034482758621
0.069,"super middleweight",13,"left-handed",17,11,0,28,0.607142857142857
0.069,"super middleweight",14,"left-handed",6,1,0,7,0.857142857142857
0.068,"heavyweight",15,"left-handed",4,3,0,7,0.571428571428571
0.068,"featherweight",17,"left-handed",20,11,0,31,0.645161290322581
0.068,"super welterweight",10,"left-handed",6,0,0,6,1
0.067,"super welterweight",16,"left-handed",5,2,1,8,0.6875
0.067,"bantamweight",10,"left-handed",5,4,0,9,0.555555555555556
0.067,"super featherweight",12,"left-handed",11,0,1,12,0.958333333333333
0.067,"heavyweight",13,"left-handed",0,3,2,5,0.2
0.066,"super lightweight",9,"left-handed",2,0,0,2,1
0.066,"lightweight",11,"left-handed",21,0,0,21,1
0.065,"super lightweight",20,"left-handed",4,4,0,8,0.5
0.065,"cruiserweight",30,"left-handed",19,72,4,95,0.221052631578947
0.064,"middleweight",28,"left-handed",22,65,2,89,0.258426966292135
0.064,"welterweight",9,"left-handed",6,0,0,6,1
0.064,"cruiserweight",14,"left-handed",2,0,0,2,1
0.064,"super welterweight",17,"left-handed",4,0,0,4,1
0.064,"super welterweight",16,"left-handed",6,1,0,7,0.857142857142857
0.064,"bantamweight",9,"left-handed",7,8,2,17,0.470588235294118
0.064,"super middleweight",8,"left-handed",4,1,0,5,0.8
0.063,"cruiserweight",10,"left-handed",6,0,0,6,1
0.062,"super lightweight",23,"left-handed",7,16,0,23,0.304347826086957
0.062,"super middleweight",22,"left-handed",5,1,2,8,0.75
0.062,"featherweight",10,"left-handed",5,0,0,5,1
0.062,"light heavyweight",7,"left-handed",7,0,0,7,1
0.062,"lightweight",15,"left-handed",5,0,0,5,1
0.062,"featherweight",15,"left-handed",1,5,1,7,0.214285714285714
0.062,"super bantamweight",9,"left-handed",2,0,0,2,1
0.061,"super bantamweight",14,"left-handed",2,8,2,12,0.25
0.061,"super bantamweight",8,"left-handed",7,1,0,8,0.875
0.061,"featherweight",8,"left-handed",4,1,0,5,0.8
0.06,"middleweight",16,"left-handed",8,0,0,8,1
0.06,"bantamweight",8,"left-handed",4,0,0,4,1
0.059,"super middleweight",23,"left-handed",13,2,2,17,0.823529411764706
0.058,"super flyweight",20,"left-handed",6,4,0,10,0.6
0.058,"super bantamweight",16,"left-handed",5,20,1,26,0.211538461538462
0.058,"welterweight",13,"left-handed",1,1,1,3,0.5
0.057,"flyweight",10,"left-handed",4,4,1,9,0.5
0.057,"featherweight",17,"left-handed",7,37,1,45,0.166666666666667
0.109,"super flyweight",9,"left-handed",2,2,2,6,0.5
0.109,"super featherweight",6,"left-handed",5,0,0,5,1
0.109,"super lightweight",11,"left-handed",4,5,0,9,0.444444444444444
0.107,"heavyweight",9,"left-handed",8,0,0,8,1
0.106,"middleweight",6,"left-handed",3,0,0,3,1
0.103,"light flyweight",7,"left-handed",4,1,0,5,0.8
0.102,"heavyweight",30,"left-handed",4,14,0,18,0.222222222222222
0.101,"featherweight",8,"left-handed",5,3,1,9,0.611111111111111
0.099,"featherweight",20,"left-handed",24,54,2,80,0.3125
0.098,"featherweight",12,"left-handed",6,0,0,6,1
0.098,"flyweight",9,"left-handed",4,1,1,6,0.75
0.098,"super welterweight",10,"left-handed",5,1,0,6,0.833333333333333
0.098,"light heavyweight",20,"left-handed",13,31,2,46,0.304347826086957
0.097,"super lightweight",11,"left-handed",6,0,0,6,1
0.097,"flyweight",11,"left-handed",3,0,0,3,1
0.095,"featherweight",14,"left-handed",13,7,0,20,0.65
0.095,"welterweight",10,"left-handed",3,8,1,12,0.291666666666667
0.095,"super lightweight",7,"left-handed",5,0,0,5,1
0.095,"super welterweight",19,"left-handed",2,1,1,4,0.625
0.094,"super featherweight",10,"left-handed",4,0,0,4,1
0.094,"featherweight",NA,"left-handed",4,0,0,4,1
0.094,"super flyweight",12,"left-handed",8,9,3,20,0.475
0.094,"super lightweight",27,"left-handed",23,55,6,84,0.30952380952381
0.093,"flyweight",7,"left-handed",2,2,0,4,0.5
0.092,"super welterweight",21,"left-handed",5,4,3,12,0.541666666666667
0.092,"super lightweight",16,"left-handed",5,5,0,10,0.5
0.091,"featherweight",20,"left-handed",4,5,3,12,0.458333333333333
0.091,"featherweight",18,"left-handed",8,23,5,36,0.291666666666667
0.09,"super flyweight",16,"left-handed",9,29,1,39,0.243589743589744
0.09,"welterweight",13,"left-handed",3,5,1,9,0.388888888888889
0.088,"lightweight",17,"left-handed",8,1,0,9,0.888888888888889
0.088,"featherweight",15,"left-handed",4,0,1,5,0.9
0.087,"welterweight",13,"left-handed",2,1,0,3,0.666666666666667
0.086,"super featherweight",17,"left-handed",27,8,1,36,0.763888888888889
0.085,"super featherweight",9,"left-handed",6,4,0,10,0.6
0.085,"welterweight",29,"left-handed",33,27,2,62,0.548387096774194
0.083,"super middleweight",11,"left-handed",4,2,0,6,0.666666666666667
0.083,"super bantamweight",21,"left-handed",18,23,2,43,0.441860465116279
0.082,"featherweight",9,"left-handed",2,3,2,7,0.428571428571429
0.082,"lightweight",16,"left-handed",10,1,0,11,0.909090909090909
0.082,"heavyweight",33,"left-handed",14,10,0,24,0.583333333333333
0.08,"heavyweight",23,"left-handed",4,12,1,17,0.264705882352941
0.08,"heavyweight",25,"left-handed",32,24,2,58,0.568965517241379
0.08,"light flyweight",10,"left-handed",6,6,3,15,0.5
0.079,"super welterweight",26,"left-handed",9,36,4,49,0.224489795918367
0.079,"cruiserweight",21,"left-handed",19,16,3,38,0.539473684210526
0.078,"super featherweight",12,"left-handed",2,1,1,4,0.625
0.078,"super bantamweight",14,"left-handed",3,16,1,20,0.175
0.078,"super middleweight",23,"left-handed",5,26,2,33,0.181818181818182
0.075,"super middleweight",10,"left-handed",3,4,1,8,0.4375
0.168,"super lightweight",11,"left-handed",8,1,0,9,0.888888888888889
0.167,"super bantamweight",6,"left-handed",7,0,0,7,1
0.166,"heavyweight",16,"left-handed",5,0,0,5,1
0.166,"super middleweight",14,"left-handed",4,3,0,7,0.571428571428571
0.162,"welterweight",13,"left-handed",4,1,1,6,0.75
0.162,"super welterweight",22,"left-handed",5,3,1,9,0.611111111111111
0.161,"super welterweight",16,"left-handed",6,0,1,7,0.928571428571429
0.158,"super lightweight",17,"left-handed",3,3,0,6,0.5
0.153,"flyweight",9,"left-handed",11,0,0,11,1
0.152,"middleweight",7,"left-handed",2,1,0,3,0.666666666666667
0.152,"super middleweight",6,"left-handed",5,1,0,6,0.833333333333333
0.148,"super bantamweight",11,"left-handed",8,0,0,8,1
0.148,"lightweight",29,"left-handed",10,18,1,29,0.362068965517241
0.146,"bantamweight",13,"left-handed",13,11,1,25,0.54
0.146,"light heavyweight",15,"left-handed",7,0,0,7,1
0.145,"cruiserweight",13,"left-handed",5,16,1,22,0.25
0.145,"flyweight",11,"left-handed",10,6,2,18,0.611111111111111
0.145,"heavyweight",NA,"left-handed",10,3,0,13,0.769230769230769
0.144,"light flyweight",8,"left-handed",9,1,1,11,0.863636363636364
0.143,"super welterweight",13,"left-handed",8,1,0,9,0.888888888888889
0.133,"super lightweight",20,"left-handed",5,2,1,8,0.6875
0.132,"super lightweight",6,"left-handed",7,0,0,7,1
0.131,"super featherweight",23,"left-handed",16,4,1,21,0.785714285714286
0.131,"welterweight",18,"left-handed",6,17,2,25,0.28
0.129,"super featherweight",24,"left-handed",21,6,0,27,0.777777777777778
0.128,"super featherweight",10,"left-handed",3,0,0,3,1
0.127,"middleweight",14,"left-handed",7,10,0,17,0.411764705882353
0.127,"lightweight",5,"left-handed",6,0,0,6,1
0.126,"super bantamweight",15,"left-handed",6,7,1,14,0.464285714285714
0.125,"lightweight",11,"left-handed",6,3,0,9,0.666666666666667
0.124,"middleweight",10,"left-handed",2,1,1,4,0.625
0.124,"super flyweight",22,"left-handed",4,13,4,21,0.285714285714286
0.124,"light heavyweight",13,"left-handed",3,5,0,8,0.375
0.123,"super lightweight",12,"left-handed",3,6,0,9,0.333333333333333
0.123,"featherweight",13,"left-handed",11,13,1,25,0.46
0.123,"featherweight",17,"left-handed",6,2,0,8,0.75
0.122,"welterweight",11,"left-handed",4,1,0,5,0.8
0.121,"welterweight",18,"left-handed",2,8,0,10,0.2
0.121,"lightweight",17,"left-handed",6,8,1,15,0.433333333333333
0.12,"welterweight",18,"left-handed",4,0,0,4,1
0.119,"super middleweight",7,"left-handed",6,1,1,8,0.8125
0.119,"middleweight",NA,"left-handed",16,9,0,25,0.64
0.118,"welterweight",12,"left-handed",6,0,0,6,1
0.117,"cruiserweight",19,"left-handed",5,4,0,9,0.555555555555556
0.116,"lightweight",24,"left-handed",1,9,2,12,0.166666666666667
0.115,"super lightweight",15,"left-handed",4,2,0,6,0.666666666666667
0.113,"super welterweight",16,"left-handed",19,11,0,30,0.633333333333333
0.113,"lightweight",10,"left-handed",9,3,0,12,0.75
0.113,"welterweight",16,"left-handed",8,1,0,9,0.888888888888889
0.11,"super welterweight",18,"left-handed",13,24,3,40,0.3625
0.284,"welterweight",9,"left-handed",4,0,0,4,1
0.283,"super flyweight",15,"left-handed",11,2,0,13,0.846153846153846
0.282,"lightweight",8,"left-handed",2,0,0,2,1
0.281,"cruiserweight",14,"left-handed",4,6,0,10,0.4
0.281,"welterweight",10,"left-handed",3,2,1,6,0.583333333333333
0.281,"middleweight",14,"left-handed",5,0,0,5,1
0.28,"super middleweight",16,"left-handed",10,1,0,11,0.909090909090909
0.28,"super featherweight",16,"left-handed",6,5,3,14,0.535714285714286
0.279,"middleweight",15,"left-handed",4,0,0,4,1
0.276,"middleweight",7,"left-handed",7,0,0,7,1
0.271,"super featherweight",NA,"left-handed",18,8,2,28,0.678571428571429
0.269,"super welterweight",11,"left-handed",11,0,0,11,1
0.266,"super welterweight",16,"left-handed",7,6,0,13,0.538461538461538
0.26,"welterweight",22,"left-handed",26,27,3,56,0.491071428571429
0.256,"super middleweight",16,"left-handed",26,18,3,47,0.585106382978723
0.244,"super bantamweight",4,"left-handed",7,0,0,7,1
0.244,"welterweight",15,"left-handed",19,7,0,26,0.730769230769231
0.242,"lightweight",9,"left-handed",8,1,0,9,0.888888888888889
0.24,"light heavyweight",16,"left-handed",11,8,1,20,0.575
0.237,"super flyweight",8,"left-handed",4,5,1,10,0.45
0.233,"cruiserweight",14,"left-handed",18,40,7,65,0.330769230769231
0.227,"heavyweight",18,"left-handed",4,1,0,5,0.8
0.226,"super lightweight",12,"left-handed",6,2,0,8,0.75
0.226,"middleweight",17,"left-handed",7,6,2,15,0.533333333333333
0.226,"super middleweight",23,"left-handed",32,13,2,47,0.702127659574468
0.222,"super bantamweight",12,"left-handed",5,7,4,16,0.4375
0.222,"light flyweight",8,"left-handed",2,7,0,9,0.222222222222222
0.214,"welterweight",28,"left-handed",12,24,3,39,0.346153846153846
0.213,"middleweight",12,"left-handed",6,3,0,9,0.666666666666667
0.209,"welterweight",7,"left-handed",12,0,0,12,1
0.207,"super welterweight",16,"left-handed",4,6,1,11,0.409090909090909
0.207,"light flyweight",20,"left-handed",7,6,2,15,0.533333333333333
0.202,"super welterweight",23,"left-handed",6,7,1,14,0.464285714285714
0.201,"featherweight",9,"left-handed",9,1,1,11,0.863636363636364
0.2,"lightweight",14,"left-handed",13,6,0,19,0.684210526315789
0.2,"super flyweight",14,"left-handed",6,7,1,14,0.464285714285714
0.193,"lightweight",17,"left-handed",4,11,3,18,0.305555555555556
0.192,"super welterweight",36,"left-handed",12,13,1,26,0.480769230769231
0.192,"welterweight",22,"left-handed",13,10,2,25,0.56
0.189,"super bantamweight",12,"left-handed",5,3,1,9,0.611111111111111
0.188,"lightweight",18,"left-handed",9,4,0,13,0.692307692307692
0.187,"heavyweight",10,"left-handed",3,1,0,4,0.75
0.184,"middleweight",6,"left-handed",1,1,2,4,0.5
0.18,"welterweight",7,"left-handed",8,0,0,8,1
0.178,"lightweight",NA,"left-handed",12,3,0,15,0.8
0.176,"super bantamweight",15,"left-handed",9,0,0,9,1
0.172,"super lightweight",13,"left-handed",4,0,0,4,1
0.171,"cruiserweight",8,"left-handed",7,1,0,8,0.875
0.169,"super featherweight",26,"left-handed",11,8,0,19,0.578947368421053
0.169,"super lightweight",15,"left-handed",2,2,1,5,0.5
0.468,"bantamweight",10,"left-handed",6,5,2,13,0.538461538461538
0.458,"super welterweight",15,"left-handed",4,1,0,5,0.8
0.458,"super featherweight",22,"left-handed",15,14,1,30,0.516666666666667
0.446,"featherweight",16,"left-handed",10,0,1,11,0.954545454545455
0.445,"minimumweight",12,"left-handed",7,4,3,14,0.607142857142857
0.445,"welterweight",19,"left-handed",29,66,8,103,0.320388349514563
0.443,"middleweight",22,"left-handed",6,12,2,20,0.35
0.435,"welterweight",11,"left-handed",9,2,0,11,0.818181818181818
0.424,"super middleweight",16,"left-handed",24,23,0,47,0.51063829787234
0.418,"heavyweight",20,"left-handed",19,11,1,31,0.629032258064516
0.416,"super middleweight",10,"left-handed",2,0,0,2,1
0.41,"flyweight",15,"left-handed",7,10,2,19,0.421052631578947
0.409,"lightweight",10,"left-handed",0,2,0,2,0
0.404,"featherweight",17,"left-handed",21,29,4,54,0.425925925925926
0.398,"cruiserweight",14,"left-handed",11,4,3,18,0.694444444444444
0.398,"featherweight",17,"left-handed",8,11,0,19,0.421052631578947
0.394,"heavyweight",14,"left-handed",7,0,0,7,1
0.392,"super featherweight",8,"left-handed",7,0,0,7,1
0.386,"lightweight",10,"left-handed",4,7,0,11,0.363636363636364
0.385,"welterweight",12,"left-handed",6,1,0,7,0.857142857142857
0.384,"lightweight",19,"left-handed",10,3,0,13,0.769230769230769
0.381,"middleweight",9,"left-handed",3,0,0,3,1
0.38,"bantamweight",7,"left-handed",14,1,0,15,0.933333333333333
0.372,"welterweight",8,"left-handed",1,1,0,2,0.5
0.371,"welterweight",24,"left-handed",16,9,3,28,0.625
0.368,"super bantamweight",9,"left-handed",14,0,1,15,0.966666666666667
0.367,"middleweight",19,"left-handed",6,11,2,19,0.368421052631579
0.367,"bantamweight",24,"left-handed",14,45,6,65,0.261538461538462
0.361,"flyweight",18,"left-handed",9,27,2,38,0.263157894736842
0.359,"super welterweight",15,"left-handed",13,2,1,16,0.84375
0.351,"welterweight",5,"left-handed",4,1,0,5,0.8
0.344,"super flyweight",6,"left-handed",7,3,0,10,0.7
0.34,"welterweight",14,"left-handed",11,5,1,17,0.676470588235294
0.339,"super flyweight",14,"left-handed",11,3,0,14,0.785714285714286
0.335,"middleweight",6,"left-handed",5,0,1,6,0.916666666666667
0.334,"super welterweight",13,"left-handed",1,0,1,2,0.75
0.326,"super featherweight",8,"left-handed",5,0,0,5,1
0.323,"featherweight",23,"left-handed",11,12,1,24,0.479166666666667
0.32,"light heavyweight",22,"left-handed",22,11,3,36,0.652777777777778
0.32,"super bantamweight",NA,"left-handed",4,28,2,34,0.147058823529412
0.318,"featherweight",8,"left-handed",4,1,0,5,0.8
0.318,"flyweight",16,"left-handed",6,0,1,7,0.928571428571429
0.312,"featherweight",9,"left-handed",6,2,0,8,0.75
0.306,"lightweight",11,"left-handed",16,4,3,23,0.760869565217391
0.304,"lightweight",10,"left-handed",4,0,0,4,1
0.298,"flyweight",12,"left-handed",4,4,1,9,0.5
0.297,"super featherweight",12,"left-handed",3,13,1,17,0.205882352941176
0.295,"light heavyweight",30,"left-handed",22,34,1,57,0.394736842105263
0.294,"super middleweight",16,"left-handed",9,2,0,11,0.818181818181818
0.288,"super lightweight",17,"left-handed",11,6,1,18,0.638888888888889
0.681,"light flyweight",9,"left-handed",16,0,0,16,1
0.678,"super lightweight",19,"left-handed",7,1,1,9,0.833333333333333
0.657,"lightweight",9,"left-handed",11,2,0,13,0.846153846153846
0.656,"flyweight",7,"left-handed",9,1,2,12,0.833333333333333
0.654,"minimumweight",11,"left-handed",4,3,1,8,0.5625
0.649,"super lightweight",18,"left-handed",13,19,3,35,0.414285714285714
0.649,"middleweight",22,"left-handed",19,0,0,19,1
0.647,"middleweight",25,"left-handed",17,11,1,29,0.603448275862069
0.646,"welterweight",17,"left-handed",9,6,1,16,0.59375
0.642,"bantamweight",7,"left-handed",3,1,0,4,0.75
0.636,"welterweight",14,"left-handed",8,2,0,10,0.8
0.621,"welterweight",24,"left-handed",27,31,5,63,0.468253968253968
0.619,"super lightweight",13,"left-handed",9,3,3,15,0.7
0.613,"heavyweight",23,"left-handed",21,13,1,35,0.614285714285714
0.596,"super flyweight",10,"left-handed",6,1,0,7,0.857142857142857
0.592,"featherweight",NA,"left-handed",3,1,1,5,0.7
0.589,"super welterweight",20,"left-handed",11,4,0,15,0.733333333333333
0.588,"super welterweight",12,"left-handed",4,8,1,13,0.346153846153846
0.585,"heavyweight",13,"left-handed",9,3,0,12,0.75
0.579,"super bantamweight",19,"left-handed",22,35,7,64,0.3984375
0.577,"middleweight",19,"left-handed",6,34,4,44,0.181818181818182
0.572,"light heavyweight",17,"left-handed",7,12,1,20,0.375
0.569,"lightweight",9,"left-handed",7,13,0,20,0.35
0.562,"middleweight",21,"left-handed",10,63,5,78,0.16025641025641
0.561,"super featherweight",6,"left-handed",5,0,0,5,1
0.56,"lightweight",10,"left-handed",15,2,0,17,0.882352941176471
0.559,"lightweight",23,"left-handed",7,7,2,16,0.5
0.552,"flyweight",7,"left-handed",6,1,0,7,0.857142857142857
0.551,"super lightweight",13,"left-handed",4,4,5,13,0.5
0.549,"featherweight",10,"left-handed",9,4,0,13,0.692307692307692
0.547,"super welterweight",15,"left-handed",7,4,0,11,0.636363636363636
0.546,"super welterweight",7,"left-handed",5,0,1,6,0.916666666666667
0.542,"super lightweight",13,"left-handed",9,0,0,9,1
0.526,"middleweight",17,"left-handed",14,5,1,20,0.725
0.525,"light heavyweight",16,"left-handed",5,0,0,5,1
0.524,"super lightweight",10,"left-handed",9,1,0,10,0.9
0.519,"lightweight",14,"left-handed",2,15,1,18,0.138888888888889
0.516,"heavyweight",7,"left-handed",1,2,0,3,0.333333333333333
0.515,"super lightweight",25,"left-handed",6,21,1,28,0.232142857142857
0.51,"super lightweight",16,"left-handed",10,5,0,15,0.666666666666667
0.509,"welterweight",17,"left-handed",7,10,2,19,0.421052631578947
0.506,"cruiserweight",22,"left-handed",18,37,2,57,0.333333333333333
0.505,"super welterweight",21,"left-handed",1,4,4,9,0.333333333333333
0.501,"super flyweight",21,"left-handed",7,8,3,18,0.472222222222222
0.497,"super middleweight",7,"left-handed",2,8,0,10,0.2
0.497,"super featherweight",8,"left-handed",8,1,0,9,0.888888888888889
0.495,"flyweight",5,"left-handed",6,0,1,7,0.928571428571429
0.488,"featherweight",12,"left-handed",11,1,1,13,0.884615384615385
0.484,"lightweight",11,"left-handed",6,8,1,15,0.433333333333333
0.469,"super featherweight",10,"left-handed",18,2,1,21,0.880952380952381
1.077,"lightweight",13,"left-handed",3,0,0,3,1
1.073,"welterweight",13,"left-handed",10,7,1,18,0.583333333333333
1.069,"super flyweight",12,"left-handed",4,10,3,17,0.323529411764706
1.062,"flyweight",10,"left-handed",10,11,2,23,0.478260869565217
1.026,"super lightweight",9,"left-handed",7,0,0,7,1
1.007,"middleweight",17,"left-handed",2,7,4,13,0.307692307692308
1.004,"light flyweight",11,"left-handed",10,8,1,19,0.552631578947368
0.987,"super bantamweight",16,"left-handed",20,8,3,31,0.693548387096774
0.969,"super featherweight",4,"left-handed",6,1,3,10,0.75
0.96,"super welterweight",18,"left-handed",12,1,0,13,0.923076923076923
0.96,"lightweight",5,"left-handed",4,0,0,4,1
0.959,"cruiserweight",10,"left-handed",9,26,3,38,0.276315789473684
0.956,"featherweight",8,"left-handed",24,2,0,26,0.923076923076923
0.95,"light heavyweight",13,"left-handed",12,0,0,12,1
0.943,"cruiserweight",12,"left-handed",5,0,0,5,1
0.942,"super welterweight",19,"left-handed",13,3,1,17,0.794117647058823
0.93,"light heavyweight",NA,"left-handed",6,3,2,11,0.636363636363636
0.925,"cruiserweight",22,"left-handed",6,6,1,13,0.5
0.916,"super lightweight",14,"left-handed",10,2,2,14,0.785714285714286
0.912,"super lightweight",14,"left-handed",10,2,0,12,0.833333333333333
0.904,"light heavyweight",10,"left-handed",14,3,0,17,0.823529411764706
0.892,"super welterweight",16,"left-handed",13,1,0,14,0.928571428571429
0.892,"super welterweight",NA,"left-handed",7,0,0,7,1
0.875,"heavyweight",19,"left-handed",4,7,5,16,0.40625
0.865,"light heavyweight",32,"left-handed",44,8,0,52,0.846153846153846
0.863,"super bantamweight",8,"left-handed",1,0,0,1,1
0.85,"middleweight",20,"left-handed",13,6,0,19,0.684210526315789
0.846,"light heavyweight",17,"left-handed",7,1,0,8,0.875
0.845,"bantamweight",14,"left-handed",11,27,2,40,0.3
0.809,"welterweight",10,"left-handed",7,6,0,13,0.538461538461538
0.804,"light flyweight",NA,"left-handed",6,13,3,22,0.340909090909091
0.8,"super flyweight",9,"left-handed",9,2,1,12,0.791666666666667
0.795,"light heavyweight",9,"left-handed",4,7,1,12,0.375
0.79,"super middleweight",10,"left-handed",12,0,1,13,0.961538461538462
0.788,"super welterweight",20,"left-handed",12,2,2,16,0.8125
0.781,"welterweight",10,"left-handed",3,0,0,3,1
0.769,"super bantamweight",6,"left-handed",6,0,0,6,1
0.768,"super lightweight",11,"left-handed",4,0,0,4,1
0.748,"super welterweight",21,"left-handed",15,12,3,30,0.55
0.746,"lightweight",8,"left-handed",9,1,1,11,0.863636363636364
0.744,"featherweight",16,"left-handed",12,1,1,14,0.892857142857143
0.734,"middleweight",29,"left-handed",26,16,0,42,0.619047619047619
0.727,"light heavyweight",16,"left-handed",20,12,1,33,0.621212121212121
0.725,"heavyweight",20,"left-handed",7,16,2,25,0.32
0.719,"light heavyweight",14,"left-handed",10,8,0,18,0.555555555555556
0.716,"super middleweight",15,"left-handed",13,1,0,14,0.928571428571429
0.711,"light flyweight",11,"left-handed",7,1,1,9,0.833333333333333
0.697,"super middleweight",16,"left-handed",5,13,2,20,0.3
0.689,"flyweight",7,"left-handed",6,1,2,9,0.777777777777778
0.686,"flyweight",12,"left-handed",5,0,0,5,1
1.661,"super featherweight",8,"left-handed",4,0,0,4,1
1.619,"heavyweight",27,"left-handed",7,11,1,19,0.394736842105263
1.616,"light heavyweight",11,"left-handed",6,0,0,6,1
1.614,"lightweight",15,"left-handed",5,2,2,9,0.666666666666667
1.609,"featherweight",NA,"left-handed",8,30,4,42,0.238095238095238
1.593,"lightweight",6,"left-handed",7,0,0,7,1
1.573,"super middleweight",7,"left-handed",4,0,0,4,1
1.566,"super lightweight",18,"left-handed",12,6,0,18,0.666666666666667
1.557,"lightweight",6,"left-handed",2,0,1,3,0.833333333333333
1.535,"middleweight",10,"left-handed",8,5,1,14,0.607142857142857
1.522,"featherweight",11,"left-handed",5,1,2,8,0.75
1.52,"bantamweight",19,"left-handed",18,24,4,46,0.434782608695652
1.491,"featherweight",12,"left-handed",4,0,0,4,1
1.48,"light heavyweight",7,"left-handed",6,0,0,6,1
1.468,"heavyweight",16,"left-handed",8,5,0,13,0.615384615384615
1.452,"super middleweight",18,"left-handed",5,12,1,18,0.305555555555556
1.433,"super welterweight",24,"left-handed",10,4,2,16,0.6875
1.423,"bantamweight",NA,"left-handed",5,5,0,10,0.5
1.422,"cruiserweight",13,"left-handed",8,3,1,12,0.708333333333333
1.398,"featherweight",11,"left-handed",11,7,0,18,0.611111111111111
1.387,"heavyweight",22,"left-handed",13,26,1,40,0.3375
1.382,"super middleweight",10,"left-handed",9,0,0,9,1
1.38,"middleweight",14,"left-handed",1,1,0,2,0.5
1.376,"super lightweight",10,"left-handed",15,0,0,15,1
1.367,"welterweight",NA,"left-handed",6,1,0,7,0.857142857142857
1.349,"super featherweight",16,"left-handed",8,13,0,21,0.380952380952381
1.337,"super middleweight",11,"left-handed",4,14,0,18,0.222222222222222
1.305,"welterweight",13,"left-handed",6,1,2,9,0.777777777777778
1.283,"super welterweight",15,"left-handed",3,3,2,8,0.5
1.267,"super lightweight",20,"left-handed",14,5,1,20,0.725
1.241,"featherweight",7,"left-handed",6,3,1,10,0.65
1.237,"welterweight",14,"left-handed",9,1,1,11,0.863636363636364
1.235,"welterweight",11,"left-handed",10,4,0,14,0.714285714285714
1.232,"super welterweight",11,"left-handed",12,3,1,16,0.78125
1.231,"super middleweight",27,"left-handed",12,7,0,19,0.631578947368421
1.23,"super middleweight",16,"left-handed",6,0,0,6,1
1.224,"super featherweight",19,"left-handed",5,3,0,8,0.625
1.223,"super lightweight",18,"left-handed",7,12,3,22,0.386363636363636
1.2,"lightweight",16,"left-handed",9,10,2,21,0.476190476190476
1.168,"flyweight",12,"left-handed",5,4,1,10,0.55
1.146,"super lightweight",8,"left-handed",8,0,0,8,1
1.137,"middleweight",14,"left-handed",5,1,0,6,0.833333333333333
1.127,"super lightweight",NA,"left-handed",3,3,0,6,0.5
1.126,"featherweight",10,"left-handed",9,8,0,17,0.529411764705882
1.119,"welterweight",11,"left-handed",7,1,0,8,0.875
1.11,"heavyweight",NA,"left-handed",7,0,1,8,0.9375
1.108,"flyweight",9,"left-handed",8,0,1,9,0.944444444444444
1.096,"minimumweight",13,"left-handed",6,27,2,35,0.2
1.09,"light flyweight",9,"left-handed",6,2,0,8,0.75
1.084,"super bantamweight",17,"left-handed",10,23,1,34,0.308823529411765
2.355,"lightweight",8,"left-handed",9,0,0,9,1
2.329,"cruiserweight",21,"left-handed",25,19,3,47,0.563829787234043
2.312,"super lightweight",19,"left-handed",15,0,0,15,1
2.309,"super bantamweight",12,"left-handed",13,1,1,15,0.9
2.287,"super lightweight",24,"left-handed",26,14,0,40,0.65
2.264,"lightweight",14,"left-handed",8,1,1,10,0.85
2.258,"lightweight",5,"left-handed",8,0,0,8,1
2.243,"super lightweight",21,"left-handed",16,4,2,22,0.772727272727273
2.221,"super welterweight",18,"left-handed",20,5,0,25,0.8
2.21,"lightweight",14,"left-handed",14,5,4,23,0.695652173913043
2.179,"super welterweight",12,"left-handed",3,2,1,6,0.583333333333333
2.175,"cruiserweight",31,"left-handed",32,3,0,35,0.914285714285714
2.169,"super featherweight",7,"left-handed",8,0,0,8,1
2.163,"cruiserweight",NA,"left-handed",12,28,7,47,0.329787234042553
2.144,"lightweight",16,"left-handed",24,6,3,33,0.772727272727273
2.142,"super featherweight",22,"left-handed",16,7,1,24,0.6875
2.136,"lightweight",12,"left-handed",7,1,0,8,0.875
2.101,"super flyweight",17,"left-handed",17,20,1,38,0.460526315789474
2.064,"super featherweight",18,"left-handed",28,12,3,43,0.686046511627907
2.05,"super bantamweight",14,"left-handed",5,6,0,11,0.454545454545455
2.027,"featherweight",15,"left-handed",7,8,4,19,0.473684210526316
2.025,"super welterweight",11,"left-handed",0,0,1,1,0.5
2.017,"super lightweight",12,"left-handed",3,5,0,8,0.375
2.005,"heavyweight",20,"left-handed",11,2,1,14,0.821428571428571
1.987,"super featherweight",16,"left-handed",25,10,3,38,0.697368421052632
1.973,"featherweight",12,"left-handed",9,0,0,9,1
1.928,"cruiserweight",21,"left-handed",16,16,4,36,0.5
1.885,"welterweight",20,"left-handed",12,7,1,20,0.625
1.88,"super welterweight",17,"left-handed",6,26,4,36,0.222222222222222
1.873,"flyweight",6,"left-handed",10,0,0,10,1
1.87,"super welterweight",11,"left-handed",4,3,0,7,0.571428571428571
1.863,"light heavyweight",11,"left-handed",4,7,0,11,0.363636363636364
1.854,"light flyweight",10,"left-handed",1,1,0,2,0.5
1.824,"light heavyweight",12,"left-handed",16,0,0,16,1
1.804,"super welterweight",14,"left-handed",10,5,0,15,0.666666666666667
1.8,"heavyweight",11,"left-handed",11,4,1,16,0.71875
1.795,"heavyweight",16,"left-handed",13,26,3,42,0.345238095238095
1.794,"super lightweight",26,"left-handed",12,19,1,32,0.390625
1.794,"lightweight",17,"left-handed",16,2,1,19,0.868421052631579
1.788,"featherweight",8,"left-handed",13,0,0,13,1
1.766,"featherweight",11,"left-handed",3,2,1,6,0.583333333333333
1.764,"flyweight",NA,"left-handed",11,11,1,23,0.5
1.762,"lightweight",9,"left-handed",6,0,0,6,1
1.746,"super middleweight",19,"left-handed",10,9,0,19,0.526315789473684
1.733,"super flyweight",18,"left-handed",31,12,1,44,0.715909090909091
1.73,"super bantamweight",8,"left-handed",12,6,0,18,0.666666666666667
1.709,"super welterweight",12,"left-handed",8,2,0,10,0.8
1.704,"super welterweight",5,"left-handed",5,0,0,5,1
1.68,"lightweight",16,"left-handed",13,1,1,15,0.9
1.671,"lightweight",26,"left-handed",31,36,4,71,0.464788732394366
2.984,"lightweight",11,"left-handed",11,1,1,13,0.884615384615385
2.982,"super featherweight",16,"left-handed",4,4,2,10,0.5
2.976,"featherweight",28,"left-handed",46,28,1,75,0.62
2.958,"lightweight",10,"left-handed",8,2,2,12,0.75
2.94,"super lightweight",14,"left-handed",4,2,0,6,0.666666666666667
2.94,"lightweight",11,"left-handed",9,1,0,10,0.9
2.917,"super middleweight",16,"left-handed",9,0,0,9,1
2.883,"super lightweight",14,"left-handed",5,5,0,10,0.5
2.86,"super lightweight",8,"left-handed",3,2,0,5,0.6
2.849,"super flyweight",11,"left-handed",7,6,2,15,0.533333333333333
2.794,"lightweight",23,"left-handed",19,11,0,30,0.633333333333333
2.772,"super lightweight",12,"left-handed",6,0,0,6,1
2.765,"super bantamweight",19,"left-handed",18,18,1,37,0.5
2.743,"bantamweight",NA,"left-handed",17,14,4,35,0.542857142857143
2.697,"super lightweight",22,"left-handed",13,4,1,18,0.75
2.687,"lightweight",21,"left-handed",9,13,1,23,0.41304347826087
2.66,"featherweight",9,"left-handed",10,1,0,11,0.909090909090909
2.657,"welterweight",15,"left-handed",11,1,0,12,0.916666666666667
2.651,"heavyweight",29,"left-handed",16,14,0,30,0.533333333333333
2.633,"featherweight",11,"left-handed",14,0,1,15,0.966666666666667
2.62,"lightweight",11,"left-handed",3,4,0,7,0.428571428571429
2.614,"middleweight",16,"left-handed",16,4,0,20,0.8
2.61,"super welterweight",11,"left-handed",5,10,3,18,0.361111111111111
2.585,"featherweight",14,"left-handed",5,4,0,9,0.555555555555556
2.583,"heavyweight",33,"left-handed",35,33,1,69,0.514492753623188
2.556,"featherweight",10,"left-handed",6,0,0,6,1
2.546,"heavyweight",15,"left-handed",15,2,1,18,0.861111111111111
2.539,"flyweight",NA,"left-handed",4,2,1,7,0.642857142857143
2.522,"super welterweight",24,"left-handed",1,0,0,1,1
2.521,"lightweight",8,"left-handed",10,0,0,10,1
2.48,"flyweight",15,"left-handed",8,16,1,25,0.34
2.464,"lightweight",24,"left-handed",6,5,0,11,0.545454545454545
2.455,"lightweight",18,"left-handed",20,14,3,37,0.581081081081081
2.426,"lightweight",24,"left-handed",20,8,0,28,0.714285714285714
2.423,"super middleweight",19,"left-handed",7,1,2,10,0.8
2.41,"super bantamweight",15,"left-handed",8,6,4,18,0.555555555555556
2.398,"super lightweight",20,"left-handed",4,14,1,19,0.236842105263158
2.388,"flyweight",12,"left-handed",8,5,2,15,0.6
2.377,"super lightweight",18,"left-handed",9,4,0,13,0.692307692307692
2.364,"welterweight",13,"left-handed",6,3,0,9,0.666666666666667
0.019,"super middleweight",22,"right-handed",5,104,1,110,0.05
0.019,"super welterweight",25,"right-handed",15,188,12,215,0.0976744186046512
0.019,"super welterweight",19,"right-handed",1,31,0,32,0.03125
0.018,"super lightweight",18,"right-handed",12,56,0,68,0.176470588235294
0.017,"middleweight",10,"right-handed",3,36,1,40,0.0875
0.016,"middleweight",26,"right-handed",2,37,3,42,0.0833333333333333
0.015,"super welterweight",15,"right-handed",0,35,0,35,0
0.015,"lightweight",14,"right-handed",2,39,4,45,0.0888888888888889
0.014,"super lightweight",19,"right-handed",6,158,4,168,0.0476190476190476
0.013,"middleweight",23,"right-handed",2,37,1,40,0.0625
0.013,"heavyweight",14,"right-handed",7,41,0,48,0.145833333333333
0.013,"super lightweight",14,"right-handed",7,88,0,95,0.0736842105263158
0.013,"super welterweight",34,"right-handed",11,47,0,58,0.189655172413793
0.012,"super featherweight",22,"right-handed",14,58,5,77,0.214285714285714
0.011,"cruiserweight",31,"right-handed",10,48,1,59,0.177966101694915
0.011,"super bantamweight",19,"right-handed",6,51,0,57,0.105263157894737
0.01,"super featherweight",14,"right-handed",2,43,2,47,0.0638297872340425
0.01,"super lightweight",16,"right-handed",0,40,3,43,0.0348837209302326
0.01,"super middleweight",23,"right-handed",0,40,0,40,0
0.009,"featherweight",20,"right-handed",16,58,5,79,0.234177215189873
0.009,"super bantamweight",21,"right-handed",9,50,4,63,0.174603174603175
0.008,"lightweight",10,"right-handed",7,45,1,53,0.141509433962264
0.007,"welterweight",25,"right-handed",8,53,1,62,0.137096774193548
0.007,"cruiserweight",21,"right-handed",3,44,0,47,0.0638297872340425
0.006,"middleweight",NA,"right-handed",0,44,2,46,0.0217391304347826
0.006,"super middleweight",14,"right-handed",8,99,1,108,0.0787037037037037
0.003,"light heavyweight",30,"right-handed",19,58,0,77,0.246753246753247
0.002,"lightweight",12,"right-handed",2,62,1,65,0.0384615384615385
0.03,"lightweight",9,"right-handed",0,20,0,20,0
0.03,"cruiserweight",23,"right-handed",3,56,4,63,0.0793650793650794
0.029,"lightweight",18,"right-handed",4,42,1,47,0.0957446808510638
0.029,"super featherweight",11,"right-handed",0,20,0,20,0
0.029,"super featherweight",19,"right-handed",4,36,2,42,0.119047619047619
0.029,"super middleweight",21,"right-handed",3,26,1,30,0.116666666666667
0.028,"super middleweight",18,"right-handed",1,22,3,26,0.0961538461538462
0.028,"bantamweight",NA,"right-handed",1,22,0,23,0.0434782608695652
0.028,"super welterweight",19,"right-handed",10,37,2,49,0.224489795918367
0.028,"super bantamweight",NA,"right-handed",5,22,0,27,0.185185185185185
0.028,"super lightweight",28,"right-handed",0,22,0,22,0
0.028,"cruiserweight",15,"right-handed",6,31,1,38,0.171052631578947
0.028,"light heavyweight",9,"right-handed",2,24,0,26,0.0769230769230769
0.027,"super lightweight",25,"right-handed",2,23,4,29,0.137931034482759
0.027,"super welterweight",27,"right-handed",6,55,2,63,0.111111111111111
0.027,"lightweight",9,"right-handed",2,41,1,44,0.0568181818181818
0.027,"super lightweight",21,"right-handed",0,23,0,23,0
0.027,"lightweight",22,"right-handed",1,37,1,39,0.0384615384615385
0.026,"super lightweight",22,"right-handed",6,33,2,41,0.170731707317073
0.026,"super lightweight",9,"right-handed",1,43,0,44,0.0227272727272727
0.026,"super lightweight",25,"right-handed",20,67,4,91,0.241758241758242
0.026,"welterweight",12,"right-handed",3,34,4,41,0.121951219512195
0.026,"lightweight",16,"right-handed",15,34,0,49,0.306122448979592
0.026,"super welterweight",28,"right-handed",0,24,0,24,0
0.026,"super lightweight",20,"right-handed",9,31,0,40,0.225
0.025,"super featherweight",16,"right-handed",9,33,5,47,0.24468085106383
0.025,"middleweight",8,"right-handed",0,25,0,25,0
0.025,"super middleweight",9,"right-handed",2,25,0,27,0.0740740740740741
0.025,"cruiserweight",13,"right-handed",4,34,1,39,0.115384615384615
0.025,"featherweight",15,"right-handed",3,37,1,41,0.0853658536585366
0.025,"cruiserweight",17,"right-handed",1,25,0,26,0.0384615384615385
0.025,"featherweight",9,"right-handed",0,25,0,25,0
0.025,"super welterweight",13,"right-handed",0,25,1,26,0.0192307692307692
0.025,"super welterweight",32,"right-handed",8,53,2,63,0.142857142857143
0.024,"super middleweight",13,"right-handed",7,52,3,62,0.137096774193548
0.023,"super welterweight",23,"right-handed",4,40,2,46,0.108695652173913
0.023,"light heavyweight",13,"right-handed",0,27,2,29,0.0344827586206897
0.023,"light heavyweight",10,"right-handed",3,40,0,43,0.0697674418604651
0.023,"cruiserweight",27,"right-handed",3,88,2,93,0.043010752688172
0.023,"super welterweight",21,"right-handed",5,37,2,44,0.136363636363636
0.023,"flyweight",25,"right-handed",0,27,0,27,0
0.022,"featherweight",24,"right-handed",0,25,1,26,0.0192307692307692
0.022,"light heavyweight",26,"right-handed",4,41,1,46,0.0978260869565217
0.022,"cruiserweight",23,"right-handed",1,31,2,34,0.0588235294117647
0.021,"middleweight",26,"right-handed",3,36,2,41,0.0975609756097561
0.021,"super lightweight",30,"right-handed",3,36,0,39,0.0769230769230769
0.02,"lightweight",27,"right-handed",2,31,4,37,0.108108108108108
0.02,"light heavyweight",19,"right-handed",0,30,0,30,0
0.02,"middleweight",12,"right-handed",11,34,0,45,0.244444444444444
0.019,"heavyweight",23,"right-handed",2,39,0,41,0.0487804878048781
0.035,"heavyweight",20,"right-handed",21,73,7,101,0.242574257425743
0.035,"middleweight",26,"right-handed",3,18,0,21,0.142857142857143
0.035,"welterweight",11,"right-handed",1,1,0,2,0.5
0.035,"lightweight",15,"right-handed",0,13,1,14,0.0357142857142857
0.035,"super middleweight",7,"right-handed",0,14,0,14,0
0.035,"middleweight",22,"right-handed",1,16,0,17,0.0588235294117647
0.035,"featherweight",19,"right-handed",0,5,0,5,0
0.035,"featherweight",20,"right-handed",0,15,0,15,0
0.035,"super welterweight",24,"right-handed",9,31,1,41,0.231707317073171
0.035,"featherweight",22,"right-handed",2,21,0,23,0.0869565217391304
0.035,"super bantamweight",13,"right-handed",0,15,0,15,0
0.035,"super middleweight",17,"right-handed",2,29,2,33,0.0909090909090909
0.035,"lightweight",32,"right-handed",1,21,3,25,0.1
0.035,"middleweight",10,"right-handed",0,15,0,15,0
0.035,"light heavyweight",18,"right-handed",2,18,1,21,0.119047619047619
0.035,"cruiserweight",28,"right-handed",6,32,0,38,0.157894736842105
0.034,"super middleweight",23,"right-handed",15,37,2,54,0.296296296296296
0.034,"welterweight",7,"right-handed",0,16,2,18,0.0555555555555556
0.034,"heavyweight",37,"right-handed",3,26,3,32,0.140625
0.034,"super middleweight",13,"right-handed",0,9,0,9,0
0.034,"super lightweight",NA,"right-handed",1,15,0,16,0.0625
0.034,"lightweight",11,"right-handed",0,16,0,16,0
0.034,"super middleweight",NA,"right-handed",1,37,2,40,0.05
0.034,"cruiserweight",17,"right-handed",1,16,0,17,0.0588235294117647
0.034,"lightweight",NA,"right-handed",0,16,0,16,0
0.033,"super lightweight",15,"right-handed",3,15,1,19,0.184210526315789
0.033,"middleweight",18,"right-handed",1,17,0,18,0.0555555555555556
0.033,"welterweight",13,"right-handed",2,19,0,21,0.0952380952380952
0.033,"super bantamweight",24,"right-handed",1,24,0,25,0.04
0.033,"super bantamweight",25,"right-handed",2,20,0,22,0.0909090909090909
0.033,"lightweight",12,"right-handed",0,17,0,17,0
0.032,"middleweight",16,"right-handed",4,37,1,42,0.107142857142857
0.032,"flyweight",10,"right-handed",3,18,5,26,0.211538461538462
0.032,"super bantamweight",20,"right-handed",2,18,2,22,0.136363636363636
0.032,"super middleweight",24,"right-handed",3,18,0,21,0.142857142857143
0.032,"featherweight",14,"right-handed",3,26,2,31,0.129032258064516
0.032,"cruiserweight",32,"right-handed",5,42,2,49,0.122448979591837
0.031,"middleweight",25,"right-handed",1,21,2,24,0.0833333333333333
0.031,"super featherweight",20,"right-handed",2,26,0,28,0.0714285714285714
0.031,"cruiserweight",13,"right-handed",0,19,0,19,0
0.031,"lightweight",27,"right-handed",0,20,1,21,0.0238095238095238
0.031,"featherweight",14,"right-handed",0,28,1,29,0.0172413793103448
0.03,"super welterweight",15,"right-handed",3,23,1,27,0.12962962962963
0.03,"light heavyweight",14,"right-handed",17,28,2,47,0.382978723404255
0.03,"super lightweight",13,"right-handed",1,19,1,21,0.0714285714285714
0.03,"light heavyweight",25,"right-handed",9,21,0,30,0.3
0.03,"super middleweight",24,"right-handed",0,20,0,20,0
0.03,"lightweight",16,"right-handed",7,47,2,56,0.142857142857143
0.03,"super welterweight",11,"right-handed",7,36,0,43,0.162790697674419
0.03,"flyweight",24,"right-handed",1,20,0,21,0.0476190476190476
0.038,"welterweight",NA,"right-handed",0,3,0,3,0
0.037,"super featherweight",11,"right-handed",5,19,1,25,0.22
0.037,"middleweight",32,"right-handed",5,22,4,31,0.225806451612903
0.037,"lightweight",13,"right-handed",4,26,0,30,0.133333333333333
0.037,"light heavyweight",10,"right-handed",1,13,3,17,0.147058823529412
0.037,"middleweight",12,"right-handed",1,20,0,21,0.0476190476190476
0.037,"super welterweight",18,"right-handed",9,51,3,63,0.166666666666667
0.037,"super lightweight",23,"right-handed",1,30,0,31,0.032258064516129
0.037,"middleweight",21,"right-handed",2,13,1,16,0.15625
0.037,"middleweight",20,"right-handed",12,28,3,43,0.313953488372093
0.037,"heavyweight",21,"right-handed",2,24,2,28,0.107142857142857
0.037,"featherweight",13,"right-handed",4,11,0,15,0.266666666666667
0.037,"light heavyweight",26,"right-handed",1,14,3,18,0.138888888888889
0.037,"super flyweight",NA,"right-handed",2,13,4,19,0.210526315789474
0.037,"welterweight",23,"right-handed",5,3,0,8,0.625
0.037,"lightweight",7,"right-handed",0,13,3,16,0.09375
0.037,"lightweight",12,"right-handed",0,13,0,13,0
0.037,"super welterweight",20,"right-handed",2,30,1,33,0.0757575757575758
0.037,"welterweight",11,"right-handed",4,83,2,89,0.0561797752808989
0.037,"super welterweight",NA,"right-handed",0,13,0,13,0
0.037,"super bantamweight",10,"right-handed",1,10,0,11,0.0909090909090909
0.037,"featherweight",8,"right-handed",0,13,0,13,0
0.037,"super bantamweight",12,"right-handed",0,13,1,14,0.0357142857142857
0.037,"middleweight",20,"right-handed",0,7,1,8,0.0625
0.037,"super middleweight",25,"right-handed",2,19,0,21,0.0952380952380952
0.037,"cruiserweight",10,"right-handed",10,28,2,40,0.275
0.037,"welterweight",16,"right-handed",1,16,1,18,0.0833333333333333
0.037,"super lightweight",11,"right-handed",9,21,1,31,0.306451612903226
0.037,"super featherweight",14,"right-handed",6,14,1,21,0.30952380952381
0.037,"welterweight",25,"right-handed",5,18,0,23,0.217391304347826
0.036,"middleweight",21,"right-handed",0,18,1,19,0.0263157894736842
0.036,"lightweight",12,"right-handed",16,21,0,37,0.432432432432432
0.036,"super middleweight",20,"right-handed",11,37,2,50,0.24
0.036,"featherweight",20,"right-handed",3,14,0,17,0.176470588235294
0.036,"middleweight",15,"right-handed",4,23,2,29,0.172413793103448
0.036,"middleweight",15,"right-handed",9,20,3,32,0.328125
0.036,"light heavyweight",20,"right-handed",4,14,1,19,0.236842105263158
0.036,"cruiserweight",29,"right-handed",14,39,1,54,0.268518518518519
0.036,"middleweight",18,"right-handed",5,81,1,87,0.0632183908045977
0.036,"super featherweight",20,"right-handed",0,14,0,14,0
0.036,"super lightweight",19,"right-handed",3,27,0,30,0.1
0.036,"super bantamweight",NA,"right-handed",1,18,0,19,0.0526315789473684
0.036,"light flyweight",14,"right-handed",0,14,1,15,0.0333333333333333
0.036,"light heavyweight",26,"right-handed",9,35,1,45,0.211111111111111
0.036,"super welterweight",21,"right-handed",11,17,0,28,0.392857142857143
0.036,"light heavyweight",16,"right-handed",11,36,1,48,0.239583333333333
0.036,"cruiserweight",27,"right-handed",27,47,1,75,0.366666666666667
0.035,"super welterweight",16,"right-handed",7,63,1,71,0.105633802816901
0.035,"middleweight",18,"right-handed",2,22,1,25,0.1
0.035,"light heavyweight",21,"right-handed",2,17,2,21,0.142857142857143
0.04,"super flyweight",14,"right-handed",4,13,0,17,0.235294117647059
0.04,"middleweight",20,"right-handed",11,12,0,23,0.478260869565217
0.04,"featherweight",19,"right-handed",2,13,2,17,0.176470588235294
0.039,"cruiserweight",17,"right-handed",7,24,1,32,0.234375
0.039,"super featherweight",16,"right-handed",3,13,1,17,0.205882352941176
0.039,"middleweight",26,"right-handed",13,16,1,30,0.45
0.039,"bantamweight",30,"right-handed",12,77,5,94,0.154255319148936
0.039,"middleweight",31,"right-handed",7,29,2,38,0.210526315789474
0.039,"welterweight",10,"right-handed",2,19,0,21,0.0952380952380952
0.039,"cruiserweight",23,"right-handed",5,22,0,27,0.185185185185185
0.039,"super middleweight",30,"right-handed",4,50,0,54,0.0740740740740741
0.039,"heavyweight",25,"right-handed",2,16,0,18,0.111111111111111
0.039,"minimumweight",12,"right-handed",3,14,0,17,0.176470588235294
0.039,"lightweight",10,"right-handed",9,13,1,23,0.41304347826087
0.039,"middleweight",27,"right-handed",2,11,0,13,0.153846153846154
0.039,"super middleweight",NA,"right-handed",6,12,0,18,0.333333333333333
0.039,"middleweight",27,"right-handed",1,16,2,19,0.105263157894737
0.039,"super bantamweight",12,"right-handed",3,25,1,29,0.120689655172414
0.039,"super lightweight",6,"right-handed",1,11,0,12,0.0833333333333333
0.039,"featherweight",5,"right-handed",1,11,0,12,0.0833333333333333
0.039,"heavyweight",28,"right-handed",0,2,0,2,0
0.039,"welterweight",27,"right-handed",1,11,0,12,0.0833333333333333
0.039,"middleweight",25,"right-handed",0,11,0,11,0
0.039,"super bantamweight",11,"right-handed",0,11,0,11,0
0.039,"flyweight",NA,"right-handed",0,11,1,12,0.0416666666666667
0.039,"featherweight",23,"right-handed",0,11,0,11,0
0.039,"lightweight",25,"right-handed",0,9,0,9,0
0.039,"super lightweight",26,"right-handed",2,12,2,16,0.1875
0.039,"super bantamweight",11,"right-handed",4,16,0,20,0.2
0.039,"welterweight",23,"right-handed",7,20,2,29,0.275862068965517
0.039,"light heavyweight",26,"right-handed",3,21,0,24,0.125
0.039,"super lightweight",21,"right-handed",0,14,2,16,0.0625
0.038,"bantamweight",16,"right-handed",3,21,1,25,0.14
0.038,"welterweight",27,"right-handed",6,31,1,38,0.171052631578947
0.038,"welterweight",12,"right-handed",3,47,4,54,0.0925925925925926
0.038,"super flyweight",15,"right-handed",10,30,1,41,0.25609756097561
0.038,"welterweight",NA,"right-handed",2,13,0,15,0.133333333333333
0.038,"lightweight",8,"right-handed",4,13,0,17,0.235294117647059
0.038,"cruiserweight",18,"right-handed",3,23,0,26,0.115384615384615
0.038,"middleweight",20,"right-handed",3,12,0,15,0.2
0.038,"flyweight",14,"right-handed",4,17,0,21,0.19047619047619
0.038,"heavyweight",9,"right-handed",4,16,0,20,0.2
0.038,"heavyweight",25,"right-handed",8,14,0,22,0.363636363636364
0.038,"middleweight",25,"right-handed",5,50,0,55,0.0909090909090909
0.038,"super bantamweight",15,"right-handed",0,11,0,11,0
0.038,"super welterweight",12,"right-handed",0,12,0,12,0
0.038,"super welterweight",21,"right-handed",1,12,0,13,0.0769230769230769
0.038,"heavyweight",19,"right-handed",0,12,0,12,0
0.038,"middleweight",25,"right-handed",0,12,0,12,0
0.038,"super featherweight",15,"right-handed",0,11,0,11,0
0.041,"welterweight",29,"right-handed",1,9,0,10,0.1
0.041,"super bantamweight",18,"right-handed",0,9,0,9,0
0.041,"super featherweight",10,"right-handed",0,9,0,9,0
0.041,"super bantamweight",20,"right-handed",0,9,0,9,0
0.041,"lightweight",14,"right-handed",1,10,0,11,0.0909090909090909
0.041,"lightweight",10,"right-handed",0,9,0,9,0
0.041,"super welterweight",17,"right-handed",0,9,0,9,0
0.041,"heavyweight",15,"right-handed",0,9,0,9,0
0.041,"super middleweight",33,"right-handed",25,93,2,120,0.216666666666667
0.041,"flyweight",10,"right-handed",0,9,2,11,0.0909090909090909
0.041,"cruiserweight",24,"right-handed",0,9,0,9,0
0.041,"super flyweight",9,"right-handed",0,9,0,9,0
0.041,"super welterweight",27,"right-handed",0,9,0,9,0
0.041,"super middleweight",31,"right-handed",69,79,2,150,0.466666666666667
0.041,"cruiserweight",25,"right-handed",8,49,3,60,0.158333333333333
0.041,"flyweight",11,"right-handed",4,14,3,21,0.261904761904762
0.04,"featherweight",20,"right-handed",2,12,0,14,0.142857142857143
0.04,"super middleweight",16,"right-handed",2,9,3,14,0.25
0.04,"cruiserweight",8,"right-handed",9,12,1,22,0.431818181818182
0.04,"heavyweight",19,"right-handed",9,11,0,20,0.45
0.04,"featherweight",11,"right-handed",6,14,1,21,0.30952380952381
0.04,"middleweight",17,"right-handed",2,14,4,20,0.2
0.04,"super lightweight",22,"right-handed",2,17,0,19,0.105263157894737
0.04,"super welterweight",10,"right-handed",2,27,1,30,0.0833333333333333
0.04,"lightweight",NA,"right-handed",2,10,1,13,0.192307692307692
0.04,"featherweight",20,"right-handed",1,8,1,10,0.15
0.04,"super middleweight",26,"right-handed",9,38,4,51,0.215686274509804
0.04,"super featherweight",27,"right-handed",3,8,0,11,0.272727272727273
0.04,"welterweight",16,"right-handed",0,12,0,12,0
0.04,"cruiserweight",19,"right-handed",3,12,0,15,0.2
0.04,"super middleweight",12,"right-handed",2,10,2,14,0.214285714285714
0.04,"flyweight",NA,"right-handed",2,10,1,13,0.192307692307692
0.04,"lightweight",20,"right-handed",5,25,0,30,0.166666666666667
0.04,"super featherweight",19,"right-handed",6,23,1,30,0.216666666666667
0.04,"featherweight",16,"right-handed",4,29,0,33,0.121212121212121
0.04,"super bantamweight",14,"right-handed",4,21,2,27,0.185185185185185
0.04,"lightweight",12,"right-handed",1,11,1,13,0.115384615384615
0.04,"heavyweight",19,"right-handed",1,12,1,14,0.107142857142857
0.04,"lightweight",7,"right-handed",0,10,0,10,0
0.04,"cruiserweight",10,"right-handed",0,6,0,6,0
0.04,"super lightweight",16,"right-handed",0,10,0,10,0
0.04,"welterweight",7,"right-handed",0,10,0,10,0
0.04,"cruiserweight",6,"right-handed",1,10,0,11,0.0909090909090909
0.04,"super lightweight",8,"right-handed",0,10,0,10,0
0.04,"middleweight",NA,"right-handed",0,8,1,9,0.0555555555555556
0.04,"super bantamweight",7,"right-handed",0,9,0,9,0
0.04,"light flyweight",NA,"right-handed",0,10,0,10,0
0.04,"welterweight",16,"right-handed",0,10,0,10,0
0.04,"light flyweight",30,"right-handed",0,10,0,10,0
0.04,"light heavyweight",16,"right-handed",17,53,3,73,0.253424657534247
0.042,"super lightweight",27,"right-handed",0,8,0,8,0
0.042,"middleweight",12,"right-handed",0,8,0,8,0
0.042,"super featherweight",NA,"right-handed",0,8,1,9,0.0555555555555556
0.042,"welterweight",9,"right-handed",0,8,1,9,0.0555555555555556
0.042,"welterweight",16,"right-handed",0,8,0,8,0
0.042,"welterweight",NA,"right-handed",0,7,0,7,0
0.042,"super flyweight",14,"right-handed",0,8,0,8,0
0.042,"super featherweight",10,"right-handed",12,48,5,65,0.223076923076923
0.042,"super middleweight",8,"right-handed",0,8,0,8,0
0.042,"flyweight",17,"right-handed",0,8,0,8,0
0.042,"heavyweight",17,"right-handed",0,8,0,8,0
0.042,"super welterweight",18,"right-handed",1,1,0,2,0.5
0.042,"featherweight",14,"right-handed",3,16,0,19,0.157894736842105
0.042,"super welterweight",12,"right-handed",4,48,2,54,0.0925925925925926
0.042,"super welterweight",17,"right-handed",2,26,2,30,0.1
0.042,"featherweight",17,"right-handed",4,30,2,36,0.138888888888889
0.042,"light flyweight",15,"right-handed",2,13,2,17,0.176470588235294
0.042,"heavyweight",30,"right-handed",3,17,1,21,0.166666666666667
0.042,"super lightweight",13,"right-handed",5,27,2,34,0.176470588235294
0.042,"super welterweight",NA,"right-handed",2,12,3,17,0.205882352941176
0.042,"super flyweight",11,"right-handed",6,24,0,30,0.2
0.042,"super bantamweight",24,"right-handed",3,9,2,14,0.285714285714286
0.041,"middleweight",17,"right-handed",1,55,2,58,0.0344827586206897
0.041,"cruiserweight",28,"right-handed",0,10,2,12,0.0833333333333333
0.041,"welterweight",10,"right-handed",2,13,0,15,0.133333333333333
0.041,"super lightweight",13,"right-handed",1,23,2,26,0.0769230769230769
0.041,"lightweight",17,"right-handed",10,29,0,39,0.256410256410256
0.041,"lightweight",7,"right-handed",8,20,0,28,0.285714285714286
0.041,"welterweight",16,"right-handed",13,17,0,30,0.433333333333333
0.041,"super lightweight",18,"right-handed",3,16,1,20,0.175
0.041,"light heavyweight",25,"right-handed",11,32,2,45,0.266666666666667
0.041,"bantamweight",22,"right-handed",7,14,0,21,0.333333333333333
0.041,"super lightweight",17,"right-handed",3,14,0,17,0.176470588235294
0.041,"super welterweight",7,"right-handed",3,19,3,25,0.18
0.041,"super lightweight",8,"right-handed",5,1,0,6,0.833333333333333
0.041,"flyweight",14,"right-handed",1,9,1,11,0.136363636363636
0.041,"welterweight",15,"right-handed",0,9,1,10,0.05
0.041,"bantamweight",14,"right-handed",1,9,1,11,0.136363636363636
0.041,"heavyweight",8,"right-handed",19,42,1,62,0.314516129032258
0.041,"super welterweight",11,"right-handed",2,9,4,15,0.266666666666667
0.041,"welterweight",14,"right-handed",2,9,0,11,0.181818181818182
0.041,"middleweight",13,"right-handed",1,16,1,18,0.0833333333333333
0.041,"heavyweight",24,"right-handed",2,16,0,18,0.111111111111111
0.041,"heavyweight",19,"right-handed",2,9,0,11,0.181818181818182
0.041,"light heavyweight",19,"right-handed",1,10,0,11,0.0909090909090909
0.041,"bantamweight",21,"right-handed",0,9,0,9,0
0.041,"light heavyweight",11,"right-handed",0,9,0,9,0
0.041,"super welterweight",20,"right-handed",0,9,0,9,0
0.041,"lightweight",7,"right-handed",0,6,0,6,0
0.041,"super featherweight",14,"right-handed",0,9,1,10,0.05
0.043,"cruiserweight",13,"right-handed",13,51,4,68,0.220588235294118
0.043,"welterweight",17,"right-handed",4,11,2,17,0.294117647058824
0.043,"super welterweight",20,"right-handed",3,25,0,28,0.107142857142857
0.043,"lightweight",12,"right-handed",4,19,1,24,0.1875
0.043,"super middleweight",35,"right-handed",7,67,5,79,0.120253164556962
0.042,"middleweight",18,"right-handed",0,8,0,8,0
0.042,"super welterweight",23,"right-handed",11,10,1,22,0.522727272727273
0.042,"cruiserweight",19,"right-handed",1,8,1,10,0.15
0.042,"super welterweight",19,"right-handed",21,25,0,46,0.456521739130435
0.042,"super middleweight",7,"right-handed",7,10,3,20,0.425
0.042,"super welterweight",29,"right-handed",3,45,1,49,0.0714285714285714
0.042,"super welterweight",9,"right-handed",9,26,3,38,0.276315789473684
0.042,"featherweight",10,"right-handed",2,21,0,23,0.0869565217391304
0.042,"welterweight",10,"right-handed",9,13,1,23,0.41304347826087
0.042,"heavyweight",21,"right-handed",7,15,0,22,0.318181818181818
0.042,"super flyweight",7,"right-handed",4,13,0,17,0.235294117647059
0.042,"heavyweight",11,"right-handed",7,12,0,19,0.368421052631579
0.042,"super middleweight",17,"right-handed",6,21,3,30,0.25
0.042,"super welterweight",12,"right-handed",5,10,0,15,0.333333333333333
0.042,"flyweight",15,"right-handed",3,13,3,19,0.236842105263158
0.042,"super bantamweight",22,"right-handed",4,12,1,17,0.264705882352941
0.042,"super featherweight",31,"right-handed",7,14,0,21,0.333333333333333
0.042,"featherweight",13,"right-handed",9,45,5,59,0.194915254237288
0.042,"lightweight",16,"right-handed",7,11,0,18,0.388888888888889
0.042,"cruiserweight",8,"right-handed",7,15,1,23,0.326086956521739
0.042,"middleweight",15,"right-handed",2,10,0,12,0.166666666666667
0.042,"lightweight",24,"right-handed",1,11,1,13,0.115384615384615
0.042,"super middleweight",16,"right-handed",1,5,0,6,0.166666666666667
0.042,"bantamweight",8,"right-handed",1,10,2,13,0.153846153846154
0.042,"super middleweight",10,"right-handed",0,2,0,2,0
0.042,"cruiserweight",26,"right-handed",8,72,2,82,0.109756097560976
0.042,"featherweight",NA,"right-handed",1,1,0,2,0.5
0.042,"featherweight",16,"right-handed",2,10,1,13,0.192307692307692
0.042,"heavyweight",13,"right-handed",3,32,0,35,0.0857142857142857
0.042,"heavyweight",NA,"right-handed",2,9,0,11,0.181818181818182
0.042,"super featherweight",25,"right-handed",12,56,3,71,0.190140845070423
0.042,"super featherweight",NA,"right-handed",1,5,0,6,0.166666666666667
0.042,"super welterweight",16,"right-handed",0,8,0,8,0
0.042,"cruiserweight",8,"right-handed",0,6,0,6,0
0.042,"super welterweight",29,"right-handed",0,6,0,6,0
0.042,"super middleweight",29,"right-handed",0,7,0,7,0
0.042,"super lightweight",20,"right-handed",0,8,0,8,0
0.042,"flyweight",13,"right-handed",1,8,0,9,0.111111111111111
0.042,"heavyweight",24,"right-handed",0,8,0,8,0
0.042,"light heavyweight",8,"right-handed",0,8,1,9,0.0555555555555556
0.042,"super welterweight",NA,"right-handed",0,8,0,8,0
0.042,"lightweight",8,"right-handed",0,8,0,8,0
0.042,"super welterweight",19,"right-handed",1,11,0,12,0.0833333333333333
0.042,"minimumweight",13,"right-handed",1,8,0,9,0.111111111111111
0.042,"super bantamweight",23,"right-handed",0,8,0,8,0
0.043,"super middleweight",NA,"right-handed",3,9,1,13,0.269230769230769
0.043,"super bantamweight",9,"right-handed",2,7,0,9,0.222222222222222
0.043,"heavyweight",15,"right-handed",3,27,0,30,0.1
0.043,"middleweight",21,"right-handed",0,7,4,11,0.181818181818182
0.043,"welterweight",11,"right-handed",2,6,0,8,0.25
0.043,"featherweight",19,"right-handed",0,7,2,9,0.111111111111111
0.043,"cruiserweight",20,"right-handed",2,15,0,17,0.117647058823529
0.043,"welterweight",23,"right-handed",2,10,0,12,0.166666666666667
0.043,"super lightweight",NA,"right-handed",2,6,0,8,0.25
0.043,"super featherweight",21,"right-handed",3,9,1,13,0.269230769230769
0.043,"middleweight",38,"right-handed",11,14,2,27,0.444444444444444
0.043,"super featherweight",5,"right-handed",1,7,0,8,0.125
0.043,"super welterweight",9,"right-handed",1,14,1,16,0.09375
0.043,"bantamweight",NA,"right-handed",1,13,0,14,0.0714285714285714
0.043,"super middleweight",20,"right-handed",6,26,0,32,0.1875
0.043,"welterweight",14,"right-handed",1,8,0,9,0.111111111111111
0.043,"super lightweight",14,"right-handed",1,7,0,8,0.125
0.043,"bantamweight",16,"right-handed",2,8,0,10,0.2
0.043,"light heavyweight",13,"right-handed",2,9,0,11,0.181818181818182
0.043,"super welterweight",12,"right-handed",3,7,0,10,0.3
0.043,"heavyweight",27,"right-handed",3,15,1,19,0.184210526315789
0.043,"super bantamweight",NA,"right-handed",0,7,0,7,0
0.043,"super middleweight",10,"right-handed",0,7,0,7,0
0.043,"super featherweight",19,"right-handed",0,7,0,7,0
0.043,"welterweight",19,"right-handed",0,7,0,7,0
0.043,"cruiserweight",33,"right-handed",0,7,0,7,0
0.043,"cruiserweight",15,"right-handed",0,7,0,7,0
0.043,"super featherweight",13,"right-handed",0,7,0,7,0
0.043,"super flyweight",20,"right-handed",0,5,0,5,0
0.043,"welterweight",14,"right-handed",0,3,0,3,0
0.043,"middleweight",11,"right-handed",0,5,0,5,0
0.043,"heavyweight",25,"right-handed",1,7,0,8,0.125
0.043,"light heavyweight",9,"right-handed",1,13,0,14,0.0714285714285714
0.043,"welterweight",17,"right-handed",0,7,0,7,0
0.043,"featherweight",22,"right-handed",0,7,1,8,0.0625
0.043,"featherweight",17,"right-handed",0,7,0,7,0
0.043,"bantamweight",13,"right-handed",0,7,0,7,0
0.043,"super bantamweight",7,"right-handed",0,7,0,7,0
0.043,"welterweight",16,"right-handed",0,7,0,7,0
0.043,"light heavyweight",25,"right-handed",0,7,1,8,0.0625
0.043,"super welterweight",22,"right-handed",0,7,0,7,0
0.043,"featherweight",14,"right-handed",0,7,0,7,0
0.043,"flyweight",8,"right-handed",0,6,0,6,0
0.043,"super bantamweight",15,"right-handed",0,7,0,7,0
0.043,"cruiserweight",15,"right-handed",1,7,0,8,0.125
0.043,"middleweight",14,"right-handed",1,7,0,8,0.125
0.043,"light flyweight",17,"right-handed",0,7,1,8,0.0625
0.043,"super middleweight",11,"right-handed",11,14,0,25,0.44
0.043,"super lightweight",17,"right-handed",0,9,0,9,0
0.043,"bantamweight",7,"right-handed",6,8,0,14,0.428571428571429
0.044,"lightweight",19,"right-handed",3,11,2,16,0.25
0.044,"super bantamweight",NA,"right-handed",0,6,0,6,0
0.044,"cruiserweight",16,"right-handed",0,6,0,6,0
0.044,"middleweight",12,"right-handed",0,6,0,6,0
0.044,"super bantamweight",20,"right-handed",0,6,0,6,0
0.044,"super lightweight",10,"right-handed",0,6,0,6,0
0.044,"super featherweight",10,"right-handed",0,6,0,6,0
0.044,"welterweight",12,"right-handed",0,6,0,6,0
0.044,"lightweight",18,"right-handed",0,6,0,6,0
0.044,"super welterweight",8,"right-handed",0,6,0,6,0
0.044,"bantamweight",15,"right-handed",0,6,0,6,0
0.044,"heavyweight",7,"right-handed",0,6,1,7,0.0714285714285714
0.044,"super welterweight",11,"right-handed",0,6,0,6,0
0.044,"super bantamweight",13,"right-handed",0,5,1,6,0.0833333333333333
0.044,"middleweight",17,"right-handed",0,6,1,7,0.0714285714285714
0.044,"featherweight",19,"right-handed",0,6,1,7,0.0714285714285714
0.044,"super featherweight",13,"right-handed",0,6,0,6,0
0.044,"welterweight",24,"right-handed",0,6,0,6,0
0.044,"featherweight",NA,"right-handed",0,6,0,6,0
0.044,"featherweight",17,"right-handed",0,6,0,6,0
0.044,"flyweight",9,"right-handed",0,6,1,7,0.0714285714285714
0.044,"super featherweight",12,"right-handed",0,6,0,6,0
0.044,"super lightweight",26,"right-handed",0,6,0,6,0
0.044,"super middleweight",16,"right-handed",0,6,0,6,0
0.044,"super lightweight",19,"right-handed",0,6,0,6,0
0.044,"featherweight",17,"right-handed",0,6,1,7,0.0714285714285714
0.044,"super welterweight",30,"right-handed",2,16,2,20,0.15
0.044,"welterweight",15,"right-handed",4,16,1,21,0.214285714285714
0.044,"super lightweight",10,"right-handed",4,13,2,19,0.263157894736842
0.044,"super lightweight",19,"right-handed",1,12,0,13,0.0769230769230769
0.044,"super lightweight",17,"right-handed",6,92,0,98,0.0612244897959184
0.044,"welterweight",17,"right-handed",4,7,0,11,0.363636363636364
0.044,"lightweight",15,"right-handed",2,7,0,9,0.222222222222222
0.044,"cruiserweight",30,"right-handed",7,13,3,23,0.369565217391304
0.044,"welterweight",NA,"right-handed",3,9,2,14,0.285714285714286
0.043,"heavyweight",19,"right-handed",22,10,0,32,0.6875
0.043,"middleweight",8,"right-handed",5,13,2,20,0.3
0.043,"super lightweight",27,"right-handed",3,30,0,33,0.0909090909090909
0.043,"bantamweight",22,"right-handed",10,9,3,22,0.522727272727273
0.043,"lightweight",20,"right-handed",4,10,5,19,0.342105263157895
0.043,"light flyweight",17,"right-handed",7,15,1,23,0.326086956521739
0.043,"light flyweight",11,"right-handed",10,8,0,18,0.555555555555556
0.043,"lightweight",16,"right-handed",4,8,0,12,0.333333333333333
0.043,"flyweight",22,"right-handed",2,13,2,17,0.176470588235294
0.043,"super lightweight",4,"right-handed",2,13,2,17,0.176470588235294
0.043,"welterweight",5,"right-handed",0,5,0,5,0
0.043,"super lightweight",21,"right-handed",3,8,0,11,0.272727272727273
0.043,"light heavyweight",24,"right-handed",13,18,0,31,0.419354838709677
0.043,"cruiserweight",23,"right-handed",5,33,2,40,0.15
0.043,"middleweight",9,"right-handed",6,9,0,15,0.4
0.045,"flyweight",12,"right-handed",3,32,2,37,0.108108108108108
0.045,"welterweight",12,"right-handed",4,6,1,11,0.409090909090909
0.045,"lightweight",16,"right-handed",9,30,7,46,0.271739130434783
0.045,"super welterweight",24,"right-handed",27,17,2,46,0.608695652173913
0.045,"welterweight",13,"right-handed",7,12,1,20,0.375
0.045,"welterweight",21,"right-handed",4,18,2,24,0.208333333333333
0.045,"lightweight",19,"right-handed",5,7,2,14,0.428571428571429
0.044,"light heavyweight",21,"right-handed",4,6,0,10,0.4
0.044,"middleweight",12,"right-handed",11,11,1,23,0.5
0.044,"middleweight",21,"right-handed",4,15,3,22,0.25
0.044,"lightweight",13,"right-handed",5,5,1,11,0.5
0.044,"featherweight",18,"right-handed",7,8,0,15,0.466666666666667
0.044,"featherweight",8,"right-handed",5,5,1,11,0.5
0.044,"lightweight",7,"right-handed",2,13,2,17,0.176470588235294
0.044,"middleweight",17,"right-handed",3,8,1,12,0.291666666666667
0.044,"light flyweight",22,"right-handed",3,9,2,14,0.285714285714286
0.044,"super bantamweight",13,"right-handed",2,6,2,10,0.3
0.044,"cruiserweight",26,"right-handed",1,5,5,11,0.318181818181818
0.044,"welterweight",15,"right-handed",3,6,0,9,0.333333333333333
0.044,"super welterweight",7,"right-handed",4,6,0,10,0.4
0.044,"bantamweight",NA,"right-handed",2,6,2,10,0.3
0.044,"welterweight",17,"right-handed",5,27,1,33,0.166666666666667
0.044,"middleweight",24,"right-handed",4,6,0,10,0.4
0.044,"lightweight",18,"right-handed",3,7,1,11,0.318181818181818
0.044,"super lightweight",11,"right-handed",5,13,0,18,0.277777777777778
0.044,"welterweight",4,"right-handed",2,6,2,10,0.3
0.044,"flyweight",22,"right-handed",2,6,3,11,0.318181818181818
0.044,"super middleweight",17,"right-handed",6,8,0,14,0.428571428571429
0.044,"super featherweight",18,"right-handed",3,7,0,10,0.3
0.044,"middleweight",17,"right-handed",5,11,1,17,0.323529411764706
0.044,"heavyweight",9,"right-handed",4,7,0,11,0.363636363636364
0.044,"super lightweight",24,"right-handed",6,10,0,16,0.375
0.044,"heavyweight",18,"right-handed",1,6,0,7,0.142857142857143
0.044,"welterweight",12,"right-handed",6,1,0,7,0.857142857142857
0.044,"light heavyweight",14,"right-handed",1,6,0,7,0.142857142857143
0.044,"welterweight",8,"right-handed",1,8,0,9,0.111111111111111
0.044,"middleweight",10,"right-handed",2,6,1,9,0.277777777777778
0.044,"super bantamweight",7,"right-handed",1,6,2,9,0.222222222222222
0.044,"super featherweight",21,"right-handed",1,6,2,9,0.222222222222222
0.044,"bantamweight",15,"right-handed",3,8,0,11,0.272727272727273
0.044,"super welterweight",19,"right-handed",2,14,1,17,0.147058823529412
0.044,"super lightweight",19,"right-handed",1,6,0,7,0.142857142857143
0.044,"lightweight",14,"right-handed",2,6,0,8,0.25
0.044,"light flyweight",11,"right-handed",1,6,0,7,0.142857142857143
0.044,"minimumweight",10,"right-handed",1,7,1,9,0.166666666666667
0.044,"light heavyweight",15,"right-handed",1,7,1,9,0.166666666666667
0.044,"minimumweight",18,"right-handed",1,6,2,9,0.222222222222222
0.044,"heavyweight",9,"right-handed",0,6,1,7,0.0714285714285714
0.044,"middleweight",NA,"right-handed",1,21,0,22,0.0454545454545455
0.044,"welterweight",15,"right-handed",1,6,1,8,0.1875
0.045,"super flyweight",15,"right-handed",2,6,0,8,0.25
0.045,"light flyweight",11,"right-handed",2,7,1,10,0.25
0.045,"heavyweight",31,"right-handed",2,7,0,9,0.222222222222222
0.045,"super featherweight",16,"right-handed",2,5,0,7,0.285714285714286
0.045,"super lightweight",30,"right-handed",1,5,0,6,0.166666666666667
0.045,"super welterweight",NA,"right-handed",0,3,0,3,0
0.045,"super flyweight",9,"right-handed",0,5,0,5,0
0.045,"super welterweight",13,"right-handed",0,5,0,5,0
0.045,"cruiserweight",14,"right-handed",0,5,1,6,0.0833333333333333
0.045,"super welterweight",11,"right-handed",0,5,0,5,0
0.045,"welterweight",16,"right-handed",0,5,0,5,0
0.045,"featherweight",10,"right-handed",0,4,0,4,0
0.045,"lightweight",NA,"right-handed",0,5,0,5,0
0.045,"bantamweight",10,"right-handed",0,5,0,5,0
0.045,"middleweight",21,"right-handed",0,5,0,5,0
0.045,"super welterweight",5,"right-handed",0,5,0,5,0
0.045,"super featherweight",11,"right-handed",0,5,0,5,0
0.045,"flyweight",12,"right-handed",0,5,0,5,0
0.045,"welterweight",12,"right-handed",0,5,0,5,0
0.045,"welterweight",9,"right-handed",0,5,0,5,0
0.045,"cruiserweight",22,"right-handed",0,5,0,5,0
0.045,"super bantamweight",19,"right-handed",0,5,0,5,0
0.045,"middleweight",24,"right-handed",0,5,0,5,0
0.045,"light flyweight",6,"right-handed",0,5,0,5,0
0.045,"super welterweight",16,"right-handed",0,5,1,6,0.0833333333333333
0.045,"lightweight",10,"right-handed",0,5,0,5,0
0.045,"super middleweight",15,"right-handed",0,4,0,4,0
0.045,"heavyweight",25,"right-handed",0,5,0,5,0
0.045,"heavyweight",28,"right-handed",0,5,1,6,0.0833333333333333
0.045,"super bantamweight",15,"right-handed",0,5,0,5,0
0.045,"super welterweight",19,"right-handed",0,5,0,5,0
0.045,"featherweight",13,"right-handed",0,5,0,5,0
0.045,"bantamweight",NA,"right-handed",0,5,0,5,0
0.045,"lightweight",16,"right-handed",0,5,0,5,0
0.045,"super lightweight",21,"right-handed",0,5,0,5,0
0.045,"super featherweight",14,"right-handed",0,5,0,5,0
0.045,"middleweight",11,"right-handed",0,5,1,6,0.0833333333333333
0.045,"cruiserweight",18,"right-handed",0,5,0,5,0
0.045,"super welterweight",NA,"right-handed",0,5,0,5,0
0.045,"cruiserweight",NA,"right-handed",0,5,0,5,0
0.045,"welterweight",10,"right-handed",0,5,0,5,0
0.045,"cruiserweight",19,"right-handed",0,5,0,5,0
0.045,"light flyweight",10,"right-handed",0,5,0,5,0
0.045,"bantamweight",NA,"right-handed",0,5,0,5,0
0.045,"super welterweight",28,"right-handed",2,74,2,78,0.0384615384615385
0.045,"heavyweight",30,"right-handed",2,8,0,10,0.2
0.045,"super lightweight",11,"right-handed",1,7,1,9,0.166666666666667
0.045,"welterweight",13,"right-handed",1,29,3,33,0.0757575757575758
0.045,"lightweight",11,"right-handed",2,7,3,12,0.291666666666667
0.045,"featherweight",14,"right-handed",17,7,0,24,0.708333333333333
0.045,"super lightweight",18,"right-handed",4,8,2,14,0.357142857142857
0.045,"super featherweight",12,"right-handed",2,5,2,9,0.333333333333333
0.045,"heavyweight",NA,"right-handed",3,4,1,8,0.4375
0.045,"super lightweight",10,"right-handed",4,8,0,12,0.333333333333333
0.045,"super welterweight",19,"right-handed",10,7,3,20,0.575
0.045,"featherweight",19,"right-handed",10,18,1,29,0.362068965517241
0.045,"featherweight",20,"right-handed",2,8,0,10,0.2
0.045,"welterweight",17,"right-handed",8,23,0,31,0.258064516129032
0.045,"lightweight",12,"right-handed",3,5,0,8,0.375
0.045,"flyweight",13,"right-handed",5,9,1,15,0.366666666666667
0.045,"cruiserweight",25,"right-handed",2,6,0,8,0.25
0.045,"middleweight",15,"right-handed",1,5,0,6,0.166666666666667
0.045,"lightweight",11,"right-handed",1,5,0,6,0.166666666666667
0.045,"flyweight",13,"right-handed",1,5,0,6,0.166666666666667
0.045,"super lightweight",17,"right-handed",2,12,0,14,0.142857142857143
0.045,"welterweight",13,"right-handed",1,5,0,6,0.166666666666667
0.045,"lightweight",19,"right-handed",1,5,0,6,0.166666666666667
0.045,"cruiserweight",20,"right-handed",1,6,3,10,0.25
0.045,"super middleweight",22,"right-handed",2,5,0,7,0.285714285714286
0.045,"super lightweight",17,"right-handed",2,5,0,7,0.285714285714286
0.045,"heavyweight",19,"right-handed",2,5,0,7,0.285714285714286
0.045,"middleweight",15,"right-handed",2,5,0,7,0.285714285714286
0.045,"middleweight",18,"right-handed",4,16,1,21,0.214285714285714
0.045,"super middleweight",15,"right-handed",2,7,0,9,0.222222222222222
0.045,"super lightweight",16,"right-handed",1,5,0,6,0.166666666666667
0.045,"middleweight",5,"right-handed",1,8,0,9,0.111111111111111
0.045,"lightweight",18,"right-handed",11,56,0,67,0.164179104477612
0.045,"heavyweight",34,"right-handed",14,42,1,57,0.254385964912281
0.045,"middleweight",12,"right-handed",2,6,1,9,0.277777777777778
0.045,"super welterweight",9,"right-handed",2,5,0,7,0.285714285714286
0.045,"lightweight",12,"right-handed",1,5,1,7,0.214285714285714
0.045,"super welterweight",27,"right-handed",1,11,0,12,0.0833333333333333
0.045,"super featherweight",17,"right-handed",1,3,0,4,0.25
0.045,"heavyweight",26,"right-handed",1,16,2,19,0.105263157894737
0.045,"cruiserweight",23,"right-handed",3,6,1,10,0.35
0.045,"super lightweight",4,"right-handed",1,5,0,6,0.166666666666667
0.045,"super featherweight",NA,"right-handed",1,10,0,11,0.0909090909090909
0.045,"featherweight",20,"right-handed",1,3,0,4,0.25
0.045,"super bantamweight",10,"right-handed",2,7,0,9,0.222222222222222
0.045,"welterweight",20,"right-handed",1,7,0,8,0.125
0.045,"super featherweight",NA,"right-handed",2,6,0,8,0.25
0.045,"welterweight",23,"right-handed",2,7,1,10,0.25
0.045,"heavyweight",22,"right-handed",3,11,0,14,0.214285714285714
0.045,"light heavyweight",19,"right-handed",1,11,1,13,0.115384615384615
0.045,"light flyweight",16,"right-handed",1,5,1,7,0.214285714285714
0.045,"welterweight",10,"right-handed",1,8,0,9,0.111111111111111
0.045,"bantamweight",11,"right-handed",1,5,0,6,0.166666666666667
0.045,"cruiserweight",15,"right-handed",2,9,0,11,0.181818181818182
0.045,"heavyweight",29,"right-handed",3,45,0,48,0.0625
0.045,"super featherweight",11,"right-handed",1,6,0,7,0.142857142857143
0.046,"heavyweight",16,"right-handed",0,4,0,4,0
0.046,"flyweight",12,"right-handed",0,4,0,4,0
0.046,"super flyweight",9,"right-handed",0,4,0,4,0
0.046,"super welterweight",5,"right-handed",0,4,0,4,0
0.046,"bantamweight",23,"right-handed",0,4,0,4,0
0.046,"lightweight",22,"right-handed",0,4,1,5,0.1
0.046,"super featherweight",9,"right-handed",0,3,0,3,0
0.046,"featherweight",11,"right-handed",0,4,0,4,0
0.046,"super flyweight",5,"right-handed",0,4,0,4,0
0.046,"featherweight",11,"right-handed",0,4,1,5,0.1
0.046,"lightweight",NA,"right-handed",0,4,0,4,0
0.046,"welterweight",22,"right-handed",0,4,0,4,0
0.046,"super bantamweight",21,"right-handed",0,4,0,4,0
0.046,"super welterweight",14,"right-handed",2,4,5,11,0.409090909090909
0.046,"lightweight",23,"right-handed",5,15,3,23,0.282608695652174
0.046,"super lightweight",27,"right-handed",16,124,5,145,0.127586206896552
0.046,"featherweight",30,"right-handed",17,9,0,26,0.653846153846154
0.046,"cruiserweight",19,"right-handed",5,6,1,12,0.458333333333333
0.046,"super lightweight",15,"right-handed",1,7,0,8,0.125
0.046,"super lightweight",21,"right-handed",5,6,0,11,0.454545454545455
0.046,"super welterweight",23,"right-handed",13,6,1,20,0.675
0.046,"light flyweight",10,"right-handed",4,6,1,11,0.409090909090909
0.046,"lightweight",29,"right-handed",9,26,0,35,0.257142857142857
0.046,"bantamweight",18,"right-handed",14,9,0,23,0.608695652173913
0.046,"super featherweight",13,"right-handed",9,8,1,18,0.527777777777778
0.045,"featherweight",10,"right-handed",9,5,0,14,0.642857142857143
0.045,"middleweight",NA,"right-handed",5,10,0,15,0.333333333333333
0.045,"super welterweight",19,"right-handed",5,8,1,14,0.392857142857143
0.045,"flyweight",16,"right-handed",13,33,2,48,0.291666666666667
0.045,"super featherweight",8,"right-handed",11,10,1,22,0.522727272727273
0.045,"super flyweight",9,"right-handed",4,10,1,15,0.3
0.045,"heavyweight",23,"right-handed",5,6,0,11,0.454545454545455
0.045,"light flyweight",18,"right-handed",5,7,0,12,0.416666666666667
0.045,"super welterweight",11,"right-handed",6,10,0,16,0.375
0.045,"light heavyweight",19,"right-handed",3,33,0,36,0.0833333333333333
0.045,"lightweight",7,"right-handed",9,8,0,17,0.529411764705882
0.045,"super welterweight",7,"right-handed",7,12,0,19,0.368421052631579
0.045,"super featherweight",15,"right-handed",5,5,1,11,0.5
0.045,"super flyweight",17,"right-handed",8,5,0,13,0.615384615384615
0.045,"super lightweight",17,"right-handed",11,21,2,34,0.352941176470588
0.045,"middleweight",15,"right-handed",8,39,3,50,0.19
0.045,"heavyweight",19,"right-handed",2,5,2,9,0.333333333333333
0.045,"cruiserweight",11,"right-handed",3,5,0,8,0.375
0.045,"super lightweight",12,"right-handed",2,5,2,9,0.333333333333333
0.045,"super lightweight",NA,"right-handed",3,7,0,10,0.3
0.045,"welterweight",16,"right-handed",3,8,1,12,0.291666666666667
0.045,"super middleweight",26,"right-handed",1,8,2,11,0.181818181818182
0.045,"welterweight",10,"right-handed",3,5,1,9,0.388888888888889
0.045,"welterweight",21,"right-handed",3,5,0,8,0.375
0.045,"super featherweight",15,"right-handed",3,7,0,10,0.3
0.046,"flyweight",5,"right-handed",0,1,0,1,0
0.046,"welterweight",16,"right-handed",0,2,0,2,0
0.046,"bantamweight",10,"right-handed",0,4,0,4,0
0.046,"welterweight",14,"right-handed",0,4,0,4,0
0.046,"super welterweight",14,"right-handed",0,4,0,4,0
0.046,"featherweight",16,"right-handed",0,4,1,5,0.1
0.046,"bantamweight",11,"right-handed",0,4,0,4,0
0.046,"middleweight",28,"right-handed",0,4,0,4,0
0.046,"featherweight",NA,"right-handed",0,3,0,3,0
0.046,"middleweight",14,"right-handed",0,4,0,4,0
0.046,"cruiserweight",12,"right-handed",10,6,3,19,0.605263157894737
0.046,"super flyweight",NA,"right-handed",0,4,0,4,0
0.046,"super middleweight",15,"right-handed",0,1,0,1,0
0.046,"featherweight",16,"right-handed",0,4,0,4,0
0.046,"welterweight",7,"right-handed",0,4,0,4,0
0.046,"cruiserweight",23,"right-handed",0,4,0,4,0
0.046,"welterweight",21,"right-handed",0,3,0,3,0
0.046,"super middleweight",14,"right-handed",0,4,0,4,0
0.046,"super bantamweight",30,"right-handed",0,4,1,5,0.1
0.046,"light heavyweight",10,"right-handed",0,4,0,4,0
0.046,"super flyweight",5,"right-handed",0,4,0,4,0
0.046,"light flyweight",19,"right-handed",0,4,0,4,0
0.046,"welterweight",9,"right-handed",0,4,0,4,0
0.046,"super lightweight",21,"right-handed",0,4,1,5,0.1
0.046,"bantamweight",5,"right-handed",0,4,0,4,0
0.046,"super welterweight",18,"right-handed",0,4,0,4,0
0.046,"light heavyweight",20,"right-handed",0,4,0,4,0
0.046,"super middleweight",9,"right-handed",0,4,0,4,0
0.046,"welterweight",20,"right-handed",0,4,0,4,0
0.046,"super welterweight",11,"right-handed",0,4,1,5,0.1
0.046,"welterweight",14,"right-handed",0,4,0,4,0
0.046,"super welterweight",15,"right-handed",2,4,0,6,0.333333333333333
0.046,"bantamweight",18,"right-handed",0,4,1,5,0.1
0.046,"flyweight",NA,"right-handed",0,3,0,3,0
0.046,"featherweight",5,"right-handed",0,4,0,4,0
0.046,"lightweight",22,"right-handed",0,4,0,4,0
0.046,"cruiserweight",25,"right-handed",14,9,0,23,0.608695652173913
0.046,"super flyweight",NA,"right-handed",0,4,0,4,0
0.046,"bantamweight",6,"right-handed",0,4,0,4,0
0.046,"cruiserweight",18,"right-handed",0,4,0,4,0
0.046,"featherweight",10,"right-handed",0,4,0,4,0
0.046,"cruiserweight",15,"right-handed",0,4,0,4,0
0.046,"heavyweight",11,"right-handed",0,4,0,4,0
0.046,"light flyweight",8,"right-handed",0,4,0,4,0
0.046,"super featherweight",NA,"right-handed",0,4,0,4,0
0.046,"welterweight",15,"right-handed",0,4,1,5,0.1
0.046,"bantamweight",6,"right-handed",0,3,0,3,0
0.046,"lightweight",7,"right-handed",0,4,0,4,0
0.046,"super welterweight",16,"right-handed",0,4,0,4,0
0.046,"featherweight",11,"right-handed",0,4,0,4,0
0.046,"light heavyweight",8,"right-handed",4,4,0,8,0.5
0.046,"featherweight",9,"right-handed",1,4,1,6,0.25
0.046,"super flyweight",20,"right-handed",1,12,0,13,0.0769230769230769
0.046,"welterweight",15,"right-handed",2,21,2,25,0.12
0.046,"middleweight",15,"right-handed",1,5,0,6,0.166666666666667
0.046,"heavyweight",NA,"right-handed",1,9,0,10,0.1
0.046,"super featherweight",5,"right-handed",1,4,0,5,0.2
0.046,"welterweight",22,"right-handed",3,24,3,30,0.15
0.046,"heavyweight",8,"right-handed",1,4,0,5,0.2
0.046,"middleweight",24,"right-handed",2,4,0,6,0.333333333333333
0.046,"super welterweight",12,"right-handed",1,5,0,6,0.166666666666667
0.046,"cruiserweight",16,"right-handed",0,7,1,8,0.0625
0.046,"heavyweight",21,"right-handed",2,4,0,6,0.333333333333333
0.046,"bantamweight",8,"right-handed",1,4,0,5,0.2
0.046,"flyweight",8,"right-handed",1,4,0,5,0.2
0.046,"featherweight",14,"right-handed",1,4,0,5,0.2
0.046,"flyweight",20,"right-handed",1,4,0,5,0.2
0.046,"heavyweight",19,"right-handed",1,25,1,27,0.0555555555555556
0.046,"flyweight",4,"right-handed",2,4,0,6,0.333333333333333
0.046,"super featherweight",7,"right-handed",1,4,1,6,0.25
0.046,"middleweight",24,"right-handed",9,27,0,36,0.25
0.046,"flyweight",7,"right-handed",1,3,0,4,0.25
0.046,"super lightweight",13,"right-handed",1,4,0,5,0.2
0.046,"middleweight",16,"right-handed",2,4,0,6,0.333333333333333
0.046,"light flyweight",7,"right-handed",2,4,0,6,0.333333333333333
0.046,"bantamweight",14,"right-handed",2,4,0,6,0.333333333333333
0.046,"featherweight",NA,"right-handed",1,12,0,13,0.0769230769230769
0.046,"super welterweight",15,"right-handed",2,5,0,7,0.285714285714286
0.046,"flyweight",10,"right-handed",2,4,0,6,0.333333333333333
0.046,"welterweight",14,"right-handed",1,5,0,6,0.166666666666667
0.046,"featherweight",6,"right-handed",1,5,0,6,0.166666666666667
0.046,"welterweight",24,"right-handed",1,9,0,10,0.1
0.046,"welterweight",15,"right-handed",1,4,0,5,0.2
0.046,"light flyweight",12,"right-handed",1,5,1,7,0.214285714285714
0.046,"super welterweight",9,"right-handed",1,4,0,5,0.2
0.046,"super flyweight",5,"right-handed",1,4,0,5,0.2
0.046,"light heavyweight",18,"right-handed",1,7,0,8,0.125
0.046,"super lightweight",16,"right-handed",8,24,1,33,0.257575757575758
0.046,"flyweight",12,"right-handed",1,5,0,6,0.166666666666667
0.046,"featherweight",10,"right-handed",1,4,0,5,0.2
0.046,"middleweight",11,"right-handed",1,5,0,6,0.166666666666667
0.046,"super featherweight",NA,"right-handed",1,4,0,5,0.2
0.046,"super middleweight",25,"right-handed",4,17,0,21,0.19047619047619
0.046,"super lightweight",19,"right-handed",2,13,0,15,0.133333333333333
0.046,"heavyweight",15,"right-handed",2,5,0,7,0.285714285714286
0.046,"light heavyweight",27,"right-handed",0,4,1,5,0.1
0.046,"light heavyweight",17,"right-handed",0,4,0,4,0
0.046,"featherweight",17,"right-handed",0,4,0,4,0
0.046,"featherweight",22,"right-handed",0,4,1,5,0.1
0.046,"featherweight",NA,"right-handed",0,4,0,4,0
0.046,"super bantamweight",8,"right-handed",22,14,0,36,0.611111111111111
0.046,"super lightweight",7,"right-handed",8,10,0,18,0.444444444444444
0.046,"super lightweight",7,"right-handed",10,5,0,15,0.666666666666667
0.046,"super lightweight",9,"right-handed",1,4,1,6,0.25
0.046,"heavyweight",16,"right-handed",7,7,0,14,0.5
0.046,"super welterweight",10,"right-handed",5,5,1,11,0.5
0.046,"lightweight",12,"right-handed",4,8,3,15,0.366666666666667
0.046,"featherweight",13,"right-handed",4,4,0,8,0.5
0.046,"super welterweight",13,"right-handed",13,48,2,63,0.222222222222222
0.046,"light heavyweight",17,"right-handed",14,25,1,40,0.3625
0.046,"super welterweight",22,"right-handed",2,3,3,8,0.4375
0.046,"bantamweight",9,"right-handed",9,7,0,16,0.5625
0.046,"super welterweight",9,"right-handed",7,7,0,14,0.5
0.046,"featherweight",13,"right-handed",1,14,1,16,0.09375
0.046,"cruiserweight",13,"right-handed",5,7,1,13,0.423076923076923
0.046,"super flyweight",13,"right-handed",3,10,1,14,0.25
0.046,"super flyweight",15,"right-handed",5,4,0,9,0.555555555555556
0.046,"super bantamweight",11,"right-handed",3,7,0,10,0.3
0.046,"middleweight",17,"right-handed",0,5,1,6,0.0833333333333333
0.046,"super welterweight",10,"right-handed",5,6,0,11,0.454545454545455
0.046,"featherweight",13,"right-handed",2,8,1,11,0.227272727272727
0.046,"lightweight",10,"right-handed",5,6,0,11,0.454545454545455
0.046,"super featherweight",4,"right-handed",6,14,0,20,0.3
0.046,"super welterweight",18,"right-handed",3,4,0,7,0.428571428571429
0.046,"light heavyweight",10,"right-handed",1,7,0,8,0.125
0.046,"welterweight",15,"right-handed",3,11,1,15,0.233333333333333
0.046,"light heavyweight",NA,"right-handed",2,4,1,7,0.357142857142857
0.046,"super welterweight",16,"right-handed",3,17,2,22,0.181818181818182
0.046,"heavyweight",29,"right-handed",6,37,0,43,0.13953488372093
0.046,"flyweight",22,"right-handed",3,5,0,8,0.375
0.046,"light flyweight",13,"right-handed",3,14,1,18,0.194444444444444
0.046,"welterweight",10,"right-handed",3,6,0,9,0.333333333333333
0.046,"welterweight",16,"right-handed",7,19,1,27,0.277777777777778
0.046,"flyweight",12,"right-handed",3,5,0,8,0.375
0.046,"featherweight",29,"right-handed",2,4,3,9,0.388888888888889
0.046,"super welterweight",21,"right-handed",3,4,1,8,0.4375
0.046,"super featherweight",13,"right-handed",4,6,0,10,0.4
0.046,"light flyweight",22,"right-handed",3,7,1,11,0.318181818181818
0.046,"flyweight",6,"right-handed",4,5,1,10,0.45
0.046,"flyweight",12,"right-handed",2,4,1,7,0.357142857142857
0.046,"super welterweight",15,"right-handed",2,3,1,6,0.416666666666667
0.046,"super lightweight",13,"right-handed",5,10,0,15,0.333333333333333
0.046,"cruiserweight",20,"right-handed",1,9,0,10,0.1
0.046,"super welterweight",10,"right-handed",3,5,0,8,0.375
0.046,"middleweight",11,"right-handed",3,6,0,9,0.333333333333333
0.046,"heavyweight",10,"right-handed",2,8,0,10,0.2
0.046,"super lightweight",13,"right-handed",3,4,0,7,0.428571428571429
0.046,"light flyweight",19,"right-handed",6,8,1,15,0.433333333333333
0.046,"middleweight",9,"right-handed",4,14,2,20,0.25
0.046,"super bantamweight",12,"right-handed",2,5,2,9,0.333333333333333
0.047,"cruiserweight",5,"right-handed",0,1,0,1,0
0.047,"super middleweight",10,"right-handed",0,3,0,3,0
0.047,"super bantamweight",11,"right-handed",0,3,0,3,0
0.047,"heavyweight",NA,"right-handed",0,3,0,3,0
0.047,"light heavyweight",20,"right-handed",0,3,0,3,0
0.047,"flyweight",10,"right-handed",0,3,0,3,0
0.047,"welterweight",11,"right-handed",0,3,0,3,0
0.047,"super flyweight",11,"right-handed",0,3,0,3,0
0.047,"bantamweight",9,"right-handed",0,3,0,3,0
0.047,"super featherweight",22,"right-handed",0,9,0,9,0
0.047,"lightweight",24,"right-handed",0,3,0,3,0
0.047,"lightweight",23,"right-handed",0,3,0,3,0
0.047,"super featherweight",13,"right-handed",0,3,0,3,0
0.047,"super lightweight",23,"right-handed",4,3,2,9,0.555555555555556
0.047,"featherweight",8,"right-handed",0,3,1,4,0.125
0.047,"welterweight",22,"right-handed",0,3,0,3,0
0.047,"super lightweight",18,"right-handed",0,3,0,3,0
0.047,"heavyweight",13,"right-handed",0,3,0,3,0
0.047,"super featherweight",16,"right-handed",0,3,0,3,0
0.047,"super lightweight",16,"right-handed",0,3,0,3,0
0.047,"featherweight",7,"right-handed",0,3,0,3,0
0.047,"flyweight",3,"right-handed",0,3,0,3,0
0.047,"super featherweight",9,"right-handed",0,3,0,3,0
0.047,"lightweight",NA,"right-handed",0,3,0,3,0
0.047,"flyweight",NA,"right-handed",0,3,0,3,0
0.047,"super middleweight",8,"right-handed",0,3,0,3,0
0.047,"featherweight",8,"right-handed",0,3,0,3,0
0.047,"super lightweight",6,"right-handed",0,3,0,3,0
0.047,"bantamweight",6,"right-handed",0,3,0,3,0
0.047,"minimumweight",NA,"right-handed",0,3,0,3,0
0.047,"lightweight",6,"right-handed",0,3,0,3,0
0.047,"super bantamweight",NA,"right-handed",0,3,0,3,0
0.047,"light heavyweight",11,"right-handed",0,3,0,3,0
0.047,"lightweight",8,"right-handed",0,3,0,3,0
0.047,"super lightweight",14,"right-handed",0,3,0,3,0
0.047,"lightweight",20,"right-handed",0,3,0,3,0
0.047,"super featherweight",4,"right-handed",0,3,0,3,0
0.047,"featherweight",4,"right-handed",0,3,0,3,0
0.047,"featherweight",8,"right-handed",0,3,0,3,0
0.047,"cruiserweight",18,"right-handed",0,3,0,3,0
0.047,"middleweight",NA,"right-handed",2,6,1,9,0.277777777777778
0.047,"middleweight",18,"right-handed",4,15,0,19,0.210526315789474
0.047,"middleweight",13,"right-handed",2,1,0,3,0.666666666666667
0.047,"heavyweight",11,"right-handed",6,10,1,17,0.382352941176471
0.047,"middleweight",21,"right-handed",22,24,1,47,0.478723404255319
0.047,"super middleweight",16,"right-handed",3,5,2,10,0.4
0.047,"welterweight",15,"right-handed",10,8,0,18,0.555555555555556
0.047,"bantamweight",23,"right-handed",1,8,5,14,0.25
0.047,"middleweight",10,"right-handed",7,18,1,26,0.288461538461538
0.047,"super welterweight",12,"right-handed",0,1,0,1,0
0.047,"middleweight",23,"right-handed",0,3,0,3,0
0.047,"super welterweight",16,"right-handed",0,3,0,3,0
0.047,"heavyweight",14,"right-handed",0,1,0,1,0
0.047,"super lightweight",13,"right-handed",0,3,0,3,0
0.047,"light heavyweight",NA,"right-handed",0,2,0,2,0
0.047,"welterweight",8,"right-handed",0,3,0,3,0
0.047,"welterweight",NA,"right-handed",1,3,0,4,0.25
0.047,"light flyweight",13,"right-handed",8,5,0,13,0.615384615384615
0.047,"lightweight",NA,"right-handed",0,3,0,3,0
0.047,"super featherweight",NA,"right-handed",0,3,0,3,0
0.047,"flyweight",6,"right-handed",0,3,0,3,0
0.047,"heavyweight",25,"right-handed",0,3,0,3,0
0.047,"lightweight",9,"right-handed",0,3,0,3,0
0.047,"lightweight",7,"right-handed",0,3,0,3,0
0.047,"middleweight",26,"right-handed",0,3,0,3,0
0.047,"lightweight",14,"right-handed",0,3,0,3,0
0.047,"super lightweight",5,"right-handed",0,3,0,3,0
0.047,"super lightweight",17,"right-handed",0,3,0,3,0
0.047,"super welterweight",12,"right-handed",0,3,0,3,0
0.047,"super welterweight",21,"right-handed",0,3,0,3,0
0.047,"flyweight",13,"right-handed",4,15,1,20,0.225
0.047,"super featherweight",NA,"right-handed",0,3,1,4,0.125
0.047,"super lightweight",21,"right-handed",0,3,0,3,0
0.047,"super lightweight",4,"right-handed",0,3,0,3,0
0.047,"middleweight",6,"right-handed",0,2,0,2,0
0.047,"welterweight",7,"right-handed",0,3,1,4,0.125
0.047,"super welterweight",14,"right-handed",0,3,0,3,0
0.047,"bantamweight",6,"right-handed",0,3,0,3,0
0.047,"cruiserweight",21,"right-handed",0,3,0,3,0
0.047,"super lightweight",22,"right-handed",0,3,0,3,0
0.047,"super welterweight",32,"right-handed",0,3,0,3,0
0.047,"minimumweight",11,"right-handed",0,3,0,3,0
0.047,"super welterweight",6,"right-handed",0,3,0,3,0
0.047,"super lightweight",8,"right-handed",0,3,0,3,0
0.047,"lightweight",NA,"right-handed",0,3,0,3,0
0.047,"featherweight",11,"right-handed",0,3,0,3,0
0.047,"super bantamweight",10,"right-handed",0,3,0,3,0
0.047,"featherweight",6,"right-handed",0,3,1,4,0.125
0.047,"super lightweight",NA,"right-handed",0,3,1,4,0.125
0.047,"super welterweight",13,"right-handed",0,3,0,3,0
0.047,"super welterweight",NA,"right-handed",0,3,0,3,0
0.047,"light flyweight",17,"right-handed",0,3,0,3,0
0.047,"welterweight",NA,"right-handed",0,3,0,3,0
0.047,"cruiserweight",16,"right-handed",0,3,0,3,0
0.047,"super welterweight",20,"right-handed",0,3,0,3,0
0.047,"super flyweight",22,"right-handed",0,3,0,3,0
0.047,"bantamweight",16,"right-handed",0,3,0,3,0
0.047,"super welterweight",27,"right-handed",0,3,1,4,0.125
0.047,"bantamweight",10,"right-handed",0,3,0,3,0
0.047,"welterweight",NA,"right-handed",0,3,0,3,0
0.047,"light flyweight",6,"right-handed",1,3,0,4,0.25
0.047,"bantamweight",23,"right-handed",1,3,1,5,0.3
0.047,"bantamweight",9,"right-handed",1,3,0,4,0.25
0.047,"super featherweight",9,"right-handed",1,10,1,12,0.125
0.047,"super welterweight",19,"right-handed",1,5,0,6,0.166666666666667
0.047,"featherweight",20,"right-handed",1,2,2,5,0.4
0.047,"lightweight",19,"right-handed",1,3,0,4,0.25
0.047,"super bantamweight",11,"right-handed",5,5,1,11,0.5
0.047,"heavyweight",14,"right-handed",1,12,0,13,0.0769230769230769
0.047,"super lightweight",20,"right-handed",1,5,0,6,0.166666666666667
0.047,"bantamweight",11,"right-handed",1,3,1,5,0.3
0.047,"super featherweight",11,"right-handed",1,6,0,7,0.142857142857143
0.047,"welterweight",12,"right-handed",2,5,0,7,0.285714285714286
0.047,"featherweight",NA,"right-handed",2,3,0,5,0.4
0.047,"middleweight",11,"right-handed",0,3,2,5,0.2
0.047,"lightweight",17,"right-handed",1,6,0,7,0.142857142857143
0.047,"super welterweight",9,"right-handed",1,3,0,4,0.25
0.047,"featherweight",NA,"right-handed",0,3,1,4,0.125
0.047,"flyweight",11,"right-handed",2,3,0,5,0.4
0.047,"featherweight",25,"right-handed",1,4,0,5,0.2
0.047,"super bantamweight",11,"right-handed",2,4,0,6,0.333333333333333
0.047,"super lightweight",18,"right-handed",0,3,2,5,0.2
0.047,"super middleweight",NA,"right-handed",1,3,0,4,0.25
0.047,"cruiserweight",19,"right-handed",1,3,1,5,0.3
0.047,"super welterweight",9,"right-handed",1,3,0,4,0.25
0.047,"welterweight",23,"right-handed",1,3,0,4,0.25
0.047,"super featherweight",17,"right-handed",1,5,0,6,0.166666666666667
0.047,"super bantamweight",13,"right-handed",2,5,1,8,0.3125
0.047,"flyweight",7,"right-handed",2,8,0,10,0.2
0.047,"flyweight",5,"right-handed",1,3,0,4,0.25
0.047,"super bantamweight",9,"right-handed",2,3,0,5,0.4
0.047,"heavyweight",14,"right-handed",1,3,0,4,0.25
0.047,"super featherweight",12,"right-handed",1,4,0,5,0.2
0.047,"super middleweight",32,"right-handed",1,3,0,4,0.25
0.047,"super lightweight",11,"right-handed",1,3,1,5,0.3
0.047,"lightweight",11,"right-handed",1,3,2,6,0.333333333333333
0.047,"light heavyweight",13,"right-handed",2,4,0,6,0.333333333333333
0.047,"welterweight",NA,"right-handed",1,3,0,4,0.25
0.047,"minimumweight",8,"right-handed",1,3,0,4,0.25
0.047,"cruiserweight",20,"right-handed",2,3,0,5,0.4
0.047,"super bantamweight",14,"right-handed",1,5,1,7,0.214285714285714
0.047,"super flyweight",14,"right-handed",1,3,0,4,0.25
0.047,"minimumweight",5,"right-handed",1,3,0,4,0.25
0.047,"super flyweight",4,"right-handed",1,3,0,4,0.25
0.047,"flyweight",12,"right-handed",0,3,0,3,0
0.047,"bantamweight",9,"right-handed",0,3,0,3,0
0.047,"super middleweight",16,"right-handed",0,3,0,3,0
0.047,"heavyweight",8,"right-handed",0,3,0,3,0
0.047,"super featherweight",10,"right-handed",0,3,0,3,0
0.047,"light heavyweight",18,"right-handed",0,3,0,3,0
0.047,"lightweight",23,"right-handed",4,19,0,23,0.173913043478261
0.047,"bantamweight",15,"right-handed",6,9,0,15,0.4
0.047,"super welterweight",10,"right-handed",1,3,1,5,0.3
0.047,"super bantamweight",9,"right-handed",3,3,0,6,0.5
0.047,"super featherweight",6,"right-handed",2,2,0,4,0.5
0.047,"heavyweight",14,"right-handed",1,4,2,7,0.285714285714286
0.047,"super featherweight",NA,"right-handed",1,3,1,5,0.3
0.047,"super featherweight",8,"right-handed",3,3,0,6,0.5
0.047,"welterweight",5,"right-handed",4,9,0,13,0.307692307692308
0.047,"lightweight",9,"right-handed",2,2,0,4,0.5
0.047,"super middleweight",10,"right-handed",2,4,1,7,0.357142857142857
0.047,"flyweight",22,"right-handed",3,5,0,8,0.375
0.047,"super bantamweight",19,"right-handed",2,3,0,5,0.4
0.047,"super bantamweight",14,"right-handed",4,7,0,11,0.363636363636364
0.047,"super lightweight",15,"right-handed",3,7,0,10,0.3
0.047,"super bantamweight",13,"right-handed",3,4,0,7,0.428571428571429
0.047,"featherweight",21,"right-handed",2,3,0,5,0.4
0.047,"light flyweight",19,"right-handed",3,7,0,10,0.3
0.047,"super featherweight",14,"right-handed",2,9,1,12,0.208333333333333
0.047,"middleweight",19,"right-handed",4,5,0,9,0.444444444444444
0.047,"bantamweight",10,"right-handed",4,6,0,10,0.4
0.047,"super lightweight",6,"right-handed",3,4,1,8,0.4375
0.047,"super middleweight",9,"right-handed",2,1,0,3,0.666666666666667
0.047,"featherweight",18,"right-handed",2,3,2,7,0.428571428571429
0.047,"super featherweight",18,"right-handed",3,6,1,10,0.35
0.047,"super bantamweight",14,"right-handed",2,4,1,7,0.357142857142857
0.047,"light flyweight",6,"right-handed",2,4,0,6,0.333333333333333
0.047,"super featherweight",13,"right-handed",3,3,1,7,0.5
0.047,"super welterweight",11,"right-handed",4,10,0,14,0.285714285714286
0.047,"bantamweight",12,"right-handed",5,9,1,15,0.366666666666667
0.047,"middleweight",16,"right-handed",10,24,1,35,0.3
0.047,"featherweight",19,"right-handed",2,8,0,10,0.2
0.047,"heavyweight",8,"right-handed",1,3,1,5,0.3
0.047,"featherweight",5,"right-handed",1,3,0,4,0.25
0.047,"lightweight",16,"right-handed",1,2,0,3,0.333333333333333
0.047,"middleweight",10,"right-handed",1,3,1,5,0.3
0.047,"super bantamweight",12,"right-handed",1,4,0,5,0.2
0.047,"cruiserweight",NA,"right-handed",1,3,0,4,0.25
0.047,"super lightweight",17,"right-handed",1,6,0,7,0.142857142857143
0.047,"lightweight",7,"right-handed",1,4,0,5,0.2
0.047,"heavyweight",NA,"right-handed",1,3,1,5,0.3
0.047,"super lightweight",19,"right-handed",1,3,1,5,0.3
0.047,"welterweight",15,"right-handed",1,3,0,4,0.25
0.047,"super featherweight",14,"right-handed",1,5,0,6,0.166666666666667
0.047,"super lightweight",15,"right-handed",1,3,0,4,0.25
0.047,"super bantamweight",17,"right-handed",0,3,2,5,0.2
0.047,"featherweight",16,"right-handed",0,3,1,4,0.125
0.047,"featherweight",18,"right-handed",5,7,2,14,0.428571428571429
0.047,"super welterweight",19,"right-handed",1,3,0,4,0.25
0.047,"super welterweight",16,"right-handed",2,8,1,11,0.227272727272727
0.048,"heavyweight",11,"right-handed",0,2,1,3,0.166666666666667
0.048,"super featherweight",13,"right-handed",2,6,2,10,0.3
0.048,"super welterweight",18,"right-handed",26,149,10,185,0.167567567567568
0.047,"super middleweight",19,"right-handed",4,8,1,13,0.346153846153846
0.047,"light flyweight",16,"right-handed",4,5,0,9,0.444444444444444
0.047,"super featherweight",6,"right-handed",8,4,0,12,0.666666666666667
0.047,"minimumweight",11,"right-handed",9,5,0,14,0.642857142857143
0.047,"cruiserweight",19,"right-handed",3,7,0,10,0.3
0.047,"lightweight",10,"right-handed",0,3,2,5,0.2
0.047,"super middleweight",14,"right-handed",4,5,1,10,0.45
0.047,"super middleweight",19,"right-handed",7,3,1,11,0.681818181818182
0.047,"featherweight",9,"right-handed",3,1,0,4,0.75
0.047,"lightweight",10,"right-handed",6,3,0,9,0.666666666666667
0.047,"super middleweight",15,"right-handed",4,3,0,7,0.571428571428571
0.047,"super bantamweight",19,"right-handed",6,3,1,10,0.65
0.047,"cruiserweight",18,"right-handed",2,3,3,8,0.4375
0.047,"heavyweight",NA,"right-handed",2,4,1,7,0.357142857142857
0.047,"featherweight",9,"right-handed",6,4,0,10,0.6
0.047,"super lightweight",11,"right-handed",6,5,0,11,0.545454545454545
0.047,"middleweight",25,"right-handed",4,3,2,9,0.555555555555556
0.047,"heavyweight",24,"right-handed",20,24,0,44,0.454545454545455
0.047,"middleweight",27,"right-handed",4,3,0,7,0.571428571428571
0.047,"heavyweight",17,"right-handed",1,6,1,8,0.1875
0.047,"welterweight",18,"right-handed",5,9,1,15,0.366666666666667
0.047,"featherweight",NA,"right-handed",5,3,0,8,0.625
0.047,"lightweight",15,"right-handed",3,3,2,8,0.5
0.047,"super featherweight",13,"right-handed",5,4,0,9,0.555555555555556
0.047,"middleweight",10,"right-handed",1,3,1,5,0.3
0.047,"cruiserweight",28,"right-handed",4,4,0,8,0.5
0.047,"featherweight",15,"right-handed",3,6,1,10,0.35
0.047,"lightweight",17,"right-handed",5,7,1,13,0.423076923076923
0.047,"heavyweight",NA,"right-handed",4,8,0,12,0.333333333333333
0.047,"cruiserweight",9,"right-handed",7,13,2,22,0.363636363636364
0.047,"heavyweight",19,"right-handed",4,10,0,14,0.285714285714286
0.047,"welterweight",20,"right-handed",4,4,0,8,0.5
0.047,"lightweight",22,"right-handed",4,6,0,10,0.4
0.047,"lightweight",11,"right-handed",0,6,0,6,0
0.047,"bantamweight",11,"right-handed",8,19,0,27,0.296296296296296
0.047,"super welterweight",16,"right-handed",4,3,0,7,0.571428571428571
0.047,"super flyweight",19,"right-handed",4,7,2,13,0.384615384615385
0.047,"super welterweight",9,"right-handed",4,2,1,7,0.642857142857143
0.047,"super featherweight",12,"right-handed",5,3,0,8,0.625
0.047,"super flyweight",13,"right-handed",4,4,0,8,0.5
0.047,"featherweight",10,"right-handed",4,3,0,7,0.571428571428571
0.047,"minimumweight",7,"right-handed",4,3,0,7,0.571428571428571
0.047,"super middleweight",20,"right-handed",3,6,0,9,0.333333333333333
0.047,"light heavyweight",16,"right-handed",3,6,0,9,0.333333333333333
0.047,"super middleweight",14,"right-handed",4,17,0,21,0.19047619047619
0.047,"welterweight",17,"right-handed",5,36,0,41,0.121951219512195
0.047,"featherweight",6,"right-handed",2,2,0,4,0.5
0.048,"super flyweight",9,"right-handed",0,2,0,2,0
0.048,"cruiserweight",17,"right-handed",0,1,0,1,0
0.048,"super featherweight",12,"right-handed",0,2,0,2,0
0.048,"heavyweight",20,"right-handed",0,2,0,2,0
0.048,"minimumweight",11,"right-handed",0,2,1,3,0.166666666666667
0.048,"super flyweight",6,"right-handed",0,2,0,2,0
0.048,"super lightweight",18,"right-handed",0,2,0,2,0
0.048,"bantamweight",4,"right-handed",0,2,0,2,0
0.048,"super featherweight",20,"right-handed",0,2,0,2,0
0.048,"super lightweight",6,"right-handed",0,2,0,2,0
0.048,"middleweight",13,"right-handed",0,2,0,2,0
0.048,"bantamweight",7,"right-handed",0,2,0,2,0
0.048,"super bantamweight",10,"right-handed",0,2,0,2,0
0.048,"middleweight",18,"right-handed",0,2,0,2,0
0.048,"welterweight",10,"right-handed",0,1,0,1,0
0.048,"flyweight",6,"right-handed",0,2,0,2,0
0.048,"super bantamweight",5,"right-handed",0,2,0,2,0
0.048,"super featherweight",4,"right-handed",0,2,0,2,0
0.048,"cruiserweight",20,"right-handed",0,2,0,2,0
0.048,"super flyweight",9,"right-handed",0,2,0,2,0
0.048,"super lightweight",9,"right-handed",0,2,0,2,0
0.048,"super bantamweight",8,"right-handed",0,2,0,2,0
0.048,"",8,"right-handed",0,2,0,2,0
0.048,"super featherweight",10,"right-handed",0,2,0,2,0
0.048,"middleweight",5,"right-handed",0,2,0,2,0
0.048,"featherweight",18,"right-handed",5,4,2,11,0.545454545454545
0.048,"heavyweight",22,"right-handed",0,3,1,4,0.125
0.048,"middleweight",23,"right-handed",19,5,0,24,0.791666666666667
0.048,"super welterweight",8,"right-handed",3,4,1,8,0.4375
0.048,"featherweight",8,"right-handed",3,6,0,9,0.333333333333333
0.048,"super bantamweight",19,"right-handed",3,5,0,8,0.375
0.048,"welterweight",16,"right-handed",2,4,0,6,0.333333333333333
0.048,"featherweight",18,"right-handed",8,12,1,21,0.404761904761905
0.048,"lightweight",9,"right-handed",8,6,0,14,0.571428571428571
0.048,"super featherweight",15,"right-handed",1,4,0,5,0.2
0.048,"super middleweight",NA,"right-handed",1,3,1,5,0.3
0.048,"super flyweight",28,"right-handed",3,11,0,14,0.214285714285714
0.048,"super middleweight",20,"right-handed",1,3,2,6,0.333333333333333
0.048,"middleweight",9,"right-handed",0,3,0,3,0
0.048,"super featherweight",6,"right-handed",2,3,1,6,0.416666666666667
0.048,"flyweight",8,"right-handed",1,5,0,6,0.166666666666667
0.048,"super bantamweight",NA,"right-handed",14,4,0,18,0.777777777777778
0.048,"welterweight",15,"right-handed",10,14,1,25,0.42
0.048,"super bantamweight",8,"right-handed",5,4,2,11,0.545454545454545
0.048,"super flyweight",7,"right-handed",18,10,1,29,0.637931034482759
0.048,"cruiserweight",20,"right-handed",9,3,2,14,0.714285714285714
0.048,"middleweight",14,"right-handed",2,8,0,10,0.2
0.048,"super middleweight",16,"right-handed",25,41,6,72,0.388888888888889
0.048,"lightweight",10,"right-handed",2,3,0,5,0.4
0.048,"welterweight",16,"right-handed",11,7,0,18,0.611111111111111
0.048,"heavyweight",26,"right-handed",0,2,0,2,0
0.048,"super lightweight",16,"right-handed",0,2,0,2,0
0.048,"super middleweight",24,"right-handed",0,2,0,2,0
0.048,"featherweight",8,"right-handed",0,2,0,2,0
0.048,"bantamweight",6,"right-handed",0,2,0,2,0
0.048,"cruiserweight",NA,"right-handed",0,2,0,2,0
0.048,"welterweight",8,"right-handed",0,2,0,2,0
0.048,"super flyweight",7,"right-handed",0,2,0,2,0
0.048,"super bantamweight",4,"right-handed",0,2,0,2,0
0.048,"lightweight",6,"right-handed",0,2,0,2,0
0.048,"light heavyweight",17,"right-handed",0,1,0,1,0
0.048,"super featherweight",17,"right-handed",0,2,0,2,0
0.048,"super lightweight",11,"right-handed",0,2,0,2,0
0.048,"middleweight",NA,"right-handed",0,2,0,2,0
0.048,"lightweight",10,"right-handed",0,2,0,2,0
0.048,"cruiserweight",25,"right-handed",0,2,0,2,0
0.048,"bantamweight",NA,"right-handed",0,2,0,2,0
0.048,"flyweight",6,"right-handed",0,2,0,2,0
0.048,"featherweight",4,"right-handed",0,2,0,2,0
0.048,"lightweight",4,"right-handed",0,2,1,3,0.166666666666667
0.048,"super bantamweight",6,"right-handed",0,2,0,2,0
0.048,"super welterweight",8,"right-handed",0,2,0,2,0
0.048,"welterweight",17,"right-handed",0,2,0,2,0
0.048,"super lightweight",8,"right-handed",0,2,0,2,0
0.048,"super flyweight",5,"right-handed",0,2,0,2,0
0.048,"lightweight",27,"right-handed",0,2,0,2,0
0.048,"middleweight",NA,"right-handed",0,2,0,2,0
0.048,"lightweight",16,"right-handed",0,2,0,2,0
0.048,"cruiserweight",12,"right-handed",0,2,0,2,0
0.048,"super bantamweight",NA,"right-handed",0,2,0,2,0
0.048,"lightweight",NA,"right-handed",0,2,0,2,0
0.048,"lightweight",12,"right-handed",0,2,0,2,0
0.048,"cruiserweight",10,"right-handed",0,2,0,2,0
0.048,"lightweight",4,"right-handed",0,2,0,2,0
0.048,"lightweight",14,"right-handed",0,2,0,2,0
0.048,"super middleweight",8,"right-handed",0,2,0,2,0
0.048,"super featherweight",18,"right-handed",0,2,0,2,0
0.048,"super featherweight",9,"right-handed",0,2,0,2,0
0.048,"super bantamweight",8,"right-handed",0,2,0,2,0
0.048,"welterweight",21,"right-handed",0,2,0,2,0
0.048,"bantamweight",NA,"right-handed",0,2,0,2,0
0.048,"light heavyweight",23,"right-handed",0,2,0,2,0
0.048,"super featherweight",12,"right-handed",0,2,1,3,0.166666666666667
0.048,"heavyweight",11,"right-handed",0,2,0,2,0
0.048,"middleweight",20,"right-handed",0,2,0,2,0
0.048,"light flyweight",8,"right-handed",0,2,0,2,0
0.048,"super bantamweight",19,"right-handed",0,2,0,2,0
0.048,"super lightweight",8,"right-handed",0,2,0,2,0
0.048,"light heavyweight",17,"right-handed",0,2,0,2,0
0.048,"bantamweight",23,"right-handed",0,2,0,2,0
2.999,"featherweight",12,"right-handed",9,1,1,11,0.863636363636364
2.998,"heavyweight",20,"right-handed",14,3,1,18,0.805555555555556
2.998,"super lightweight",19,"right-handed",23,7,0,30,0.766666666666667
2.995,"heavyweight",30,"right-handed",14,14,2,30,0.5
2.995,"light heavyweight",17,"right-handed",35,22,1,58,0.612068965517241
2.992,"super middleweight",11,"right-handed",6,0,0,6,1
2.988,"flyweight",NA,"right-handed",5,11,1,17,0.323529411764706
2.986,"lightweight",13,"right-handed",7,7,0,14,0.5
2.985,"featherweight",17,"right-handed",9,17,1,27,0.351851851851852
2.983,"super lightweight",16,"right-handed",22,6,1,29,0.775862068965517
2.974,"cruiserweight",23,"right-handed",6,7,0,13,0.461538461538462
2.963,"welterweight",13,"right-handed",43,12,1,56,0.776785714285714
2.963,"heavyweight",28,"right-handed",19,3,0,22,0.863636363636364
2.957,"lightweight",10,"right-handed",5,6,1,12,0.458333333333333
2.95,"super middleweight",18,"right-handed",28,5,0,33,0.848484848484849
2.936,"super middleweight",NA,"right-handed",7,2,1,10,0.75
2.93,"cruiserweight",23,"right-handed",21,17,3,41,0.548780487804878
2.928,"super middleweight",13,"right-handed",8,4,0,12,0.666666666666667
2.913,"lightweight",11,"right-handed",11,10,2,23,0.521739130434783
2.909,"super middleweight",14,"right-handed",3,0,1,4,0.875
2.89,"bantamweight",14,"right-handed",6,27,2,35,0.2
2.89,"welterweight",11,"right-handed",3,0,2,5,0.8
2.885,"super flyweight",11,"right-handed",9,3,1,13,0.730769230769231
2.879,"super lightweight",15,"right-handed",18,9,2,29,0.655172413793103
2.876,"super lightweight",15,"right-handed",8,7,0,15,0.533333333333333
2.865,"super welterweight",16,"right-handed",17,7,0,24,0.708333333333333
2.865,"super welterweight",17,"right-handed",7,0,0,7,1
2.862,"featherweight",23,"right-handed",22,12,0,34,0.647058823529412
2.861,"lightweight",9,"right-handed",18,6,0,24,0.75
2.859,"lightweight",17,"right-handed",13,14,2,29,0.482758620689655
2.859,"light heavyweight",10,"right-handed",10,2,0,12,0.833333333333333
2.856,"super bantamweight",6,"right-handed",10,1,0,11,0.909090909090909
2.845,"lightweight",15,"right-handed",15,7,3,25,0.66
2.845,"lightweight",6,"right-handed",13,3,1,17,0.794117647058823
2.839,"flyweight",11,"right-handed",2,2,2,6,0.5
2.822,"welterweight",17,"right-handed",3,3,0,6,0.5
2.817,"super lightweight",19,"right-handed",9,6,2,17,0.588235294117647
2.812,"super featherweight",18,"right-handed",16,2,0,18,0.888888888888889
2.805,"super middleweight",11,"right-handed",12,0,0,12,1
2.795,"super lightweight",7,"right-handed",3,4,0,7,0.428571428571429
2.789,"featherweight",17,"right-handed",10,4,0,14,0.714285714285714
2.785,"super welterweight",8,"right-handed",1,9,1,11,0.136363636363636
2.768,"light heavyweight",20,"right-handed",11,5,1,17,0.676470588235294
2.767,"super lightweight",15,"right-handed",14,3,1,18,0.805555555555556
2.758,"super welterweight",11,"right-handed",3,0,0,3,1
2.756,"super middleweight",22,"right-handed",23,25,1,49,0.479591836734694
2.756,"featherweight",18,"right-handed",21,19,1,41,0.524390243902439
2.745,"super lightweight",11,"right-handed",6,0,0,6,1
2.745,"bantamweight",20,"right-handed",8,4,4,16,0.625
2.742,"light flyweight",13,"right-handed",13,9,10,32,0.5625
2.737,"welterweight",22,"right-handed",8,0,1,9,0.944444444444444
2.733,"featherweight",9,"right-handed",4,4,1,9,0.5
2.728,"lightweight",9,"right-handed",6,0,0,6,1
2.723,"super welterweight",15,"right-handed",7,3,0,10,0.7
2.717,"super middleweight",22,"right-handed",15,5,2,22,0.727272727272727
2.709,"lightweight",17,"right-handed",10,4,0,14,0.714285714285714
2.704,"super middleweight",17,"right-handed",13,2,1,16,0.84375
2.7,"welterweight",11,"right-handed",6,0,0,6,1
2.7,"super welterweight",15,"right-handed",6,0,0,6,1
2.699,"cruiserweight",21,"right-handed",19,6,0,25,0.76
2.695,"lightweight",13,"right-handed",10,3,0,13,0.769230769230769
2.684,"flyweight",16,"right-handed",10,11,0,21,0.476190476190476
2.682,"super middleweight",17,"right-handed",7,13,0,20,0.35
2.674,"super flyweight",15,"right-handed",5,3,0,8,0.625
2.667,"lightweight",12,"right-handed",7,4,0,11,0.636363636363636
2.664,"featherweight",16,"right-handed",6,13,0,19,0.315789473684211
2.662,"heavyweight",24,"right-handed",14,11,0,25,0.56
2.654,"super lightweight",31,"right-handed",12,13,2,27,0.481481481481481
2.648,"super middleweight",14,"right-handed",5,0,0,5,1
2.645,"super bantamweight",9,"right-handed",13,12,1,26,0.519230769230769
2.64,"super middleweight",12,"right-handed",17,0,0,17,1
2.639,"super lightweight",23,"right-handed",12,14,1,27,0.462962962962963
2.631,"middleweight",15,"right-handed",10,1,1,12,0.875
2.629,"featherweight",12,"right-handed",6,3,0,9,0.666666666666667
2.62,"featherweight",16,"right-handed",6,4,2,12,0.583333333333333
2.616,"light flyweight",10,"right-handed",10,0,0,10,1
2.615,"welterweight",12,"right-handed",15,2,0,17,0.882352941176471
2.614,"super welterweight",14,"right-handed",8,4,1,13,0.653846153846154
2.609,"super middleweight",25,"right-handed",7,25,3,35,0.242857142857143
2.608,"lightweight",18,"right-handed",38,23,0,61,0.622950819672131
2.602,"middleweight",19,"right-handed",11,25,5,41,0.329268292682927
2.602,"middleweight",21,"right-handed",21,12,0,33,0.636363636363636
2.592,"cruiserweight",23,"right-handed",7,5,0,12,0.583333333333333
2.592,"heavyweight",20,"right-handed",15,11,1,27,0.574074074074074
2.579,"welterweight",14,"right-handed",21,3,0,24,0.875
2.565,"welterweight",15,"right-handed",17,12,1,30,0.583333333333333
2.565,"super featherweight",9,"right-handed",4,4,0,8,0.5
2.557,"welterweight",20,"right-handed",17,38,1,56,0.3125
2.553,"super middleweight",9,"right-handed",4,1,0,5,0.8
2.552,"bantamweight",13,"right-handed",11,3,0,14,0.785714285714286
2.549,"cruiserweight",11,"right-handed",5,0,0,5,1
2.544,"light flyweight",9,"right-handed",5,6,1,12,0.458333333333333
2.542,"welterweight",20,"right-handed",18,13,0,31,0.580645161290323
2.542,"welterweight",14,"right-handed",6,9,1,16,0.40625
2.541,"super flyweight",18,"right-handed",19,16,2,37,0.540540540540541
2.537,"flyweight",8,"right-handed",6,6,0,12,0.5
2.522,"super bantamweight",11,"right-handed",7,2,1,10,0.75
2.52,"super welterweight",14,"right-handed",21,0,0,21,1
2.519,"bantamweight",21,"right-handed",15,28,8,51,0.372549019607843
2.512,"super lightweight",13,"right-handed",2,4,0,6,0.333333333333333
2.508,"super middleweight",27,"right-handed",14,10,0,24,0.583333333333333
2.507,"super featherweight",13,"right-handed",5,7,0,12,0.416666666666667
2.503,"light heavyweight",9,"right-handed",5,0,0,5,1
2.497,"welterweight",13,"right-handed",10,1,1,12,0.875
2.497,"featherweight",25,"right-handed",19,9,1,29,0.672413793103448
2.497,"super middleweight",18,"right-handed",22,9,0,31,0.709677419354839
2.493,"lightweight",23,"right-handed",10,6,3,19,0.605263157894737
2.484,"lightweight",16,"right-handed",12,2,0,14,0.857142857142857
2.483,"super middleweight",19,"right-handed",19,18,3,40,0.5125
2.483,"lightweight",7,"right-handed",11,2,0,13,0.846153846153846
2.472,"super middleweight",16,"right-handed",10,2,1,13,0.807692307692308
2.467,"welterweight",12,"right-handed",7,0,0,7,1
2.46,"super welterweight",22,"right-handed",20,9,1,30,0.683333333333333
2.458,"super lightweight",12,"right-handed",5,3,1,9,0.611111111111111
2.447,"welterweight",11,"right-handed",11,2,0,13,0.846153846153846
2.446,"super middleweight",20,"right-handed",24,12,0,36,0.666666666666667
2.445,"cruiserweight",22,"right-handed",21,3,0,24,0.875
2.424,"super featherweight",14,"right-handed",39,18,3,60,0.675
2.42,"super middleweight",NA,"right-handed",7,0,0,7,1
2.417,"super bantamweight",15,"right-handed",10,10,3,23,0.5
2.415,"middleweight",23,"right-handed",11,0,0,11,1
2.403,"super middleweight",17,"right-handed",12,1,0,13,0.923076923076923
2.401,"heavyweight",17,"right-handed",9,6,0,15,0.6
2.398,"super lightweight",18,"right-handed",8,5,2,15,0.6
2.387,"super welterweight",15,"right-handed",4,3,2,9,0.555555555555556
2.386,"super welterweight",22,"right-handed",22,1,0,23,0.956521739130435
2.385,"super middleweight",13,"right-handed",9,0,0,9,1
2.38,"welterweight",19,"right-handed",11,8,1,20,0.575
2.37,"light flyweight",20,"right-handed",33,9,1,43,0.779069767441861
2.364,"heavyweight",23,"right-handed",9,0,0,9,1
2.358,"super middleweight",21,"right-handed",18,7,0,25,0.72
2.353,"light flyweight",11,"right-handed",7,15,1,23,0.326086956521739
2.352,"featherweight",16,"right-handed",10,7,0,17,0.588235294117647
2.35,"heavyweight",23,"right-handed",9,1,1,11,0.863636363636364
2.348,"super middleweight",24,"right-handed",37,15,3,55,0.7
2.345,"bantamweight",9,"right-handed",15,3,0,18,0.833333333333333
2.34,"bantamweight",6,"right-handed",3,2,0,5,0.6
2.34,"welterweight",22,"right-handed",28,9,2,39,0.743589743589744
2.337,"heavyweight",16,"right-handed",5,4,0,9,0.555555555555556
2.337,"flyweight",17,"right-handed",24,5,0,29,0.827586206896552
2.326,"super featherweight",14,"right-handed",9,15,4,28,0.392857142857143
2.321,"heavyweight",17,"right-handed",9,1,0,10,0.9
2.319,"super lightweight",17,"right-handed",4,5,1,10,0.45
2.312,"light heavyweight",22,"right-handed",14,4,2,20,0.75
2.311,"super featherweight",12,"right-handed",15,13,1,29,0.53448275862069
2.309,"featherweight",13,"right-handed",17,2,1,20,0.875
2.308,"middleweight",17,"right-handed",19,15,1,35,0.557142857142857
2.308,"heavyweight",24,"right-handed",15,3,0,18,0.833333333333333
2.307,"super flyweight",17,"right-handed",18,1,0,19,0.947368421052632
2.306,"bantamweight",14,"right-handed",17,1,0,18,0.944444444444444
2.301,"middleweight",7,"right-handed",12,1,0,13,0.923076923076923
2.299,"super middleweight",NA,"right-handed",5,4,3,12,0.541666666666667
2.297,"middleweight",25,"right-handed",34,9,1,44,0.784090909090909
2.291,"welterweight",11,"right-handed",5,6,2,13,0.461538461538462
2.277,"welterweight",27,"right-handed",26,41,3,70,0.392857142857143
2.273,"super lightweight",16,"right-handed",12,11,1,24,0.520833333333333
2.268,"super lightweight",19,"right-handed",21,2,1,24,0.895833333333333
2.262,"middleweight",14,"right-handed",10,0,0,10,1
2.261,"lightweight",8,"right-handed",9,3,2,14,0.714285714285714
2.257,"featherweight",14,"right-handed",11,3,0,14,0.785714285714286
2.247,"welterweight",12,"right-handed",2,2,2,6,0.5
2.246,"super middleweight",13,"right-handed",15,8,2,25,0.64
2.239,"bantamweight",8,"right-handed",11,2,0,13,0.846153846153846
2.238,"super middleweight",NA,"right-handed",10,8,1,19,0.552631578947368
2.235,"lightweight",21,"right-handed",21,8,1,30,0.716666666666667
2.234,"lightweight",17,"right-handed",11,2,2,15,0.8
2.233,"super featherweight",8,"right-handed",10,17,0,27,0.37037037037037
2.232,"super welterweight",11,"right-handed",12,0,0,12,1
2.231,"super middleweight",NA,"right-handed",4,4,0,8,0.5
2.228,"middleweight",18,"right-handed",6,11,1,18,0.361111111111111
2.224,"bantamweight",11,"right-handed",12,1,1,14,0.892857142857143
2.223,"super featherweight",7,"right-handed",12,1,0,13,0.923076923076923
2.221,"super lightweight",14,"right-handed",4,1,0,5,0.8
2.219,"middleweight",9,"right-handed",7,7,0,14,0.5
2.217,"super lightweight",8,"right-handed",7,6,0,13,0.538461538461538
2.216,"super bantamweight",33,"right-handed",24,9,1,34,0.720588235294118
2.202,"cruiserweight",20,"right-handed",20,1,1,22,0.931818181818182
2.201,"heavyweight",29,"right-handed",20,17,2,39,0.538461538461538
2.2,"featherweight",7,"right-handed",5,3,0,8,0.625
2.199,"flyweight",11,"right-handed",10,2,1,13,0.807692307692308
2.197,"featherweight",7,"right-handed",7,3,1,11,0.681818181818182
2.197,"light heavyweight",24,"right-handed",13,8,0,21,0.619047619047619
2.195,"heavyweight",13,"right-handed",4,0,0,4,1
2.191,"super middleweight",16,"right-handed",22,5,1,28,0.803571428571429
2.186,"welterweight",10,"right-handed",7,1,0,8,0.875
2.186,"lightweight",16,"right-handed",5,19,3,27,0.240740740740741
2.183,"lightweight",22,"right-handed",9,38,4,51,0.215686274509804
2.18,"featherweight",7,"right-handed",6,1,1,8,0.8125
2.176,"super welterweight",21,"right-handed",15,27,1,43,0.36046511627907
2.149,"bantamweight",14,"right-handed",13,49,5,67,0.23134328358209
2.149,"welterweight",13,"right-handed",8,0,0,8,1
2.147,"lightweight",20,"right-handed",10,6,0,16,0.625
2.14,"super flyweight",12,"right-handed",11,6,3,20,0.625
2.137,"welterweight",27,"right-handed",31,9,0,40,0.775
2.134,"super middleweight",13,"right-handed",4,0,0,4,1
2.132,"middleweight",11,"right-handed",13,0,0,13,1
2.132,"super lightweight",17,"right-handed",7,3,2,12,0.666666666666667
2.129,"super welterweight",22,"right-handed",13,7,0,20,0.65
2.128,"super featherweight",16,"right-handed",27,10,3,40,0.7125
2.127,"super featherweight",9,"right-handed",4,7,1,12,0.375
2.125,"light flyweight",10,"right-handed",9,12,1,22,0.431818181818182
2.114,"welterweight",12,"right-handed",30,32,0,62,0.483870967741935
2.114,"welterweight",13,"right-handed",3,2,1,6,0.583333333333333
2.111,"lightweight",8,"right-handed",9,4,0,13,0.692307692307692
2.108,"lightweight",23,"right-handed",24,6,1,31,0.790322580645161
2.1,"super flyweight",10,"right-handed",8,6,0,14,0.571428571428571
2.098,"featherweight",10,"right-handed",8,9,4,21,0.476190476190476
2.097,"welterweight",20,"right-handed",12,11,1,24,0.520833333333333
2.093,"super welterweight",13,"right-handed",12,2,1,15,0.833333333333333
2.091,"lightweight",4,"right-handed",12,0,0,12,1
2.091,"cruiserweight",17,"right-handed",5,3,0,8,0.625
2.09,"bantamweight",20,"right-handed",21,49,7,77,0.318181818181818
2.088,"minimumweight",6,"right-handed",7,3,1,11,0.681818181818182
2.086,"super bantamweight",12,"right-handed",9,9,1,19,0.5
2.084,"bantamweight",9,"right-handed",8,3,0,11,0.727272727272727
2.083,"cruiserweight",NA,"right-handed",8,0,0,8,1
2.081,"welterweight",7,"right-handed",8,0,0,8,1
2.079,"super lightweight",20,"right-handed",10,20,0,30,0.333333333333333
2.078,"super featherweight",16,"right-handed",8,0,1,9,0.944444444444444
2.076,"featherweight",11,"right-handed",9,21,0,30,0.3
2.076,"light heavyweight",11,"right-handed",13,0,0,13,1
2.071,"middleweight",27,"right-handed",15,11,1,27,0.574074074074074
2.066,"heavyweight",8,"right-handed",3,1,0,4,0.75
2.066,"middleweight",10,"right-handed",2,0,0,2,1
2.058,"bantamweight",13,"right-handed",13,14,1,28,0.482142857142857
2.051,"heavyweight",26,"right-handed",9,8,2,19,0.526315789473684
2.045,"super lightweight",23,"right-handed",27,20,3,50,0.57
2.036,"featherweight",17,"right-handed",2,0,0,2,1
2.032,"super featherweight",18,"right-handed",15,14,1,30,0.516666666666667
2.029,"lightweight",15,"right-handed",6,1,1,8,0.8125
2.029,"lightweight",15,"right-handed",6,2,1,9,0.722222222222222
2.02,"bantamweight",7,"right-handed",16,0,0,16,1
2.014,"super welterweight",14,"right-handed",19,17,5,41,0.524390243902439
2.009,"featherweight",12,"right-handed",11,0,1,12,0.958333333333333
2.006,"heavyweight",30,"right-handed",12,6,0,18,0.666666666666667
2.004,"featherweight",13,"right-handed",11,6,1,18,0.638888888888889
2.002,"heavyweight",19,"right-handed",21,11,0,32,0.65625
2.002,"featherweight",9,"right-handed",13,4,0,17,0.764705882352941
2,"super bantamweight",14,"right-handed",17,9,4,30,0.633333333333333
1.996,"lightweight",16,"right-handed",13,2,0,15,0.866666666666667
1.995,"light flyweight",17,"right-handed",8,3,3,14,0.678571428571429
1.994,"heavyweight",24,"right-handed",29,6,0,35,0.828571428571429
1.988,"heavyweight",17,"right-handed",7,0,0,7,1
1.987,"super bantamweight",14,"right-handed",16,15,1,32,0.515625
1.986,"super lightweight",26,"right-handed",13,7,2,22,0.636363636363636
1.985,"super middleweight",30,"right-handed",8,9,1,18,0.472222222222222
1.984,"heavyweight",27,"right-handed",32,4,1,37,0.878378378378378
1.981,"light heavyweight",15,"right-handed",14,2,1,17,0.852941176470588
1.97,"super welterweight",23,"right-handed",14,2,0,16,0.875
1.965,"light heavyweight",8,"right-handed",5,0,0,5,1
1.957,"super bantamweight",12,"right-handed",12,9,4,25,0.56
1.953,"lightweight",20,"right-handed",7,11,1,19,0.394736842105263
1.953,"light heavyweight",22,"right-handed",32,3,0,35,0.914285714285714
1.952,"super middleweight",26,"right-handed",19,17,0,36,0.527777777777778
1.951,"super middleweight",19,"right-handed",16,4,4,24,0.75
1.949,"super welterweight",18,"right-handed",11,4,0,15,0.733333333333333
1.924,"light heavyweight",10,"right-handed",9,1,0,10,0.9
1.913,"heavyweight",19,"right-handed",4,0,0,4,1
1.908,"super middleweight",11,"right-handed",3,0,0,3,1
1.907,"super middleweight",19,"right-handed",8,4,4,16,0.625
1.901,"super middleweight",18,"right-handed",18,37,7,62,0.346774193548387
1.896,"heavyweight",17,"right-handed",13,2,0,15,0.866666666666667
1.895,"lightweight",20,"right-handed",41,24,1,66,0.628787878787879
1.893,"light heavyweight",13,"right-handed",6,12,1,19,0.342105263157895
1.893,"lightweight",18,"right-handed",29,10,4,43,0.720930232558139
1.889,"super bantamweight",12,"right-handed",5,4,4,13,0.538461538461538
1.887,"cruiserweight",24,"right-handed",12,2,0,14,0.857142857142857
1.883,"super lightweight",23,"right-handed",1,0,1,2,0.75
1.881,"cruiserweight",17,"right-handed",9,0,0,9,1
1.88,"super lightweight",15,"right-handed",11,1,0,12,0.916666666666667
1.876,"welterweight",17,"right-handed",9,18,3,30,0.35
1.875,"featherweight",6,"right-handed",3,6,0,9,0.333333333333333
1.873,"welterweight",7,"right-handed",14,0,0,14,1
1.873,"minimumweight",13,"right-handed",18,3,3,24,0.8125
1.87,"super lightweight",16,"right-handed",6,7,2,15,0.466666666666667
1.87,"super lightweight",11,"right-handed",7,2,0,9,0.777777777777778
1.867,"super lightweight",14,"right-handed",6,0,0,6,1
1.863,"cruiserweight",33,"right-handed",8,5,1,14,0.607142857142857
1.863,"heavyweight",19,"right-handed",2,5,0,7,0.285714285714286
1.861,"super lightweight",22,"right-handed",10,21,2,33,0.333333333333333
1.859,"light heavyweight",18,"right-handed",18,43,2,63,0.301587301587302
1.858,"super middleweight",NA,"right-handed",8,3,0,11,0.727272727272727
1.858,"super welterweight",8,"right-handed",4,3,3,10,0.55
1.858,"heavyweight",14,"right-handed",14,0,2,16,0.9375
1.858,"welterweight",14,"right-handed",10,2,0,12,0.833333333333333
1.856,"middleweight",22,"right-handed",12,2,0,14,0.857142857142857
1.849,"heavyweight",12,"right-handed",18,2,0,20,0.9
1.848,"flyweight",12,"right-handed",4,1,0,5,0.8
1.837,"super welterweight",15,"right-handed",6,5,0,11,0.545454545454545
1.834,"bantamweight",5,"right-handed",12,0,1,13,0.961538461538462
1.833,"super welterweight",8,"right-handed",4,0,0,4,1
1.832,"cruiserweight",19,"right-handed",13,2,1,16,0.84375
1.831,"middleweight",16,"right-handed",15,3,0,18,0.833333333333333
1.827,"super welterweight",5,"right-handed",7,0,0,7,1
1.827,"heavyweight",16,"right-handed",9,0,0,9,1
1.825,"super lightweight",10,"right-handed",13,0,0,13,1
1.824,"featherweight",4,"right-handed",4,0,0,4,1
1.815,"super featherweight",12,"right-handed",10,2,2,14,0.785714285714286
1.813,"super welterweight",27,"right-handed",14,10,1,25,0.58
1.811,"super welterweight",18,"right-handed",11,0,1,12,0.958333333333333
1.808,"lightweight",11,"right-handed",15,8,2,25,0.64
1.806,"super lightweight",12,"right-handed",10,7,2,19,0.578947368421053
1.805,"middleweight",12,"right-handed",7,4,1,12,0.625
1.802,"super middleweight",7,"right-handed",6,0,0,6,1
1.802,"lightweight",9,"right-handed",12,2,0,14,0.857142857142857
1.793,"super welterweight",11,"right-handed",10,0,0,10,1
1.793,"super bantamweight",16,"right-handed",11,24,0,35,0.314285714285714
1.784,"middleweight",NA,"right-handed",6,3,1,10,0.65
1.783,"super bantamweight",11,"right-handed",12,5,2,19,0.684210526315789
1.781,"featherweight",9,"right-handed",4,0,0,4,1
1.777,"super middleweight",7,"right-handed",5,0,0,5,1
1.777,"super bantamweight",21,"right-handed",10,9,3,22,0.522727272727273
1.771,"lightweight",19,"right-handed",5,7,6,18,0.444444444444444
1.765,"super lightweight",16,"right-handed",13,7,2,22,0.636363636363636
1.757,"light heavyweight",7,"right-handed",5,0,0,5,1
1.755,"cruiserweight",28,"right-handed",44,15,0,59,0.745762711864407
1.754,"super lightweight",14,"right-handed",16,1,0,17,0.941176470588235
1.747,"heavyweight",13,"right-handed",16,1,0,17,0.941176470588235
1.746,"featherweight",8,"right-handed",7,2,0,9,0.777777777777778
1.74,"lightweight",14,"right-handed",13,14,2,29,0.482758620689655
1.739,"flyweight",7,"right-handed",7,4,2,13,0.615384615384615
1.735,"middleweight",17,"right-handed",15,11,2,28,0.571428571428571
1.726,"super middleweight",7,"right-handed",4,0,1,5,0.9
1.725,"flyweight",13,"right-handed",11,6,0,17,0.647058823529412
1.725,"super flyweight",11,"right-handed",7,0,0,7,1
1.723,"super bantamweight",11,"right-handed",6,9,1,16,0.40625
1.721,"super welterweight",28,"right-handed",21,16,3,40,0.5625
1.72,"super featherweight",8,"right-handed",8,0,0,8,1
1.71,"super welterweight",25,"right-handed",21,4,2,27,0.814814814814815
1.709,"flyweight",15,"right-handed",21,45,2,68,0.323529411764706
1.705,"featherweight",17,"right-handed",7,0,0,7,1
1.702,"bantamweight",19,"right-handed",18,5,0,23,0.782608695652174
1.692,"middleweight",9,"right-handed",4,1,0,5,0.8
1.692,"middleweight",30,"right-handed",41,29,2,72,0.583333333333333
1.691,"super featherweight",17,"right-handed",10,14,5,29,0.431034482758621
1.69,"featherweight",11,"right-handed",7,2,2,11,0.727272727272727
1.69,"welterweight",11,"right-handed",12,2,0,14,0.857142857142857
1.69,"lightweight",11,"right-handed",11,1,1,13,0.884615384615385
1.686,"featherweight",20,"right-handed",6,6,2,14,0.5
1.685,"lightweight",17,"right-handed",12,14,4,30,0.466666666666667
1.685,"cruiserweight",9,"right-handed",19,1,0,20,0.95
1.682,"welterweight",18,"right-handed",3,6,3,12,0.375
1.682,"bantamweight",14,"right-handed",9,3,1,13,0.730769230769231
1.682,"flyweight",13,"right-handed",9,11,0,20,0.45
1.682,"super middleweight",19,"right-handed",6,22,4,32,0.25
1.68,"featherweight",9,"right-handed",1,3,0,4,0.25
1.679,"welterweight",25,"right-handed",18,4,2,24,0.791666666666667
1.677,"super featherweight",11,"right-handed",6,7,5,18,0.472222222222222
1.674,"super flyweight",19,"right-handed",15,1,1,17,0.911764705882353
1.673,"middleweight",NA,"right-handed",5,0,0,5,1
1.669,"super featherweight",14,"right-handed",7,6,1,14,0.535714285714286
1.668,"bantamweight",12,"right-handed",6,3,1,10,0.65
1.665,"cruiserweight",13,"right-handed",7,3,0,10,0.7
1.663,"heavyweight",28,"right-handed",25,12,0,37,0.675675675675676
1.662,"super middleweight",25,"right-handed",8,10,3,21,0.452380952380952
1.662,"super middleweight",16,"right-handed",15,11,1,27,0.574074074074074
1.662,"lightweight",26,"right-handed",36,33,6,75,0.52
1.659,"featherweight",10,"right-handed",10,1,1,12,0.875
1.659,"super flyweight",18,"right-handed",3,5,0,8,0.375
1.654,"minimumweight",8,"right-handed",18,0,0,18,1
1.651,"welterweight",11,"right-handed",11,0,0,11,1
1.65,"super bantamweight",7,"right-handed",11,3,0,14,0.785714285714286
1.649,"super welterweight",21,"right-handed",21,11,0,32,0.65625
1.649,"cruiserweight",16,"right-handed",17,5,0,22,0.772727272727273
1.641,"featherweight",9,"right-handed",22,4,0,26,0.846153846153846
1.64,"super lightweight",15,"right-handed",7,32,1,40,0.1875
1.638,"welterweight",12,"right-handed",11,10,0,21,0.523809523809524
1.634,"bantamweight",14,"right-handed",13,2,0,15,0.866666666666667
1.634,"welterweight",20,"right-handed",18,25,0,43,0.418604651162791
1.633,"super lightweight",19,"right-handed",16,14,3,33,0.53030303030303
1.632,"light heavyweight",30,"right-handed",15,5,0,20,0.75
1.632,"bantamweight",12,"right-handed",2,2,0,4,0.5
1.628,"super lightweight",16,"right-handed",6,4,1,11,0.590909090909091
1.627,"super featherweight",10,"right-handed",10,9,0,19,0.526315789473684
1.622,"super welterweight",16,"right-handed",13,5,0,18,0.722222222222222
1.622,"welterweight",16,"right-handed",7,7,1,15,0.5
1.617,"middleweight",13,"right-handed",6,4,4,14,0.571428571428571
1.614,"super middleweight",13,"right-handed",16,0,0,16,1
1.612,"super flyweight",8,"right-handed",7,5,0,12,0.583333333333333
1.605,"super featherweight",15,"right-handed",4,5,0,9,0.444444444444444
1.593,"super lightweight",17,"right-handed",16,15,3,34,0.514705882352941
1.593,"featherweight",11,"right-handed",7,6,2,15,0.533333333333333
1.59,"welterweight",16,"right-handed",18,18,1,37,0.5
1.59,"super welterweight",17,"right-handed",16,7,3,26,0.673076923076923
1.588,"super welterweight",24,"right-handed",10,6,2,18,0.611111111111111
1.583,"super welterweight",12,"right-handed",11,1,2,14,0.857142857142857
1.583,"super flyweight",11,"right-handed",8,0,0,8,1
1.578,"super lightweight",18,"right-handed",24,30,2,56,0.446428571428571
1.576,"middleweight",15,"right-handed",4,7,1,12,0.375
1.574,"super welterweight",15,"right-handed",16,20,3,39,0.448717948717949
1.567,"super flyweight",8,"right-handed",19,0,0,19,1
1.566,"super middleweight",13,"right-handed",11,9,0,20,0.55
1.565,"welterweight",11,"right-handed",9,0,1,10,0.95
1.56,"lightweight",11,"right-handed",8,3,1,12,0.708333333333333
1.557,"super welterweight",10,"right-handed",8,3,0,11,0.727272727272727
1.556,"super flyweight",8,"right-handed",16,5,0,21,0.761904761904762
1.555,"light heavyweight",13,"right-handed",9,0,0,9,1
1.551,"cruiserweight",29,"right-handed",49,19,2,70,0.714285714285714
1.55,"super featherweight",7,"right-handed",12,2,0,14,0.857142857142857
1.548,"super bantamweight",16,"right-handed",23,39,3,65,0.376923076923077
1.545,"light heavyweight",11,"right-handed",15,0,0,15,1
1.541,"super middleweight",14,"right-handed",7,1,1,9,0.833333333333333
1.54,"lightweight",25,"right-handed",5,7,0,12,0.416666666666667
1.537,"featherweight",18,"right-handed",13,10,0,23,0.565217391304348
1.53,"heavyweight",14,"right-handed",9,0,0,9,1
1.529,"super featherweight",26,"right-handed",19,12,0,31,0.612903225806452
1.528,"light heavyweight",18,"right-handed",10,15,2,27,0.407407407407407
1.525,"heavyweight",31,"right-handed",16,10,4,30,0.6
1.525,"super welterweight",10,"right-handed",8,0,1,9,0.944444444444444
1.519,"welterweight",9,"right-handed",10,4,1,15,0.7
1.513,"featherweight",6,"right-handed",11,1,0,12,0.916666666666667
1.5,"super lightweight",8,"right-handed",15,0,0,15,1
1.5,"lightweight",16,"right-handed",6,0,0,6,1
1.499,"lightweight",13,"right-handed",8,9,1,18,0.472222222222222
1.498,"welterweight",14,"right-handed",8,7,1,16,0.53125
1.494,"super bantamweight",12,"right-handed",10,11,0,21,0.476190476190476
1.494,"super flyweight",8,"right-handed",5,0,1,6,0.916666666666667
1.492,"super featherweight",9,"right-handed",6,8,0,14,0.428571428571429
1.483,"welterweight",13,"right-handed",12,7,2,21,0.619047619047619
1.483,"super bantamweight",12,"right-handed",11,1,0,12,0.916666666666667
1.481,"bantamweight",13,"right-handed",16,8,0,24,0.666666666666667
1.479,"super lightweight",10,"right-handed",8,6,1,15,0.566666666666667
1.475,"super flyweight",10,"right-handed",18,6,0,24,0.75
1.474,"flyweight",25,"right-handed",8,6,2,16,0.5625
1.469,"featherweight",9,"right-handed",9,2,0,11,0.818181818181818
1.469,"super lightweight",15,"right-handed",3,12,5,20,0.275
1.465,"super featherweight",7,"right-handed",20,1,0,21,0.952380952380952
1.464,"super lightweight",16,"right-handed",14,3,1,18,0.805555555555556
1.463,"super lightweight",16,"right-handed",9,3,3,15,0.7
1.455,"middleweight",20,"right-handed",13,6,0,19,0.684210526315789
1.454,"welterweight",14,"right-handed",7,8,0,15,0.466666666666667
1.453,"lightweight",12,"right-handed",10,3,2,15,0.733333333333333
1.45,"bantamweight",23,"right-handed",10,14,2,26,0.423076923076923
1.449,"welterweight",13,"right-handed",5,2,0,7,0.714285714285714
1.448,"super welterweight",8,"right-handed",9,4,1,14,0.678571428571429
1.446,"super bantamweight",15,"right-handed",16,8,1,25,0.66
1.446,"super featherweight",24,"right-handed",23,7,1,31,0.758064516129032
1.446,"lightweight",36,"right-handed",23,18,4,45,0.555555555555556
1.445,"flyweight",11,"right-handed",9,19,2,30,0.333333333333333
1.444,"minimumweight",NA,"right-handed",8,5,1,14,0.607142857142857
1.438,"middleweight",12,"right-handed",6,1,0,7,0.857142857142857
1.437,"super welterweight",22,"right-handed",23,9,2,34,0.705882352941177
1.435,"lightweight",16,"right-handed",29,11,1,41,0.719512195121951
1.434,"super bantamweight",23,"right-handed",9,16,1,26,0.365384615384615
1.43,"lightweight",17,"right-handed",12,10,4,26,0.538461538461538
1.428,"featherweight",6,"right-handed",4,2,0,6,0.666666666666667
1.428,"flyweight",14,"right-handed",15,0,0,15,1
1.427,"welterweight",11,"right-handed",7,33,6,46,0.217391304347826
1.421,"super lightweight",10,"right-handed",10,0,0,10,1
1.42,"lightweight",29,"right-handed",33,17,3,53,0.650943396226415
1.42,"super lightweight",14,"right-handed",3,2,0,5,0.6
1.42,"super featherweight",7,"right-handed",7,0,0,7,1
1.419,"super welterweight",7,"right-handed",4,1,1,6,0.75
1.418,"middleweight",17,"right-handed",6,5,0,11,0.545454545454545
1.413,"light heavyweight",20,"right-handed",13,17,1,31,0.435483870967742
1.412,"lightweight",8,"right-handed",6,0,0,6,1
1.409,"super middleweight",10,"right-handed",11,0,0,11,1
1.404,"super middleweight",6,"right-handed",5,0,0,5,1
1.404,"welterweight",21,"right-handed",17,11,4,32,0.59375
1.403,"cruiserweight",16,"right-handed",14,0,0,14,1
1.402,"light heavyweight",12,"right-handed",5,2,0,7,0.714285714285714
1.391,"super welterweight",8,"right-handed",3,5,3,11,0.409090909090909
1.39,"super welterweight",17,"right-handed",15,5,0,20,0.75
1.387,"super middleweight",15,"right-handed",6,3,0,9,0.666666666666667
1.386,"super lightweight",10,"right-handed",8,2,1,11,0.772727272727273
1.385,"super middleweight",30,"right-handed",6,4,0,10,0.6
1.384,"lightweight",12,"right-handed",11,7,0,18,0.611111111111111
1.383,"middleweight",25,"right-handed",5,9,1,15,0.366666666666667
1.383,"light heavyweight",10,"right-handed",4,2,1,7,0.642857142857143
1.379,"minimumweight",17,"right-handed",10,3,2,15,0.733333333333333
1.379,"middleweight",9,"right-handed",7,0,0,7,1
1.379,"lightweight",16,"right-handed",7,18,3,28,0.303571428571429
1.372,"super lightweight",15,"right-handed",10,9,1,20,0.525
1.372,"super welterweight",16,"right-handed",10,1,0,11,0.909090909090909
1.371,"super middleweight",12,"right-handed",5,1,1,7,0.785714285714286
1.369,"featherweight",18,"right-handed",11,16,0,27,0.407407407407407
1.367,"middleweight",10,"right-handed",9,1,1,11,0.863636363636364
1.367,"heavyweight",15,"right-handed",3,2,1,6,0.583333333333333
1.364,"super lightweight",12,"right-handed",13,7,1,21,0.642857142857143
1.362,"super featherweight",9,"right-handed",10,5,1,16,0.65625
1.359,"super middleweight",17,"right-handed",20,14,5,39,0.576923076923077
1.357,"welterweight",12,"right-handed",4,1,1,6,0.75
1.356,"light heavyweight",18,"right-handed",10,6,0,16,0.625
1.354,"welterweight",22,"right-handed",23,7,1,31,0.758064516129032
1.353,"welterweight",20,"right-handed",4,12,1,17,0.264705882352941
1.348,"welterweight",20,"right-handed",9,18,5,32,0.359375
1.348,"welterweight",13,"right-handed",2,10,1,13,0.192307692307692
1.347,"welterweight",13,"right-handed",11,4,3,18,0.694444444444444
1.345,"super welterweight",20,"right-handed",5,8,3,16,0.40625
1.342,"cruiserweight",13,"right-handed",9,2,0,11,0.818181818181818
1.34,"lightweight",13,"right-handed",9,15,0,24,0.375
1.338,"super middleweight",13,"right-handed",6,1,0,7,0.857142857142857
1.336,"super welterweight",9,"right-handed",4,0,0,4,1
1.334,"super welterweight",11,"right-handed",8,2,3,13,0.730769230769231
1.33,"super featherweight",18,"right-handed",6,10,0,16,0.375
1.329,"super bantamweight",20,"right-handed",7,6,1,14,0.535714285714286
1.329,"super welterweight",7,"right-handed",5,0,0,5,1
1.326,"super featherweight",5,"right-handed",3,1,1,5,0.7
1.326,"super lightweight",11,"right-handed",3,11,0,14,0.214285714285714
1.323,"light flyweight",13,"right-handed",8,7,2,17,0.529411764705882
1.32,"cruiserweight",24,"right-handed",7,7,2,16,0.5
1.32,"light heavyweight",20,"right-handed",7,13,1,21,0.357142857142857
1.318,"super bantamweight",9,"right-handed",2,0,0,2,1
1.318,"lightweight",15,"right-handed",6,4,2,12,0.583333333333333
1.318,"featherweight",10,"right-handed",16,6,0,22,0.727272727272727
1.312,"light heavyweight",22,"right-handed",10,0,0,10,1
1.309,"lightweight",14,"right-handed",7,11,2,20,0.4
1.304,"flyweight",NA,"right-handed",4,1,1,6,0.75
1.301,"welterweight",18,"right-handed",10,1,1,12,0.875
1.3,"featherweight",25,"right-handed",9,3,2,14,0.714285714285714
1.299,"lightweight",18,"right-handed",32,12,0,44,0.727272727272727
1.299,"cruiserweight",14,"right-handed",9,6,3,18,0.583333333333333
1.296,"featherweight",8,"right-handed",7,1,1,9,0.833333333333333
1.294,"super middleweight",18,"right-handed",7,3,1,11,0.681818181818182
1.294,"heavyweight",11,"right-handed",13,3,0,16,0.8125
1.29,"super featherweight",10,"right-handed",5,4,0,9,0.555555555555556
1.288,"light heavyweight",23,"right-handed",19,16,0,35,0.542857142857143
1.287,"featherweight",26,"right-handed",9,16,1,26,0.365384615384615
1.287,"welterweight",13,"right-handed",14,14,1,29,0.5
1.286,"light heavyweight",17,"right-handed",13,3,1,17,0.794117647058823
1.282,"super middleweight",18,"right-handed",26,30,4,60,0.466666666666667
1.277,"lightweight",17,"right-handed",7,44,3,54,0.157407407407407
1.267,"featherweight",21,"right-handed",28,17,0,45,0.622222222222222
1.266,"lightweight",13,"right-handed",6,7,4,17,0.470588235294118
1.264,"light heavyweight",17,"right-handed",7,0,0,7,1
1.259,"super welterweight",18,"right-handed",5,0,1,6,0.916666666666667
1.258,"super bantamweight",23,"right-handed",10,10,1,21,0.5
1.256,"lightweight",10,"right-handed",4,2,1,7,0.642857142857143
1.251,"welterweight",9,"right-handed",10,1,1,12,0.875
1.25,"super flyweight",10,"right-handed",5,4,2,11,0.545454545454545
1.249,"featherweight",12,"right-handed",10,6,0,16,0.625
1.244,"featherweight",26,"right-handed",19,26,2,47,0.425531914893617
1.243,"cruiserweight",12,"right-handed",5,13,0,18,0.277777777777778
1.24,"super featherweight",10,"right-handed",2,3,1,6,0.416666666666667
1.239,"welterweight",22,"right-handed",9,16,3,28,0.375
1.236,"super middleweight",16,"right-handed",20,2,0,22,0.909090909090909
1.234,"cruiserweight",14,"right-handed",4,0,0,4,1
1.232,"featherweight",17,"right-handed",24,3,0,27,0.888888888888889
1.232,"heavyweight",18,"right-handed",8,2,1,11,0.772727272727273
1.23,"welterweight",14,"right-handed",5,0,0,5,1
1.224,"heavyweight",22,"right-handed",7,0,0,7,1
1.223,"super welterweight",13,"right-handed",8,3,1,12,0.708333333333333
1.219,"cruiserweight",18,"right-handed",11,0,0,11,1
1.218,"super lightweight",11,"right-handed",32,27,1,60,0.541666666666667
1.217,"super middleweight",14,"right-handed",8,5,1,14,0.607142857142857
1.216,"heavyweight",15,"right-handed",6,0,0,6,1
1.215,"super bantamweight",18,"right-handed",23,9,0,32,0.71875
1.212,"heavyweight",10,"right-handed",14,8,0,22,0.636363636363636
1.202,"lightweight",23,"right-handed",19,3,1,23,0.847826086956522
1.202,"middleweight",32,"right-handed",22,13,1,36,0.625
1.201,"light heavyweight",30,"right-handed",11,13,0,24,0.458333333333333
1.201,"super welterweight",10,"right-handed",6,0,1,7,0.928571428571429
1.199,"super welterweight",6,"right-handed",8,14,0,22,0.363636363636364
1.196,"minimumweight",19,"right-handed",7,0,1,8,0.9375
1.195,"super flyweight",9,"right-handed",9,5,1,15,0.633333333333333
1.193,"super flyweight",9,"right-handed",11,2,1,14,0.821428571428571
1.191,"super flyweight",8,"right-handed",10,0,0,10,1
1.19,"super bantamweight",12,"right-handed",7,0,0,7,1
1.188,"welterweight",17,"right-handed",8,5,1,14,0.607142857142857
1.187,"lightweight",15,"right-handed",7,2,0,9,0.777777777777778
1.185,"middleweight",10,"right-handed",5,3,1,9,0.611111111111111
1.185,"super lightweight",16,"right-handed",14,5,0,19,0.736842105263158
1.185,"heavyweight",23,"right-handed",21,22,3,46,0.489130434782609
1.179,"super flyweight",18,"right-handed",9,1,1,11,0.863636363636364
1.177,"super flyweight",6,"right-handed",5,4,0,9,0.555555555555556
1.176,"middleweight",16,"right-handed",13,2,1,16,0.84375
1.175,"super lightweight",9,"right-handed",9,1,0,10,0.9
1.174,"welterweight",13,"right-handed",6,4,2,12,0.583333333333333
1.168,"super featherweight",13,"right-handed",10,5,2,17,0.647058823529412
1.167,"super lightweight",11,"right-handed",15,1,1,17,0.911764705882353
1.167,"light flyweight",14,"right-handed",7,6,2,15,0.533333333333333
1.166,"super middleweight",18,"right-handed",38,12,0,50,0.76
1.166,"super lightweight",31,"right-handed",31,16,0,47,0.659574468085106
1.165,"super lightweight",9,"right-handed",3,0,0,3,1
1.164,"welterweight",12,"right-handed",7,1,0,8,0.875
1.163,"flyweight",21,"right-handed",5,13,3,21,0.30952380952381
1.162,"cruiserweight",33,"right-handed",23,21,0,44,0.522727272727273
1.16,"lightweight",15,"right-handed",5,8,0,13,0.384615384615385
1.157,"light flyweight",7,"right-handed",8,1,1,10,0.85
1.157,"featherweight",11,"right-handed",8,0,1,9,0.944444444444444
1.156,"light heavyweight",NA,"right-handed",8,14,0,22,0.363636363636364
1.156,"super middleweight",8,"right-handed",11,3,0,14,0.785714285714286
1.151,"super lightweight",9,"right-handed",6,0,0,6,1
1.151,"super featherweight",15,"right-handed",15,14,1,30,0.516666666666667
1.145,"welterweight",10,"right-handed",9,0,0,9,1
1.144,"super featherweight",9,"right-handed",6,3,1,10,0.65
1.144,"cruiserweight",26,"right-handed",11,0,1,12,0.958333333333333
1.143,"welterweight",17,"right-handed",7,19,0,26,0.269230769230769
1.143,"lightweight",23,"right-handed",23,17,1,41,0.573170731707317
1.139,"featherweight",14,"right-handed",15,10,2,27,0.592592592592593
1.137,"super lightweight",15,"right-handed",11,5,0,16,0.6875
1.136,"middleweight",14,"right-handed",6,6,1,13,0.5
1.135,"super bantamweight",21,"right-handed",33,28,3,64,0.5390625
1.132,"super featherweight",17,"right-handed",8,15,0,23,0.347826086956522
1.129,"lightweight",11,"right-handed",1,0,1,2,0.75
1.126,"light heavyweight",NA,"right-handed",3,0,0,3,1
1.125,"flyweight",NA,"right-handed",5,1,2,8,0.75
1.124,"super lightweight",6,"right-handed",12,1,1,14,0.892857142857143
1.124,"super lightweight",11,"right-handed",10,1,1,12,0.875
1.122,"cruiserweight",11,"right-handed",8,0,0,8,1
1.122,"minimumweight",12,"right-handed",10,9,3,22,0.522727272727273
1.122,"welterweight",7,"right-handed",5,0,0,5,1
1.12,"welterweight",25,"right-handed",25,21,0,46,0.543478260869565
1.117,"super welterweight",13,"right-handed",17,4,0,21,0.80952380952381
1.117,"lightweight",15,"right-handed",12,0,0,12,1
1.111,"featherweight",19,"right-handed",9,17,2,28,0.357142857142857
1.108,"light heavyweight",13,"right-handed",14,1,1,16,0.90625
1.108,"bantamweight",12,"right-handed",12,7,1,20,0.625
1.108,"super lightweight",9,"right-handed",8,0,0,8,1
1.108,"bantamweight",17,"right-handed",7,6,2,15,0.533333333333333
1.107,"light heavyweight",21,"right-handed",28,5,0,33,0.848484848484849
1.104,"middleweight",21,"right-handed",5,3,0,8,0.625
1.103,"middleweight",19,"right-handed",7,17,3,27,0.314814814814815
1.099,"super flyweight",19,"right-handed",14,8,6,28,0.607142857142857
1.099,"super lightweight",14,"right-handed",7,5,0,12,0.583333333333333
1.098,"lightweight",14,"right-handed",11,7,2,20,0.6
1.098,"featherweight",8,"right-handed",13,2,0,15,0.866666666666667
1.098,"super welterweight",9,"right-handed",9,0,0,9,1
1.092,"welterweight",28,"right-handed",8,35,4,47,0.212765957446809
1.092,"super welterweight",9,"right-handed",14,0,0,14,1
1.092,"super lightweight",18,"right-handed",7,17,1,25,0.3
1.091,"super lightweight",24,"right-handed",6,0,0,6,1
1.088,"super featherweight",17,"right-handed",23,9,1,33,0.712121212121212
1.087,"lightweight",8,"right-handed",5,1,0,6,0.833333333333333
1.087,"super welterweight",19,"right-handed",3,12,7,22,0.295454545454545
1.087,"middleweight",7,"right-handed",10,0,0,10,1
1.085,"lightweight",19,"right-handed",11,21,1,33,0.348484848484849
1.084,"super featherweight",23,"right-handed",10,12,7,29,0.46551724137931
1.083,"super welterweight",7,"right-handed",8,1,0,9,0.888888888888889
1.083,"super bantamweight",24,"right-handed",14,9,2,25,0.6
1.082,"super flyweight",11,"right-handed",8,0,0,8,1
1.076,"cruiserweight",13,"right-handed",4,1,0,5,0.8
1.076,"cruiserweight",18,"right-handed",10,2,1,13,0.807692307692308
1.073,"bantamweight",11,"right-handed",5,4,0,9,0.555555555555556
1.073,"cruiserweight",15,"right-handed",2,0,0,2,1
1.072,"light flyweight",9,"right-handed",5,4,0,9,0.555555555555556
1.071,"heavyweight",23,"right-handed",8,2,1,11,0.772727272727273
1.07,"heavyweight",19,"right-handed",14,4,2,20,0.75
1.069,"super lightweight",10,"right-handed",25,18,0,43,0.581395348837209
1.067,"welterweight",11,"right-handed",4,2,0,6,0.666666666666667
1.066,"super middleweight",23,"right-handed",42,8,4,54,0.814814814814815
1.066,"super lightweight",13,"right-handed",15,10,1,26,0.596153846153846
1.066,"lightweight",13,"right-handed",13,11,0,24,0.541666666666667
1.065,"super flyweight",6,"right-handed",6,2,1,9,0.722222222222222
1.059,"lightweight",13,"right-handed",9,2,1,12,0.791666666666667
1.059,"bantamweight",7,"right-handed",4,1,1,6,0.75
1.055,"super welterweight",16,"right-handed",9,4,0,13,0.692307692307692
1.054,"super middleweight",32,"right-handed",5,7,0,12,0.416666666666667
1.054,"super welterweight",22,"right-handed",14,4,0,18,0.777777777777778
1.051,"flyweight",21,"right-handed",26,7,0,33,0.787878787878788
1.05,"welterweight",14,"right-handed",8,2,0,10,0.8
1.049,"featherweight",15,"right-handed",18,30,0,48,0.375
1.042,"super flyweight",7,"right-handed",5,3,2,10,0.6
1.041,"super flyweight",9,"right-handed",8,3,3,14,0.678571428571429
1.041,"featherweight",8,"right-handed",4,0,0,4,1
1.034,"heavyweight",NA,"right-handed",8,6,0,14,0.571428571428571
1.028,"super middleweight",15,"right-handed",8,2,1,11,0.772727272727273
1.027,"super featherweight",10,"right-handed",11,3,1,15,0.766666666666667
1.027,"cruiserweight",24,"right-handed",32,4,1,37,0.878378378378378
1.026,"featherweight",15,"right-handed",0,2,0,2,0
1.026,"cruiserweight",19,"right-handed",8,2,2,12,0.75
1.023,"super bantamweight",14,"right-handed",6,6,3,15,0.5
1.022,"welterweight",7,"right-handed",5,0,1,6,0.916666666666667
1.02,"lightweight",8,"right-handed",4,6,1,11,0.409090909090909
1.018,"welterweight",19,"right-handed",6,2,0,8,0.75
1.017,"welterweight",16,"right-handed",9,20,2,31,0.32258064516129
1.016,"super featherweight",15,"right-handed",19,1,1,21,0.928571428571429
1.015,"middleweight",12,"right-handed",15,6,0,21,0.714285714285714
1.012,"welterweight",21,"right-handed",29,19,1,49,0.602040816326531
1.011,"welterweight",20,"right-handed",7,5,0,12,0.583333333333333
1.008,"heavyweight",32,"right-handed",3,5,0,8,0.375
1.006,"super middleweight",8,"right-handed",22,0,0,22,1
1.004,"super welterweight",17,"right-handed",13,2,0,15,0.866666666666667
1,"featherweight",NA,"right-handed",4,0,1,5,0.9
0.999,"lightweight",17,"right-handed",13,5,1,19,0.710526315789474
0.996,"super welterweight",15,"right-handed",7,1,3,11,0.772727272727273
0.995,"heavyweight",25,"right-handed",9,2,1,12,0.791666666666667
0.994,"bantamweight",NA,"right-handed",9,1,1,11,0.863636363636364
0.994,"super bantamweight",9,"right-handed",16,0,0,16,1
0.993,"welterweight",17,"right-handed",14,10,0,24,0.583333333333333
0.988,"lightweight",14,"right-handed",9,0,0,9,1
0.987,"cruiserweight",9,"right-handed",2,0,0,2,1
0.984,"lightweight",22,"right-handed",7,6,1,14,0.535714285714286
0.983,"super lightweight",13,"right-handed",7,19,5,31,0.306451612903226
0.983,"cruiserweight",28,"right-handed",13,30,0,43,0.302325581395349
0.981,"bantamweight",24,"right-handed",12,9,1,22,0.568181818181818
0.981,"super lightweight",14,"right-handed",11,1,1,13,0.884615384615385
0.981,"middleweight",15,"right-handed",4,0,0,4,1
0.978,"heavyweight",18,"right-handed",5,0,0,5,1
0.978,"super welterweight",15,"right-handed",32,31,1,64,0.5078125
0.978,"super featherweight",18,"right-handed",62,54,2,118,0.533898305084746
0.975,"bantamweight",12,"right-handed",5,1,0,6,0.833333333333333
0.971,"featherweight",7,"right-handed",4,0,1,5,0.9
0.97,"super middleweight",11,"right-handed",13,0,0,13,1
0.968,"lightweight",9,"right-handed",6,4,1,11,0.590909090909091
0.965,"super featherweight",12,"right-handed",8,3,2,13,0.692307692307692
0.965,"super flyweight",8,"right-handed",10,3,0,13,0.769230769230769
0.965,"lightweight",7,"right-handed",4,0,1,5,0.9
0.964,"super featherweight",19,"right-handed",14,8,2,24,0.625
0.963,"super middleweight",21,"right-handed",28,14,2,44,0.659090909090909
0.962,"minimumweight",14,"right-handed",11,30,2,43,0.27906976744186
0.96,"welterweight",12,"right-handed",4,2,0,6,0.666666666666667
0.959,"welterweight",14,"right-handed",10,6,1,17,0.617647058823529
0.958,"super featherweight",9,"right-handed",11,1,0,12,0.916666666666667
0.953,"cruiserweight",12,"right-handed",16,0,0,16,1
0.952,"light flyweight",9,"right-handed",15,0,1,16,0.96875
0.95,"bantamweight",11,"right-handed",13,7,1,21,0.642857142857143
0.943,"super lightweight",17,"right-handed",11,9,2,22,0.545454545454545
0.943,"heavyweight",28,"right-handed",14,11,2,27,0.555555555555556
0.942,"super featherweight",12,"right-handed",16,13,1,30,0.55
0.94,"featherweight",13,"right-handed",14,1,0,15,0.933333333333333
0.94,"heavyweight",13,"right-handed",7,0,0,7,1
0.938,"heavyweight",13,"right-handed",4,3,1,8,0.5625
0.938,"featherweight",8,"right-handed",8,4,3,15,0.633333333333333
0.938,"heavyweight",20,"right-handed",11,13,2,26,0.461538461538462
0.937,"bantamweight",25,"right-handed",18,12,5,35,0.585714285714286
0.937,"middleweight",9,"right-handed",11,1,0,12,0.916666666666667
0.935,"middleweight",30,"right-handed",6,7,1,14,0.464285714285714
0.935,"welterweight",29,"right-handed",19,3,0,22,0.863636363636364
0.933,"light heavyweight",8,"right-handed",7,6,0,13,0.538461538461538
0.932,"light heavyweight",12,"right-handed",12,0,0,12,1
0.932,"lightweight",19,"right-handed",12,2,1,15,0.833333333333333
0.931,"super lightweight",15,"right-handed",5,3,2,10,0.6
0.931,"cruiserweight",19,"right-handed",5,12,5,22,0.340909090909091
0.93,"welterweight",12,"right-handed",10,0,0,10,1
0.926,"middleweight",16,"right-handed",16,40,0,56,0.285714285714286
0.926,"welterweight",17,"right-handed",10,14,2,26,0.423076923076923
0.926,"welterweight",17,"right-handed",17,2,1,20,0.875
0.925,"middleweight",23,"right-handed",1,6,0,7,0.142857142857143
0.917,"super featherweight",9,"right-handed",6,1,0,7,0.857142857142857
0.916,"lightweight",17,"right-handed",14,24,0,38,0.368421052631579
0.913,"super middleweight",10,"right-handed",2,5,1,8,0.3125
0.91,"heavyweight",26,"right-handed",2,1,1,4,0.625
0.909,"light flyweight",15,"right-handed",13,19,2,34,0.411764705882353
0.908,"super welterweight",15,"right-handed",8,15,4,27,0.37037037037037
0.903,"super bantamweight",12,"right-handed",7,1,2,10,0.8
0.902,"heavyweight",29,"right-handed",8,12,4,24,0.416666666666667
0.902,"lightweight",11,"right-handed",13,3,2,18,0.777777777777778
0.901,"super featherweight",10,"right-handed",8,7,2,17,0.529411764705882
0.899,"light flyweight",14,"right-handed",4,6,0,10,0.4
0.897,"featherweight",9,"right-handed",8,2,0,10,0.8
0.896,"super welterweight",10,"right-handed",9,0,0,9,1
0.895,"featherweight",6,"right-handed",4,7,3,14,0.392857142857143
0.894,"middleweight",10,"right-handed",11,3,0,14,0.785714285714286
0.893,"lightweight",24,"right-handed",28,23,2,53,0.547169811320755
0.893,"super welterweight",12,"right-handed",11,8,1,20,0.575
0.89,"super welterweight",8,"right-handed",6,0,1,7,0.928571428571429
0.89,"lightweight",12,"right-handed",5,0,1,6,0.916666666666667
0.889,"lightweight",16,"right-handed",14,0,0,14,1
0.889,"super welterweight",16,"right-handed",15,1,0,16,0.9375
0.888,"bantamweight",16,"right-handed",12,28,5,45,0.322222222222222
0.888,"super featherweight",9,"right-handed",6,9,0,15,0.4
0.887,"middleweight",17,"right-handed",20,10,0,30,0.666666666666667
0.886,"flyweight",11,"right-handed",2,15,0,17,0.117647058823529
0.886,"welterweight",16,"right-handed",11,6,0,17,0.647058823529412
0.884,"super flyweight",11,"right-handed",7,3,0,10,0.7
0.881,"super flyweight",7,"right-handed",9,1,1,11,0.863636363636364
0.881,"lightweight",21,"right-handed",31,11,0,42,0.738095238095238
0.88,"super bantamweight",22,"right-handed",17,26,0,43,0.395348837209302
0.87,"welterweight",18,"right-handed",10,0,2,12,0.916666666666667
0.868,"welterweight",21,"right-handed",5,3,2,10,0.6
0.867,"lightweight",18,"right-handed",4,4,1,9,0.5
0.866,"welterweight",12,"right-handed",9,1,0,10,0.9
0.862,"welterweight",21,"right-handed",18,0,0,18,1
0.852,"featherweight",8,"right-handed",9,3,0,12,0.75
0.85,"super lightweight",9,"right-handed",6,1,2,9,0.777777777777778
0.848,"welterweight",18,"right-handed",20,23,2,45,0.466666666666667
0.84,"lightweight",10,"right-handed",9,1,0,10,0.9
0.84,"super middleweight",14,"right-handed",23,6,3,32,0.765625
0.84,"lightweight",11,"right-handed",2,4,1,7,0.357142857142857
0.837,"middleweight",13,"right-handed",6,0,1,7,0.928571428571429
0.836,"super welterweight",24,"right-handed",19,24,0,43,0.441860465116279
0.835,"super welterweight",19,"right-handed",11,5,1,17,0.676470588235294
0.834,"middleweight",36,"right-handed",9,9,1,19,0.5
0.833,"super middleweight",14,"right-handed",9,0,0,9,1
0.83,"cruiserweight",16,"right-handed",4,10,0,14,0.285714285714286
0.829,"super welterweight",14,"right-handed",5,12,5,22,0.340909090909091
0.824,"super bantamweight",9,"right-handed",7,4,0,11,0.636363636363636
0.821,"super welterweight",10,"right-handed",7,4,2,13,0.615384615384615
0.816,"welterweight",9,"right-handed",11,6,0,17,0.647058823529412
0.815,"featherweight",5,"right-handed",4,2,0,6,0.666666666666667
0.814,"welterweight",12,"right-handed",10,1,0,11,0.909090909090909
0.812,"featherweight",18,"right-handed",10,18,3,31,0.370967741935484
0.81,"lightweight",13,"right-handed",14,4,0,18,0.777777777777778
0.809,"super middleweight",17,"right-handed",7,3,0,10,0.7
0.807,"middleweight",6,"right-handed",7,11,3,21,0.404761904761905
0.807,"bantamweight",13,"right-handed",5,15,0,20,0.25
0.806,"super lightweight",18,"right-handed",7,17,1,25,0.3
0.804,"middleweight",14,"right-handed",8,14,1,23,0.369565217391304
0.803,"featherweight",11,"right-handed",6,8,2,16,0.4375
0.801,"super bantamweight",11,"right-handed",13,0,0,13,1
0.801,"light heavyweight",12,"right-handed",5,8,1,14,0.392857142857143
0.801,"super bantamweight",13,"right-handed",8,11,1,20,0.425
0.8,"super featherweight",9,"right-handed",9,11,1,21,0.452380952380952
0.8,"featherweight",24,"right-handed",30,15,0,45,0.666666666666667
0.799,"light heavyweight",32,"right-handed",20,17,3,40,0.5375
0.793,"super middleweight",29,"right-handed",12,5,1,18,0.694444444444444
0.792,"featherweight",6,"right-handed",4,5,0,9,0.444444444444444
0.786,"super welterweight",23,"right-handed",16,3,2,21,0.80952380952381
0.785,"welterweight",11,"right-handed",11,0,2,13,0.923076923076923
0.781,"super middleweight",17,"right-handed",4,1,0,5,0.8
0.78,"middleweight",16,"right-handed",15,20,1,36,0.430555555555556
0.78,"super welterweight",11,"right-handed",2,1,0,3,0.666666666666667
0.778,"super lightweight",17,"right-handed",15,17,3,35,0.471428571428571
0.778,"middleweight",7,"right-handed",3,20,5,28,0.196428571428571
0.777,"super flyweight",8,"right-handed",5,3,0,8,0.625
0.773,"super welterweight",14,"right-handed",16,20,3,39,0.448717948717949
0.772,"welterweight",19,"right-handed",17,28,3,48,0.385416666666667
0.771,"welterweight",14,"right-handed",18,7,1,26,0.711538461538462
0.771,"middleweight",22,"right-handed",3,10,0,13,0.230769230769231
0.77,"middleweight",11,"right-handed",8,1,0,9,0.888888888888889
0.767,"super bantamweight",8,"right-handed",5,1,1,7,0.785714285714286
0.767,"welterweight",10,"right-handed",10,0,0,10,1
0.766,"middleweight",23,"right-handed",43,11,1,55,0.790909090909091
0.762,"welterweight",16,"right-handed",32,14,0,46,0.695652173913043
0.762,"lightweight",12,"right-handed",5,7,0,12,0.416666666666667
0.76,"super welterweight",20,"right-handed",6,2,0,8,0.75
0.76,"lightweight",19,"right-handed",11,6,1,18,0.638888888888889
0.759,"cruiserweight",20,"right-handed",7,35,3,45,0.188888888888889
0.759,"super bantamweight",8,"right-handed",9,0,0,9,1
0.756,"heavyweight",18,"right-handed",23,6,0,29,0.793103448275862
0.754,"light heavyweight",24,"right-handed",7,11,2,20,0.4
0.751,"super welterweight",11,"right-handed",16,6,2,24,0.708333333333333
0.75,"middleweight",10,"right-handed",4,1,1,6,0.75
0.748,"lightweight",12,"right-handed",13,5,0,18,0.722222222222222
0.746,"super flyweight",19,"right-handed",25,13,1,39,0.653846153846154
0.742,"featherweight",10,"right-handed",7,6,1,14,0.535714285714286
0.742,"light heavyweight",20,"right-handed",32,18,1,51,0.637254901960784
0.736,"super middleweight",27,"right-handed",33,14,0,47,0.702127659574468
0.732,"featherweight",8,"right-handed",4,0,0,4,1
0.729,"lightweight",19,"right-handed",9,10,3,22,0.477272727272727
0.729,"super featherweight",16,"right-handed",11,22,2,35,0.342857142857143
0.729,"super welterweight",20,"right-handed",6,12,2,20,0.35
0.727,"light heavyweight",17,"right-handed",5,9,4,18,0.388888888888889
0.725,"light flyweight",20,"right-handed",7,16,4,27,0.333333333333333
0.723,"super lightweight",23,"right-handed",14,11,0,25,0.56
0.72,"super middleweight",11,"right-handed",7,1,0,8,0.875
0.719,"super bantamweight",14,"right-handed",5,1,0,6,0.833333333333333
0.718,"light heavyweight",15,"right-handed",7,0,0,7,1
0.718,"cruiserweight",NA,"right-handed",15,2,1,18,0.861111111111111
0.718,"flyweight",10,"right-handed",16,1,0,17,0.941176470588235
0.716,"bantamweight",11,"right-handed",3,5,3,11,0.409090909090909
0.716,"cruiserweight",16,"right-handed",25,1,1,27,0.944444444444444
0.716,"lightweight",11,"right-handed",15,0,1,16,0.96875
0.713,"super bantamweight",10,"right-handed",7,0,0,7,1
0.713,"super welterweight",19,"right-handed",20,27,3,50,0.43
0.713,"light heavyweight",15,"right-handed",5,1,0,6,0.833333333333333
0.712,"super lightweight",12,"right-handed",11,0,0,11,1
0.707,"middleweight",6,"right-handed",9,0,0,9,1
0.707,"super featherweight",17,"right-handed",11,3,0,14,0.785714285714286
0.706,"super flyweight",15,"right-handed",5,11,5,21,0.357142857142857
0.705,"heavyweight",32,"right-handed",11,5,0,16,0.6875
0.705,"welterweight",16,"right-handed",6,3,2,11,0.636363636363636
0.704,"middleweight",24,"right-handed",10,1,0,11,0.909090909090909
0.703,"super flyweight",11,"right-handed",3,3,1,7,0.5
0.702,"flyweight",12,"right-handed",10,1,0,11,0.909090909090909
0.701,"super bantamweight",13,"right-handed",12,3,0,15,0.8
0.7,"super middleweight",17,"right-handed",4,0,1,5,0.9
0.699,"bantamweight",18,"right-handed",9,9,0,18,0.5
0.699,"super middleweight",22,"right-handed",3,9,3,15,0.3
0.696,"super featherweight",18,"right-handed",27,35,3,65,0.438461538461538
0.696,"lightweight",21,"right-handed",7,14,4,25,0.36
0.696,"cruiserweight",13,"right-handed",4,3,0,7,0.571428571428571
0.696,"featherweight",22,"right-handed",9,7,0,16,0.5625
0.695,"heavyweight",28,"right-handed",26,23,3,52,0.528846153846154
0.694,"welterweight",11,"right-handed",19,9,2,30,0.666666666666667
0.692,"heavyweight",20,"right-handed",12,8,1,21,0.595238095238095
0.691,"welterweight",11,"right-handed",3,0,0,3,1
0.69,"super bantamweight",8,"right-handed",1,2,0,3,0.333333333333333
0.689,"cruiserweight",15,"right-handed",9,6,2,17,0.588235294117647
0.682,"featherweight",NA,"right-handed",11,0,0,11,1
0.682,"super middleweight",13,"right-handed",4,0,0,4,1
0.681,"light flyweight",8,"right-handed",7,0,0,7,1
0.681,"middleweight",16,"right-handed",5,5,3,13,0.5
0.679,"super lightweight",15,"right-handed",23,4,0,27,0.851851851851852
0.679,"light heavyweight",17,"right-handed",9,0,0,9,1
0.676,"flyweight",6,"right-handed",5,2,1,8,0.6875
0.676,"heavyweight",30,"right-handed",28,34,0,62,0.451612903225806
0.675,"middleweight",19,"right-handed",7,13,2,22,0.363636363636364
0.675,"light heavyweight",28,"right-handed",19,14,1,34,0.573529411764706
0.674,"super flyweight",15,"right-handed",8,17,3,28,0.339285714285714
0.674,"super featherweight",23,"right-handed",7,11,0,18,0.388888888888889
0.673,"light heavyweight",13,"right-handed",10,29,3,42,0.273809523809524
0.673,"super lightweight",23,"right-handed",9,5,1,15,0.633333333333333
0.669,"heavyweight",29,"right-handed",43,28,1,72,0.604166666666667
0.669,"welterweight",12,"right-handed",4,0,0,4,1
0.668,"super featherweight",15,"right-handed",6,3,0,9,0.666666666666667
0.665,"heavyweight",25,"right-handed",12,3,0,15,0.8
0.664,"welterweight",13,"right-handed",8,4,1,13,0.653846153846154
0.663,"super lightweight",11,"right-handed",8,1,0,9,0.888888888888889
0.661,"cruiserweight",25,"right-handed",20,17,0,37,0.540540540540541
0.659,"featherweight",10,"right-handed",10,3,1,14,0.75
0.657,"cruiserweight",21,"right-handed",23,9,2,34,0.705882352941177
0.655,"super middleweight",6,"right-handed",6,1,0,7,0.857142857142857
0.655,"super welterweight",5,"right-handed",6,2,0,8,0.75
0.654,"heavyweight",29,"right-handed",3,20,2,25,0.16
0.654,"cruiserweight",14,"right-handed",8,0,0,8,1
0.651,"welterweight",18,"right-handed",12,0,1,13,0.961538461538462
0.649,"super welterweight",9,"right-handed",9,0,0,9,1
0.647,"super lightweight",15,"right-handed",11,7,0,18,0.611111111111111
0.644,"lightweight",18,"right-handed",5,18,2,25,0.24
0.644,"flyweight",8,"right-handed",4,2,2,8,0.625
0.644,"light heavyweight",16,"right-handed",13,1,2,16,0.875
0.642,"light heavyweight",27,"right-handed",13,14,4,31,0.483870967741935
0.642,"welterweight",17,"right-handed",4,16,1,21,0.214285714285714
0.642,"super welterweight",16,"right-handed",7,15,1,23,0.326086956521739
0.641,"super welterweight",16,"right-handed",12,0,0,12,1
0.637,"middleweight",20,"right-handed",10,2,2,14,0.785714285714286
0.636,"middleweight",13,"right-handed",5,8,0,13,0.384615384615385
0.636,"featherweight",11,"right-handed",14,5,0,19,0.736842105263158
0.635,"welterweight",12,"right-handed",3,0,1,4,0.875
0.635,"super lightweight",9,"right-handed",2,0,0,2,1
0.633,"heavyweight",11,"right-handed",7,0,0,7,1
0.631,"featherweight",14,"right-handed",4,0,0,4,1
0.628,"middleweight",13,"right-handed",11,6,0,17,0.647058823529412
0.627,"welterweight",17,"right-handed",9,15,0,24,0.375
0.627,"lightweight",8,"right-handed",8,0,0,8,1
0.627,"lightweight",15,"right-handed",13,12,3,28,0.517857142857143
0.626,"bantamweight",8,"right-handed",3,2,0,5,0.6
0.625,"welterweight",14,"right-handed",19,17,1,37,0.527027027027027
0.624,"light heavyweight",16,"right-handed",5,1,0,6,0.833333333333333
0.624,"super middleweight",13,"right-handed",4,0,0,4,1
0.623,"super middleweight",12,"right-handed",10,36,3,49,0.23469387755102
0.623,"featherweight",10,"right-handed",14,3,0,17,0.823529411764706
0.623,"lightweight",20,"right-handed",15,6,0,21,0.714285714285714
0.622,"featherweight",9,"right-handed",5,4,2,11,0.545454545454545
0.622,"welterweight",11,"right-handed",7,1,0,8,0.875
0.622,"super welterweight",22,"right-handed",5,4,0,9,0.555555555555556
0.621,"heavyweight",15,"right-handed",9,0,1,10,0.95
0.621,"welterweight",11,"right-handed",8,11,0,19,0.421052631578947
0.62,"cruiserweight",11,"right-handed",4,5,0,9,0.444444444444444
0.619,"super lightweight",13,"right-handed",8,5,0,13,0.615384615384615
0.612,"middleweight",19,"right-handed",9,0,1,10,0.95
0.612,"super flyweight",17,"right-handed",14,1,0,15,0.933333333333333
0.611,"heavyweight",10,"right-handed",4,7,0,11,0.363636363636364
0.609,"lightweight",12,"right-handed",9,1,1,11,0.863636363636364
0.609,"featherweight",4,"right-handed",8,0,0,8,1
0.609,"super welterweight",6,"right-handed",7,0,1,8,0.9375
0.609,"minimumweight",9,"right-handed",9,5,0,14,0.642857142857143
0.608,"super lightweight",6,"right-handed",6,0,0,6,1
0.607,"heavyweight",28,"right-handed",6,1,1,8,0.8125
0.605,"featherweight",12,"right-handed",8,16,1,25,0.34
0.604,"cruiserweight",8,"right-handed",6,0,0,6,1
0.604,"lightweight",17,"right-handed",8,8,1,17,0.5
0.604,"welterweight",22,"right-handed",14,16,2,32,0.46875
0.604,"featherweight",10,"right-handed",6,0,1,7,0.928571428571429
0.604,"super lightweight",14,"right-handed",11,8,1,20,0.575
0.602,"heavyweight",NA,"right-handed",2,0,1,3,0.833333333333333
0.602,"lightweight",15,"right-handed",16,10,1,27,0.611111111111111
0.599,"super welterweight",11,"right-handed",2,0,0,2,1
0.597,"super lightweight",8,"right-handed",6,0,0,6,1
0.594,"light flyweight",12,"right-handed",19,10,1,30,0.65
0.593,"featherweight",9,"right-handed",4,0,0,4,1
0.591,"lightweight",17,"right-handed",11,11,2,24,0.5
0.591,"super bantamweight",15,"right-handed",10,5,2,17,0.647058823529412
0.591,"lightweight",10,"right-handed",5,7,1,13,0.423076923076923
0.589,"super featherweight",9,"right-handed",9,1,0,10,0.9
0.589,"heavyweight",15,"right-handed",22,12,1,35,0.642857142857143
0.588,"welterweight",30,"right-handed",4,9,0,13,0.307692307692308
0.588,"bantamweight",14,"right-handed",8,13,0,21,0.380952380952381
0.586,"welterweight",13,"right-handed",7,0,0,7,1
0.582,"middleweight",16,"right-handed",9,0,0,9,1
0.582,"super middleweight",19,"right-handed",24,9,1,34,0.720588235294118
0.582,"super middleweight",18,"right-handed",6,2,0,8,0.75
0.581,"super flyweight",14,"right-handed",4,5,3,12,0.458333333333333
0.579,"light heavyweight",9,"right-handed",3,0,0,3,1
0.579,"middleweight",NA,"right-handed",4,2,1,7,0.642857142857143
0.578,"welterweight",16,"right-handed",8,6,2,16,0.5625
0.578,"super bantamweight",18,"right-handed",12,6,2,20,0.65
0.576,"middleweight",12,"right-handed",5,0,0,5,1
0.575,"middleweight",16,"right-handed",6,0,0,6,1
0.575,"super bantamweight",7,"right-handed",2,2,1,5,0.5
0.573,"welterweight",NA,"right-handed",16,9,2,27,0.62962962962963
0.572,"middleweight",NA,"right-handed",4,2,0,6,0.666666666666667
0.572,"light heavyweight",14,"right-handed",6,2,0,8,0.75
0.572,"super lightweight",20,"right-handed",12,6,2,20,0.65
0.571,"super lightweight",11,"right-handed",9,3,0,12,0.75
0.571,"featherweight",5,"right-handed",16,1,2,19,0.894736842105263
0.571,"super middleweight",22,"right-handed",32,37,1,70,0.464285714285714
0.57,"super middleweight",10,"right-handed",5,0,0,5,1
0.569,"light heavyweight",19,"right-handed",8,2,1,11,0.772727272727273
0.567,"super lightweight",8,"right-handed",4,0,0,4,1
0.567,"super lightweight",6,"right-handed",2,0,0,2,1
0.566,"welterweight",16,"right-handed",3,12,1,16,0.21875
0.562,"super lightweight",8,"right-handed",9,5,0,14,0.642857142857143
0.562,"super middleweight",NA,"right-handed",26,1,1,28,0.946428571428571
0.561,"super middleweight",11,"right-handed",3,2,0,5,0.6
0.56,"super featherweight",15,"right-handed",26,18,0,44,0.590909090909091
0.559,"super flyweight",11,"right-handed",8,2,0,10,0.8
0.557,"lightweight",20,"right-handed",7,3,0,10,0.7
0.556,"featherweight",11,"right-handed",5,0,0,5,1
0.556,"super lightweight",10,"right-handed",9,0,1,10,0.95
0.555,"light heavyweight",22,"right-handed",22,12,0,34,0.647058823529412
0.554,"super lightweight",19,"right-handed",7,0,1,8,0.9375
0.553,"light flyweight",6,"right-handed",14,1,1,16,0.90625
0.55,"flyweight",9,"right-handed",5,5,0,10,0.5
0.55,"super flyweight",9,"right-handed",4,1,2,7,0.714285714285714
0.55,"light flyweight",10,"right-handed",8,1,1,10,0.85
0.55,"heavyweight",16,"right-handed",5,6,1,12,0.458333333333333
0.549,"middleweight",9,"right-handed",2,1,1,4,0.625
0.549,"cruiserweight",26,"right-handed",7,19,0,26,0.269230769230769
0.548,"welterweight",16,"right-handed",9,4,1,14,0.678571428571429
0.546,"heavyweight",16,"right-handed",15,15,1,31,0.5
0.541,"flyweight",10,"right-handed",3,7,4,14,0.357142857142857
0.539,"featherweight",8,"right-handed",3,6,0,9,0.333333333333333
0.538,"lightweight",16,"right-handed",5,7,1,13,0.423076923076923
0.537,"middleweight",8,"right-handed",5,0,1,6,0.916666666666667
0.537,"flyweight",10,"right-handed",9,8,1,18,0.527777777777778
0.537,"super lightweight",31,"right-handed",18,18,4,40,0.5
0.535,"minimumweight",16,"right-handed",19,0,0,19,1
0.533,"light flyweight",12,"right-handed",7,3,4,14,0.642857142857143
0.533,"cruiserweight",25,"right-handed",24,8,0,32,0.75
0.532,"light heavyweight",12,"right-handed",5,0,0,5,1
0.532,"heavyweight",13,"right-handed",8,0,0,8,1
0.532,"light heavyweight",23,"right-handed",5,16,0,21,0.238095238095238
0.531,"middleweight",13,"right-handed",2,0,0,2,1
0.531,"cruiserweight",29,"right-handed",33,9,1,43,0.779069767441861
0.529,"middleweight",13,"right-handed",3,0,0,3,1
0.529,"cruiserweight",NA,"right-handed",9,0,1,10,0.95
0.528,"super flyweight",8,"right-handed",6,1,0,7,0.857142857142857
0.528,"welterweight",23,"right-handed",28,23,4,55,0.545454545454545
0.526,"super bantamweight",6,"right-handed",7,0,0,7,1
0.522,"super welterweight",15,"right-handed",10,0,1,11,0.954545454545455
0.522,"lightweight",14,"right-handed",3,1,0,4,0.75
0.52,"lightweight",15,"right-handed",4,15,1,20,0.225
0.519,"super featherweight",12,"right-handed",20,3,0,23,0.869565217391304
0.518,"featherweight",12,"right-handed",10,31,2,43,0.255813953488372
0.517,"light heavyweight",14,"right-handed",10,0,0,10,1
0.515,"middleweight",27,"right-handed",14,17,1,32,0.453125
0.514,"cruiserweight",16,"right-handed",10,0,1,11,0.954545454545455
0.514,"lightweight",20,"right-handed",15,20,0,35,0.428571428571429
0.513,"light heavyweight",30,"right-handed",16,10,1,27,0.611111111111111
0.513,"light heavyweight",19,"right-handed",7,9,0,16,0.4375
0.513,"welterweight",17,"right-handed",11,4,0,15,0.733333333333333
0.512,"lightweight",19,"right-handed",24,10,1,35,0.7
0.511,"bantamweight",21,"right-handed",17,25,4,46,0.41304347826087
0.511,"super middleweight",20,"right-handed",3,6,0,9,0.333333333333333
0.511,"welterweight",17,"right-handed",14,6,1,21,0.69047619047619
0.509,"super middleweight",7,"right-handed",3,0,0,3,1
0.509,"super welterweight",9,"right-handed",7,0,0,7,1
0.508,"light flyweight",20,"right-handed",7,28,2,37,0.216216216216216
0.507,"super lightweight",28,"right-handed",11,27,1,39,0.294871794871795
0.506,"super welterweight",19,"right-handed",20,21,4,45,0.488888888888889
0.505,"welterweight",9,"right-handed",3,0,0,3,1
0.505,"super welterweight",20,"right-handed",17,17,1,35,0.5
0.504,"heavyweight",19,"right-handed",12,1,0,13,0.923076923076923
0.502,"super middleweight",10,"right-handed",6,10,1,17,0.382352941176471
0.499,"featherweight",25,"right-handed",22,6,1,29,0.775862068965517
0.499,"super featherweight",8,"right-handed",12,1,0,13,0.923076923076923
0.499,"middleweight",NA,"right-handed",2,41,1,44,0.0568181818181818
0.498,"featherweight",13,"right-handed",8,1,0,9,0.888888888888889
0.497,"super welterweight",12,"right-handed",9,1,0,10,0.9
0.497,"super lightweight",12,"right-handed",7,7,4,18,0.5
0.496,"bantamweight",14,"right-handed",9,5,2,16,0.625
0.496,"middleweight",21,"right-handed",9,23,4,36,0.305555555555556
0.495,"featherweight",27,"right-handed",16,18,3,37,0.472972972972973
0.491,"light flyweight",10,"right-handed",7,3,2,12,0.666666666666667
0.49,"lightweight",7,"right-handed",10,0,0,10,1
0.49,"super middleweight",10,"right-handed",1,1,0,2,0.5
0.486,"super welterweight",16,"right-handed",8,17,4,29,0.344827586206897
0.484,"super bantamweight",18,"right-handed",8,3,1,12,0.708333333333333
0.482,"middleweight",20,"right-handed",23,30,6,59,0.440677966101695
0.481,"super welterweight",16,"right-handed",33,18,3,54,0.638888888888889
0.48,"super featherweight",15,"right-handed",17,14,1,32,0.546875
0.48,"welterweight",10,"right-handed",6,0,1,7,0.928571428571429
0.48,"heavyweight",18,"right-handed",7,2,0,9,0.777777777777778
0.479,"super lightweight",12,"right-handed",4,5,0,9,0.444444444444444
0.477,"bantamweight",10,"right-handed",7,17,7,31,0.338709677419355
0.476,"minimumweight",16,"right-handed",19,8,0,27,0.703703703703704
0.476,"welterweight",10,"right-handed",6,3,1,10,0.65
0.475,"cruiserweight",11,"right-handed",6,0,0,6,1
0.475,"welterweight",7,"right-handed",10,4,0,14,0.714285714285714
0.473,"super featherweight",15,"right-handed",12,20,1,33,0.378787878787879
0.473,"super featherweight",17,"right-handed",15,15,1,31,0.5
0.473,"bantamweight",23,"right-handed",18,23,3,44,0.443181818181818
0.472,"featherweight",18,"right-handed",16,12,0,28,0.571428571428571
0.472,"super bantamweight",5,"right-handed",7,1,0,8,0.875
0.469,"super lightweight",10,"right-handed",6,2,0,8,0.75
0.468,"super featherweight",12,"right-handed",8,14,3,25,0.38
0.467,"lightweight",15,"right-handed",5,0,1,6,0.916666666666667
0.461,"lightweight",16,"right-handed",9,4,0,13,0.692307692307692
0.459,"super middleweight",6,"right-handed",8,1,1,10,0.85
0.458,"welterweight",11,"right-handed",25,26,1,52,0.490384615384615
0.456,"featherweight",14,"right-handed",15,7,0,22,0.681818181818182
0.456,"lightweight",19,"right-handed",7,11,1,19,0.394736842105263
0.455,"super welterweight",10,"right-handed",7,4,1,12,0.625
0.454,"welterweight",19,"right-handed",5,10,2,17,0.352941176470588
0.454,"featherweight",14,"right-handed",10,13,0,23,0.434782608695652
0.454,"welterweight",10,"right-handed",2,0,1,3,0.833333333333333
0.451,"super bantamweight",12,"right-handed",5,13,4,22,0.318181818181818
0.45,"featherweight",18,"right-handed",12,18,3,33,0.409090909090909
0.449,"minimumweight",7,"right-handed",5,1,1,7,0.785714285714286
0.449,"super lightweight",18,"right-handed",12,1,1,14,0.892857142857143
0.448,"super lightweight",11,"right-handed",5,8,5,18,0.416666666666667
0.447,"super welterweight",13,"right-handed",3,4,2,9,0.444444444444444
0.446,"super welterweight",8,"right-handed",3,0,0,3,1
0.446,"super lightweight",22,"right-handed",21,11,1,33,0.651515151515151
0.445,"super middleweight",21,"right-handed",13,2,0,15,0.866666666666667
0.445,"lightweight",22,"right-handed",16,13,0,29,0.551724137931034
0.443,"super bantamweight",13,"right-handed",5,8,1,14,0.392857142857143
0.442,"super welterweight",14,"right-handed",4,2,1,7,0.642857142857143
0.441,"super middleweight",19,"right-handed",6,3,0,9,0.666666666666667
0.439,"super lightweight",21,"right-handed",14,13,0,27,0.518518518518518
0.439,"heavyweight",29,"right-handed",21,14,0,35,0.6
0.438,"super welterweight",12,"right-handed",5,2,0,7,0.714285714285714
0.438,"super bantamweight",12,"right-handed",10,1,3,14,0.821428571428571
0.438,"lightweight",11,"right-handed",1,7,0,8,0.125
0.436,"super featherweight",15,"right-handed",14,3,1,18,0.805555555555556
0.435,"super welterweight",17,"right-handed",5,7,1,13,0.423076923076923
0.434,"super welterweight",15,"right-handed",5,3,1,9,0.611111111111111
0.434,"super bantamweight",15,"right-handed",10,0,1,11,0.954545454545455
0.432,"featherweight",10,"right-handed",15,15,4,34,0.5
0.432,"super welterweight",9,"right-handed",6,0,0,6,1
0.432,"super bantamweight",13,"right-handed",15,1,0,16,0.9375
0.431,"heavyweight",32,"right-handed",8,10,0,18,0.444444444444444
0.43,"bantamweight",12,"right-handed",3,3,1,7,0.5
0.43,"super lightweight",16,"right-handed",2,7,2,11,0.272727272727273
0.429,"super welterweight",8,"right-handed",11,1,0,12,0.916666666666667
0.429,"heavyweight",25,"right-handed",33,20,0,53,0.622641509433962
0.427,"lightweight",11,"right-handed",3,1,1,5,0.7
0.427,"flyweight",15,"right-handed",5,4,2,11,0.545454545454545
0.426,"super welterweight",NA,"right-handed",5,0,0,5,1
0.425,"heavyweight",13,"right-handed",14,4,0,18,0.777777777777778
0.425,"light heavyweight",21,"right-handed",31,3,0,34,0.911764705882353
0.424,"super flyweight",20,"right-handed",3,10,3,16,0.28125
0.424,"super lightweight",20,"right-handed",21,5,0,26,0.807692307692308
0.423,"lightweight",6,"right-handed",9,0,0,9,1
0.423,"cruiserweight",15,"right-handed",13,15,1,29,0.46551724137931
0.423,"welterweight",16,"right-handed",9,10,0,19,0.473684210526316
0.423,"super middleweight",25,"right-handed",14,15,0,29,0.482758620689655
0.422,"lightweight",15,"right-handed",8,9,1,18,0.472222222222222
0.421,"featherweight",9,"right-handed",4,1,0,5,0.8
0.42,"super welterweight",13,"right-handed",8,2,1,11,0.772727272727273
0.419,"super welterweight",12,"right-handed",6,17,2,25,0.28
0.418,"welterweight",12,"right-handed",7,0,1,8,0.9375
0.418,"cruiserweight",26,"right-handed",12,10,1,23,0.543478260869565
0.418,"super featherweight",15,"right-handed",8,0,0,8,1
0.417,"welterweight",18,"right-handed",9,12,1,22,0.431818181818182
0.417,"light heavyweight",19,"right-handed",10,7,1,18,0.583333333333333
0.416,"featherweight",21,"right-handed",12,24,3,39,0.346153846153846
0.414,"flyweight",19,"right-handed",4,19,3,26,0.211538461538462
0.412,"super featherweight",10,"right-handed",7,0,1,8,0.9375
0.412,"super welterweight",21,"right-handed",11,66,3,80,0.15625
0.411,"light heavyweight",24,"right-handed",13,4,0,17,0.764705882352941
0.411,"super bantamweight",26,"right-handed",2,9,2,13,0.230769230769231
0.41,"light heavyweight",15,"right-handed",9,0,0,9,1
0.41,"bantamweight",11,"right-handed",8,3,1,12,0.708333333333333
0.406,"heavyweight",24,"right-handed",14,6,0,20,0.7
0.406,"lightweight",13,"right-handed",13,36,3,52,0.278846153846154
0.406,"lightweight",3,"right-handed",7,0,0,7,1
0.405,"flyweight",11,"right-handed",8,11,2,21,0.428571428571429
0.403,"super lightweight",11,"right-handed",9,11,1,21,0.452380952380952
0.402,"super lightweight",8,"right-handed",4,1,0,5,0.8
0.399,"welterweight",18,"right-handed",15,18,0,33,0.454545454545455
0.398,"light heavyweight",11,"right-handed",3,0,0,3,1
0.398,"featherweight",14,"right-handed",5,2,0,7,0.714285714285714
0.398,"heavyweight",23,"right-handed",20,19,2,41,0.51219512195122
0.395,"super welterweight",12,"right-handed",8,1,0,9,0.888888888888889
0.394,"super featherweight",23,"right-handed",3,11,2,16,0.25
0.394,"flyweight",4,"right-handed",4,6,0,10,0.4
0.393,"super featherweight",21,"right-handed",11,18,0,29,0.379310344827586
0.393,"lightweight",30,"right-handed",8,14,0,22,0.363636363636364
0.393,"flyweight",7,"right-handed",5,6,3,14,0.464285714285714
0.393,"middleweight",30,"right-handed",17,27,4,48,0.395833333333333
0.393,"middleweight",35,"right-handed",23,18,1,42,0.55952380952381
0.392,"super flyweight",9,"right-handed",5,5,2,12,0.5
0.391,"super lightweight",8,"right-handed",9,0,0,9,1
0.39,"super welterweight",10,"right-handed",10,0,0,10,1
0.39,"lightweight",14,"right-handed",3,0,0,3,1
0.389,"light heavyweight",15,"right-handed",8,0,0,8,1
0.389,"bantamweight",17,"right-handed",7,1,0,8,0.875
0.389,"lightweight",17,"right-handed",6,4,0,10,0.6
0.388,"middleweight",27,"right-handed",5,6,2,13,0.461538461538462
0.388,"welterweight",15,"right-handed",36,36,2,74,0.5
0.387,"light heavyweight",21,"right-handed",21,20,0,41,0.51219512195122
0.385,"cruiserweight",13,"right-handed",2,0,0,2,1
0.384,"super bantamweight",7,"right-handed",3,1,0,4,0.75
0.383,"lightweight",8,"right-handed",11,2,0,13,0.846153846153846
0.381,"heavyweight",8,"right-handed",6,1,0,7,0.857142857142857
0.379,"welterweight",22,"right-handed",24,7,1,32,0.765625
0.379,"cruiserweight",11,"right-handed",9,23,0,32,0.28125
0.379,"super middleweight",23,"right-handed",26,10,1,37,0.716216216216216
0.378,"featherweight",10,"right-handed",19,0,0,19,1
0.377,"heavyweight",16,"right-handed",7,0,1,8,0.9375
0.377,"welterweight",8,"right-handed",7,0,0,7,1
0.374,"super bantamweight",10,"right-handed",5,3,0,8,0.625
0.374,"featherweight",15,"right-handed",7,5,2,14,0.571428571428571
0.373,"middleweight",19,"right-handed",10,0,1,11,0.954545454545455
0.371,"super bantamweight",6,"right-handed",5,3,0,8,0.625
0.371,"lightweight",22,"right-handed",10,15,1,26,0.403846153846154
0.37,"super featherweight",16,"right-handed",4,3,0,7,0.571428571428571
0.37,"light heavyweight",10,"right-handed",1,0,0,1,1
0.367,"lightweight",15,"right-handed",5,16,1,22,0.25
0.367,"lightweight",17,"right-handed",9,4,0,13,0.692307692307692
0.367,"featherweight",12,"right-handed",8,3,0,11,0.727272727272727
0.367,"light heavyweight",16,"right-handed",23,0,0,23,1
0.364,"middleweight",29,"right-handed",23,47,2,72,0.333333333333333
0.364,"bantamweight",8,"right-handed",1,16,0,17,0.0588235294117647
0.364,"lightweight",13,"right-handed",5,1,0,6,0.833333333333333
0.363,"heavyweight",6,"right-handed",9,1,0,10,0.9
0.362,"welterweight",9,"right-handed",5,0,0,5,1
0.361,"lightweight",10,"right-handed",6,16,4,26,0.307692307692308
0.359,"super welterweight",10,"right-handed",6,0,0,6,1
0.359,"featherweight",13,"right-handed",8,4,0,12,0.666666666666667
0.359,"flyweight",19,"right-handed",12,10,0,22,0.545454545454545
0.359,"welterweight",21,"right-handed",13,19,1,33,0.409090909090909
0.358,"welterweight",18,"right-handed",12,15,0,27,0.444444444444444
0.357,"cruiserweight",24,"right-handed",13,31,4,48,0.3125
0.357,"featherweight",10,"right-handed",9,0,0,9,1
0.357,"heavyweight",24,"right-handed",8,8,1,17,0.5
0.356,"heavyweight",11,"right-handed",4,1,0,5,0.8
0.354,"super welterweight",15,"right-handed",11,11,1,23,0.5
0.354,"super lightweight",9,"right-handed",8,0,0,8,1
0.352,"light heavyweight",16,"right-handed",12,1,0,13,0.923076923076923
0.352,"super middleweight",22,"right-handed",4,2,0,6,0.666666666666667
0.352,"welterweight",16,"right-handed",4,2,1,7,0.642857142857143
0.352,"super middleweight",9,"right-handed",1,8,0,9,0.111111111111111
0.351,"middleweight",7,"right-handed",8,0,0,8,1
0.349,"featherweight",12,"right-handed",7,1,0,8,0.875
0.347,"lightweight",16,"right-handed",7,3,0,10,0.7
0.347,"super flyweight",12,"right-handed",8,10,0,18,0.444444444444444
0.347,"bantamweight",7,"right-handed",12,13,3,28,0.482142857142857
0.346,"light heavyweight",19,"right-handed",3,16,1,20,0.175
0.346,"welterweight",8,"right-handed",5,23,0,28,0.178571428571429
0.345,"lightweight",22,"right-handed",16,14,0,30,0.533333333333333
0.342,"super lightweight",9,"right-handed",14,0,0,14,1
0.342,"super lightweight",13,"right-handed",10,0,0,10,1
0.342,"lightweight",8,"right-handed",4,2,2,8,0.625
0.341,"middleweight",21,"right-handed",3,5,1,9,0.388888888888889
0.34,"super lightweight",NA,"right-handed",3,1,0,4,0.75
0.339,"featherweight",4,"right-handed",2,3,0,5,0.4
0.339,"bantamweight",13,"right-handed",4,10,0,14,0.285714285714286
0.338,"lightweight",13,"right-handed",5,0,0,5,1
0.337,"heavyweight",27,"right-handed",1,4,2,7,0.285714285714286
0.337,"welterweight",19,"right-handed",3,13,5,21,0.261904761904762
0.336,"middleweight",9,"right-handed",8,0,0,8,1
0.333,"welterweight",27,"right-handed",17,8,0,25,0.68
0.331,"middleweight",11,"right-handed",3,0,0,3,1
0.33,"super lightweight",8,"right-handed",3,2,0,5,0.6
0.33,"cruiserweight",6,"right-handed",1,0,0,1,1
0.327,"featherweight",17,"right-handed",17,21,2,40,0.45
0.326,"light flyweight",15,"right-handed",8,4,0,12,0.666666666666667
0.326,"super welterweight",16,"right-handed",2,0,0,2,1
0.325,"welterweight",16,"right-handed",8,26,1,35,0.242857142857143
0.324,"featherweight",7,"right-handed",6,3,0,9,0.666666666666667
0.324,"bantamweight",11,"right-handed",0,2,0,2,0
0.324,"welterweight",20,"right-handed",24,17,1,42,0.583333333333333
0.324,"featherweight",8,"right-handed",7,3,1,11,0.681818181818182
0.323,"featherweight",12,"right-handed",8,1,0,9,0.888888888888889
0.323,"heavyweight",9,"right-handed",12,0,0,12,1
0.322,"featherweight",13,"right-handed",6,3,0,9,0.666666666666667
0.321,"super flyweight",10,"right-handed",12,6,0,18,0.666666666666667
0.321,"super lightweight",27,"right-handed",12,21,1,34,0.367647058823529
0.321,"super bantamweight",26,"right-handed",26,14,0,40,0.65
0.318,"heavyweight",27,"right-handed",40,9,1,50,0.81
0.317,"super lightweight",21,"right-handed",7,14,1,22,0.340909090909091
0.317,"cruiserweight",40,"right-handed",9,2,2,13,0.769230769230769
0.317,"bantamweight",12,"right-handed",8,16,3,27,0.351851851851852
0.317,"welterweight",11,"right-handed",10,16,0,26,0.384615384615385
0.316,"super welterweight",11,"right-handed",12,0,0,12,1
0.316,"super welterweight",16,"right-handed",10,0,1,11,0.954545454545455
0.315,"super welterweight",12,"right-handed",12,2,2,16,0.8125
0.315,"lightweight",17,"right-handed",8,3,0,11,0.727272727272727
0.314,"super flyweight",8,"right-handed",3,0,0,3,1
0.313,"welterweight",33,"right-handed",15,20,0,35,0.428571428571429
0.311,"light heavyweight",7,"right-handed",8,0,0,8,1
0.31,"minimumweight",10,"right-handed",4,3,0,7,0.571428571428571
0.309,"heavyweight",31,"right-handed",53,26,0,79,0.670886075949367
0.309,"light heavyweight",22,"right-handed",7,4,0,11,0.636363636363636
0.308,"middleweight",11,"right-handed",2,0,1,3,0.833333333333333
0.308,"featherweight",13,"right-handed",10,3,1,14,0.75
0.307,"welterweight",13,"right-handed",19,34,5,58,0.370689655172414
0.307,"welterweight",8,"right-handed",4,6,2,12,0.416666666666667
0.306,"featherweight",11,"right-handed",1,1,3,5,0.5
0.306,"super lightweight",6,"right-handed",6,0,2,8,0.875
0.304,"super featherweight",14,"right-handed",18,2,1,21,0.880952380952381
0.303,"lightweight",21,"right-handed",2,2,1,5,0.5
0.303,"welterweight",15,"right-handed",8,3,0,11,0.727272727272727
0.303,"super middleweight",20,"right-handed",17,31,3,51,0.362745098039216
0.302,"cruiserweight",18,"right-handed",8,2,1,11,0.772727272727273
0.302,"super flyweight",6,"right-handed",5,2,2,9,0.666666666666667
0.301,"super featherweight",14,"right-handed",2,3,2,7,0.428571428571429
0.3,"super flyweight",6,"right-handed",7,0,0,7,1
0.3,"lightweight",14,"right-handed",6,13,1,20,0.325
0.3,"super middleweight",6,"right-handed",9,6,0,15,0.6
0.3,"middleweight",23,"right-handed",15,3,0,18,0.833333333333333
0.299,"super lightweight",28,"right-handed",29,12,2,43,0.697674418604651
0.299,"super bantamweight",14,"right-handed",4,1,1,6,0.75
0.298,"middleweight",11,"right-handed",4,0,0,4,1
0.298,"heavyweight",24,"right-handed",9,14,1,24,0.395833333333333
0.298,"super middleweight",14,"right-handed",12,4,0,16,0.75
0.296,"super lightweight",NA,"right-handed",5,0,0,5,1
0.295,"middleweight",28,"right-handed",9,10,1,20,0.475
0.294,"lightweight",16,"right-handed",14,22,1,37,0.391891891891892
0.294,"super welterweight",21,"right-handed",7,2,0,9,0.777777777777778
0.293,"lightweight",15,"right-handed",8,0,2,10,0.9
0.293,"welterweight",14,"right-handed",7,17,4,28,0.321428571428571
0.293,"heavyweight",17,"right-handed",14,5,1,20,0.725
0.292,"super welterweight",19,"right-handed",14,2,0,16,0.875
0.291,"super bantamweight",7,"right-handed",7,3,0,10,0.7
0.291,"featherweight",12,"right-handed",14,9,1,24,0.604166666666667
0.291,"featherweight",12,"right-handed",2,3,2,7,0.428571428571429
0.29,"light heavyweight",13,"right-handed",8,0,0,8,1
0.29,"super welterweight",12,"right-handed",3,0,2,5,0.8
0.29,"super flyweight",14,"right-handed",4,2,0,6,0.666666666666667
0.289,"super middleweight",6,"right-handed",3,0,0,3,1
0.289,"super middleweight",10,"right-handed",3,1,0,4,0.75
0.288,"super bantamweight",17,"right-handed",12,19,0,31,0.387096774193548
0.288,"super welterweight",16,"right-handed",6,4,0,10,0.6
0.287,"super middleweight",30,"right-handed",20,38,3,61,0.352459016393443
0.287,"featherweight",19,"right-handed",6,4,1,11,0.590909090909091
0.287,"flyweight",16,"right-handed",3,6,0,9,0.333333333333333
0.286,"super featherweight",17,"right-handed",7,13,0,20,0.35
0.286,"featherweight",13,"right-handed",9,3,0,12,0.75
0.285,"bantamweight",21,"right-handed",13,5,0,18,0.722222222222222
0.285,"bantamweight",16,"right-handed",6,3,1,10,0.65
0.285,"super lightweight",17,"right-handed",8,6,0,14,0.571428571428571
0.285,"super middleweight",19,"right-handed",6,11,0,17,0.352941176470588
0.284,"welterweight",12,"right-handed",4,15,0,19,0.210526315789474
0.284,"super welterweight",18,"right-handed",18,12,0,30,0.6
0.284,"super lightweight",11,"right-handed",8,0,0,8,1
0.283,"flyweight",28,"right-handed",26,21,0,47,0.553191489361702
0.283,"lightweight",10,"right-handed",3,14,3,20,0.225
0.283,"super welterweight",19,"right-handed",20,26,0,46,0.434782608695652
0.282,"bantamweight",10,"right-handed",12,6,2,20,0.65
0.282,"heavyweight",11,"right-handed",12,1,0,13,0.923076923076923
0.281,"middleweight",20,"right-handed",0,0,1,1,0.5
0.281,"lightweight",10,"right-handed",6,13,1,20,0.325
0.281,"cruiserweight",18,"right-handed",9,0,0,9,1
0.279,"super featherweight",17,"right-handed",10,10,0,20,0.5
0.279,"cruiserweight",21,"right-handed",6,5,1,12,0.541666666666667
0.278,"light heavyweight",14,"right-handed",8,1,0,9,0.888888888888889
0.277,"super lightweight",4,"right-handed",5,0,0,5,1
0.277,"bantamweight",12,"right-handed",3,24,0,27,0.111111111111111
0.276,"super middleweight",16,"right-handed",2,1,1,4,0.625
0.276,"light heavyweight",6,"right-handed",7,0,0,7,1
0.275,"super lightweight",5,"right-handed",8,0,0,8,1
0.275,"lightweight",19,"right-handed",10,5,1,16,0.65625
0.275,"heavyweight",25,"right-handed",30,24,1,55,0.554545454545455
0.274,"featherweight",22,"right-handed",4,16,5,25,0.26
0.273,"light heavyweight",21,"right-handed",8,3,1,12,0.708333333333333
0.272,"super welterweight",14,"right-handed",4,0,0,4,1
0.272,"super middleweight",28,"right-handed",15,26,4,45,0.377777777777778
0.271,"super featherweight",19,"right-handed",4,15,0,19,0.210526315789474
0.271,"heavyweight",22,"right-handed",12,23,1,36,0.347222222222222
0.271,"cruiserweight",28,"right-handed",7,32,3,42,0.202380952380952
0.271,"lightweight",6,"right-handed",4,0,0,4,1
0.269,"lightweight",16,"right-handed",4,14,0,18,0.222222222222222
0.269,"middleweight",10,"right-handed",5,0,0,5,1
0.267,"heavyweight",26,"right-handed",19,6,1,26,0.75
0.265,"super lightweight",19,"right-handed",15,12,2,29,0.551724137931034
0.265,"super welterweight",10,"right-handed",3,2,1,6,0.583333333333333
0.265,"super lightweight",18,"right-handed",6,5,2,13,0.538461538461538
0.265,"super featherweight",25,"right-handed",12,16,1,29,0.431034482758621
0.264,"heavyweight",20,"right-handed",5,1,0,6,0.833333333333333
0.263,"super bantamweight",19,"right-handed",4,6,2,12,0.416666666666667
0.263,"heavyweight",NA,"right-handed",5,0,0,5,1
0.262,"welterweight",19,"right-handed",10,14,1,25,0.42
0.262,"super lightweight",8,"right-handed",4,5,2,11,0.454545454545455
0.261,"super lightweight",26,"right-handed",4,2,1,7,0.642857142857143
0.261,"super welterweight",11,"right-handed",6,0,0,6,1
0.261,"lightweight",13,"right-handed",9,2,0,11,0.818181818181818
0.261,"heavyweight",25,"right-handed",10,12,3,25,0.46
0.26,"welterweight",18,"right-handed",12,11,2,25,0.52
0.259,"featherweight",10,"right-handed",9,0,0,9,1
0.259,"super featherweight",11,"right-handed",8,0,0,8,1
0.259,"super middleweight",15,"right-handed",3,4,0,7,0.428571428571429
0.259,"super lightweight",11,"right-handed",10,6,0,16,0.625
0.258,"super bantamweight",11,"right-handed",8,4,0,12,0.666666666666667
0.257,"super featherweight",11,"right-handed",8,6,0,14,0.571428571428571
0.257,"super welterweight",13,"right-handed",4,2,0,6,0.666666666666667
0.257,"bantamweight",15,"right-handed",7,8,0,15,0.466666666666667
0.257,"welterweight",20,"right-handed",7,3,1,11,0.681818181818182
0.256,"featherweight",26,"right-handed",14,26,1,41,0.353658536585366
0.255,"super bantamweight",6,"right-handed",10,3,1,14,0.75
0.255,"welterweight",11,"right-handed",8,2,1,11,0.772727272727273
0.255,"bantamweight",7,"right-handed",7,1,1,9,0.833333333333333
0.254,"super middleweight",17,"right-handed",3,8,0,11,0.272727272727273
0.254,"super welterweight",12,"right-handed",6,3,1,10,0.65
0.253,"middleweight",12,"right-handed",11,0,0,11,1
0.253,"middleweight",22,"right-handed",14,10,1,25,0.58
0.253,"featherweight",17,"right-handed",8,5,1,14,0.607142857142857
0.251,"flyweight",9,"right-handed",5,2,1,8,0.6875
0.25,"super welterweight",10,"right-handed",3,1,0,4,0.75
0.25,"super middleweight",30,"right-handed",18,15,1,34,0.544117647058823
0.25,"super middleweight",26,"right-handed",16,14,1,31,0.532258064516129
0.25,"featherweight",9,"right-handed",17,2,0,19,0.894736842105263
0.249,"super bantamweight",22,"right-handed",13,8,3,24,0.604166666666667
0.248,"light flyweight",17,"right-handed",7,7,2,16,0.5
0.248,"middleweight",10,"right-handed",7,5,1,13,0.576923076923077
0.247,"super featherweight",12,"right-handed",14,13,2,29,0.517241379310345
0.247,"welterweight",9,"right-handed",8,4,1,13,0.653846153846154
0.246,"super lightweight",11,"right-handed",7,0,0,7,1
0.246,"super bantamweight",13,"right-handed",5,1,0,6,0.833333333333333
0.246,"super middleweight",17,"right-handed",7,3,1,11,0.681818181818182
0.246,"heavyweight",7,"right-handed",5,1,0,6,0.833333333333333
0.245,"super middleweight",25,"right-handed",4,6,1,11,0.409090909090909
0.245,"heavyweight",27,"right-handed",12,20,0,32,0.375
0.243,"welterweight",8,"right-handed",9,0,0,9,1
0.243,"super featherweight",18,"right-handed",5,8,1,14,0.392857142857143
0.242,"lightweight",14,"right-handed",11,16,0,27,0.407407407407407
0.24,"welterweight",5,"right-handed",7,0,0,7,1
0.239,"featherweight",27,"right-handed",10,19,0,29,0.344827586206897
0.239,"light heavyweight",12,"right-handed",8,35,6,49,0.224489795918367
0.238,"light heavyweight",NA,"right-handed",8,2,0,10,0.8
0.238,"super middleweight",14,"right-handed",4,0,0,4,1
0.238,"cruiserweight",16,"right-handed",9,2,2,13,0.769230769230769
0.237,"heavyweight",19,"right-handed",2,1,0,3,0.666666666666667
0.237,"welterweight",4,"right-handed",12,0,0,12,1
0.237,"super featherweight",7,"right-handed",8,0,0,8,1
0.236,"super lightweight",21,"right-handed",3,1,3,7,0.642857142857143
0.236,"super featherweight",14,"right-handed",5,10,2,17,0.352941176470588
0.236,"super featherweight",16,"right-handed",13,9,2,24,0.583333333333333
0.235,"welterweight",17,"right-handed",9,25,4,38,0.289473684210526
0.234,"super welterweight",23,"right-handed",18,9,2,29,0.655172413793103
0.234,"cruiserweight",8,"right-handed",4,0,0,4,1
0.234,"super featherweight",24,"right-handed",9,9,1,19,0.5
0.234,"featherweight",15,"right-handed",14,0,0,14,1
0.233,"featherweight",12,"right-handed",4,0,0,4,1
0.233,"heavyweight",10,"right-handed",6,1,1,8,0.8125
0.232,"super lightweight",24,"right-handed",8,4,1,13,0.653846153846154
0.232,"super featherweight",13,"right-handed",11,4,0,15,0.733333333333333
0.232,"cruiserweight",16,"right-handed",11,4,0,15,0.733333333333333
0.232,"cruiserweight",9,"right-handed",9,0,0,9,1
0.231,"super featherweight",20,"right-handed",17,24,2,43,0.418604651162791
0.231,"lightweight",26,"right-handed",31,24,2,57,0.56140350877193
0.23,"flyweight",6,"right-handed",10,1,1,12,0.875
0.23,"featherweight",9,"right-handed",6,5,0,11,0.545454545454545
0.23,"super middleweight",7,"right-handed",9,0,0,9,1
0.23,"middleweight",19,"right-handed",13,20,1,34,0.397058823529412
0.23,"super featherweight",21,"right-handed",2,5,1,8,0.3125
0.229,"super middleweight",20,"right-handed",16,2,0,18,0.888888888888889
0.229,"super lightweight",10,"right-handed",8,13,1,22,0.386363636363636
0.228,"welterweight",13,"right-handed",6,8,0,14,0.428571428571429
0.227,"middleweight",19,"right-handed",4,3,0,7,0.571428571428571
0.225,"welterweight",12,"right-handed",10,1,1,12,0.875
0.225,"super lightweight",5,"right-handed",13,0,0,13,1
0.225,"super flyweight",8,"right-handed",3,2,1,6,0.583333333333333
0.224,"welterweight",13,"right-handed",8,15,6,29,0.379310344827586
0.224,"super welterweight",29,"right-handed",20,12,1,33,0.621212121212121
0.223,"lightweight",12,"right-handed",3,0,1,4,0.875
0.223,"lightweight",17,"right-handed",8,6,2,16,0.5625
0.223,"heavyweight",13,"right-handed",5,2,0,7,0.714285714285714
0.223,"light heavyweight",17,"right-handed",15,11,1,27,0.574074074074074
0.223,"super flyweight",9,"right-handed",13,2,0,15,0.866666666666667
0.22,"welterweight",17,"right-handed",13,24,0,37,0.351351351351351
0.22,"welterweight",20,"right-handed",10,37,5,52,0.240384615384615
0.22,"super welterweight",10,"right-handed",5,0,0,5,1
0.22,"super middleweight",13,"right-handed",3,5,0,8,0.375
0.219,"super flyweight",21,"right-handed",15,22,3,40,0.4125
0.219,"featherweight",9,"right-handed",8,1,2,11,0.818181818181818
0.219,"welterweight",7,"right-handed",18,4,0,22,0.818181818181818
0.218,"featherweight",17,"right-handed",15,12,1,28,0.553571428571429
0.218,"middleweight",5,"right-handed",7,0,0,7,1
0.217,"heavyweight",19,"right-handed",28,13,5,46,0.66304347826087
0.217,"super welterweight",7,"right-handed",3,1,1,5,0.7
0.217,"light heavyweight",NA,"right-handed",4,2,0,6,0.666666666666667
0.217,"welterweight",17,"right-handed",8,5,0,13,0.615384615384615
0.216,"super middleweight",13,"right-handed",13,6,0,19,0.684210526315789
0.216,"middleweight",19,"right-handed",2,2,0,4,0.5
0.215,"heavyweight",25,"right-handed",4,13,0,17,0.235294117647059
0.215,"heavyweight",29,"right-handed",21,20,0,41,0.51219512195122
0.215,"light flyweight",13,"right-handed",18,1,1,20,0.925
0.215,"super lightweight",14,"right-handed",6,14,1,21,0.30952380952381
0.214,"middleweight",26,"right-handed",19,22,0,41,0.463414634146341
0.214,"middleweight",20,"right-handed",11,4,2,17,0.705882352941177
0.212,"super welterweight",17,"right-handed",12,0,1,13,0.961538461538462
0.212,"featherweight",6,"right-handed",5,1,1,7,0.785714285714286
0.211,"light heavyweight",18,"right-handed",18,73,4,95,0.210526315789474
0.211,"super welterweight",7,"right-handed",7,1,0,8,0.875
0.21,"featherweight",12,"right-handed",14,51,3,68,0.227941176470588
0.209,"cruiserweight",12,"right-handed",3,1,0,4,0.75
0.209,"super bantamweight",12,"right-handed",4,6,3,13,0.423076923076923
0.209,"super lightweight",10,"right-handed",17,6,2,25,0.72
0.208,"super middleweight",15,"right-handed",5,2,0,7,0.714285714285714
0.208,"cruiserweight",24,"right-handed",16,6,1,23,0.717391304347826
0.208,"super lightweight",NA,"right-handed",4,1,1,6,0.75
0.208,"super featherweight",15,"right-handed",5,5,2,12,0.5
0.208,"heavyweight",11,"right-handed",5,3,2,10,0.6
0.208,"lightweight",17,"right-handed",10,11,3,24,0.479166666666667
0.207,"flyweight",14,"right-handed",11,22,1,34,0.338235294117647
0.207,"light heavyweight",31,"right-handed",24,10,0,34,0.705882352941177
0.207,"heavyweight",13,"right-handed",8,0,0,8,1
0.207,"welterweight",11,"right-handed",3,0,0,3,1
0.206,"super welterweight",15,"right-handed",4,0,0,4,1
0.206,"minimumweight",7,"right-handed",6,2,1,9,0.722222222222222
0.206,"welterweight",11,"right-handed",6,1,0,7,0.857142857142857
0.205,"light heavyweight",11,"right-handed",2,0,0,2,1
0.205,"super welterweight",13,"right-handed",8,9,0,17,0.470588235294118
0.205,"super middleweight",14,"right-handed",10,7,0,17,0.588235294117647
0.203,"super lightweight",8,"right-handed",8,0,0,8,1
0.203,"super lightweight",15,"right-handed",5,7,1,13,0.423076923076923
0.202,"super lightweight",11,"right-handed",14,1,1,16,0.90625
0.202,"cruiserweight",17,"right-handed",6,2,0,8,0.75
0.202,"super welterweight",14,"right-handed",3,0,0,3,1
0.202,"super welterweight",21,"right-handed",3,9,4,16,0.3125
0.201,"super welterweight",16,"right-handed",9,11,1,21,0.452380952380952
0.201,"super lightweight",26,"right-handed",25,41,3,69,0.384057971014493
0.201,"heavyweight",20,"right-handed",2,2,0,4,0.5
0.2,"bantamweight",NA,"right-handed",6,23,1,30,0.216666666666667
0.2,"super welterweight",21,"right-handed",9,1,0,10,0.9
0.199,"super middleweight",11,"right-handed",9,2,0,11,0.818181818181818
0.199,"lightweight",7,"right-handed",4,5,0,9,0.444444444444444
0.199,"featherweight",20,"right-handed",12,42,5,59,0.245762711864407
0.198,"middleweight",15,"right-handed",4,18,1,23,0.195652173913043
0.198,"super bantamweight",13,"right-handed",11,0,0,11,1
0.198,"super lightweight",17,"right-handed",13,13,1,27,0.5
0.198,"lightweight",11,"right-handed",0,5,0,5,0
0.197,"light flyweight",11,"right-handed",0,4,1,5,0.1
0.197,"super middleweight",15,"right-handed",5,2,0,7,0.714285714285714
0.196,"super flyweight",16,"right-handed",9,12,2,23,0.434782608695652
0.196,"light heavyweight",NA,"right-handed",6,1,0,7,0.857142857142857
0.196,"welterweight",17,"right-handed",8,6,4,18,0.555555555555556
0.195,"middleweight",20,"right-handed",6,8,1,15,0.433333333333333
0.195,"welterweight",14,"right-handed",1,2,1,4,0.375
0.194,"featherweight",28,"right-handed",3,10,2,15,0.266666666666667
0.194,"super welterweight",21,"right-handed",8,9,0,17,0.470588235294118
0.194,"middleweight",23,"right-handed",27,9,1,37,0.743243243243243
0.193,"middleweight",NA,"right-handed",3,4,1,8,0.4375
0.193,"light heavyweight",29,"right-handed",19,85,4,108,0.194444444444444
0.193,"lightweight",11,"right-handed",8,1,1,10,0.85
0.192,"super featherweight",20,"right-handed",4,0,1,5,0.9
0.192,"super welterweight",21,"right-handed",14,3,0,17,0.823529411764706
0.191,"welterweight",26,"right-handed",32,18,2,52,0.634615384615385
0.188,"welterweight",13,"right-handed",6,13,0,19,0.315789473684211
0.188,"super lightweight",18,"right-handed",20,28,2,50,0.42
0.187,"welterweight",16,"right-handed",4,0,0,4,1
0.187,"light heavyweight",7,"right-handed",14,18,1,33,0.439393939393939
0.187,"middleweight",20,"right-handed",23,6,1,30,0.783333333333333
0.186,"lightweight",10,"right-handed",8,1,1,10,0.85
0.186,"featherweight",21,"right-handed",3,9,1,13,0.269230769230769
0.186,"cruiserweight",11,"right-handed",9,0,0,9,1
0.186,"cruiserweight",18,"right-handed",13,2,0,15,0.866666666666667
0.186,"lightweight",23,"right-handed",1,12,0,13,0.0769230769230769
0.186,"heavyweight",26,"right-handed",6,7,1,14,0.464285714285714
0.185,"super lightweight",9,"right-handed",18,8,0,26,0.692307692307692
0.185,"middleweight",17,"right-handed",3,1,0,4,0.75
0.185,"middleweight",8,"right-handed",8,5,0,13,0.615384615384615
0.184,"bantamweight",17,"right-handed",13,6,1,20,0.675
0.183,"super middleweight",10,"right-handed",5,1,1,7,0.785714285714286
0.183,"welterweight",10,"right-handed",4,0,0,4,1
0.183,"lightweight",11,"right-handed",7,5,3,15,0.566666666666667
0.182,"lightweight",15,"right-handed",4,4,0,8,0.5
0.182,"middleweight",NA,"right-handed",4,43,3,50,0.11
0.181,"heavyweight",18,"right-handed",8,13,0,21,0.380952380952381
0.181,"super lightweight",NA,"right-handed",6,3,0,9,0.666666666666667
0.18,"light flyweight",14,"right-handed",5,2,1,8,0.6875
0.179,"super bantamweight",15,"right-handed",4,8,2,14,0.357142857142857
0.179,"lightweight",10,"right-handed",8,0,2,10,0.9
0.179,"middleweight",8,"right-handed",3,4,0,7,0.428571428571429
0.179,"welterweight",18,"right-handed",17,10,2,29,0.620689655172414
0.179,"featherweight",6,"right-handed",2,2,1,5,0.5
0.178,"super bantamweight",NA,"right-handed",5,1,0,6,0.833333333333333
0.178,"middleweight",22,"right-handed",13,0,0,13,1
0.177,"bantamweight",22,"right-handed",8,17,2,27,0.333333333333333
0.176,"welterweight",13,"right-handed",3,1,0,4,0.75
0.176,"super welterweight",19,"right-handed",8,2,0,10,0.8
0.175,"super welterweight",16,"right-handed",7,15,4,26,0.346153846153846
0.175,"flyweight",10,"right-handed",3,3,2,8,0.5
0.175,"featherweight",11,"right-handed",6,0,0,6,1
0.175,"light heavyweight",23,"right-handed",1,0,0,1,1
0.174,"flyweight",16,"right-handed",7,1,1,9,0.833333333333333
0.174,"super lightweight",20,"right-handed",13,11,2,26,0.538461538461538
0.174,"super lightweight",15,"right-handed",16,8,1,25,0.66
0.174,"welterweight",27,"right-handed",3,2,0,5,0.6
0.174,"light flyweight",14,"right-handed",13,16,2,31,0.451612903225806
0.174,"super bantamweight",11,"right-handed",5,7,1,13,0.423076923076923
0.173,"super welterweight",6,"right-handed",2,0,0,2,1
0.173,"bantamweight",18,"right-handed",8,28,1,37,0.22972972972973
0.173,"light heavyweight",10,"right-handed",3,0,0,3,1
0.173,"super middleweight",15,"right-handed",16,6,0,22,0.727272727272727
0.171,"cruiserweight",26,"right-handed",39,19,0,58,0.672413793103448
0.171,"welterweight",17,"right-handed",7,0,0,7,1
0.17,"super welterweight",26,"right-handed",9,15,2,26,0.384615384615385
0.17,"welterweight",6,"right-handed",7,0,0,7,1
0.17,"welterweight",6,"right-handed",14,3,0,17,0.823529411764706
0.17,"super bantamweight",6,"right-handed",18,0,1,19,0.973684210526316
0.169,"heavyweight",21,"right-handed",12,22,2,36,0.361111111111111
0.169,"super featherweight",9,"right-handed",9,0,0,9,1
0.169,"lightweight",29,"right-handed",29,10,1,40,0.7375
0.169,"light heavyweight",20,"right-handed",7,12,0,19,0.368421052631579
0.168,"heavyweight",17,"right-handed",18,23,2,43,0.441860465116279
0.168,"super welterweight",20,"right-handed",4,2,2,8,0.625
0.167,"super bantamweight",17,"right-handed",11,1,0,12,0.916666666666667
0.167,"super welterweight",16,"right-handed",3,14,3,20,0.225
0.167,"super bantamweight",17,"right-handed",18,20,1,39,0.474358974358974
0.167,"super welterweight",19,"right-handed",5,12,3,20,0.325
0.166,"bantamweight",20,"right-handed",7,13,0,20,0.35
0.166,"cruiserweight",29,"right-handed",14,15,0,29,0.482758620689655
0.165,"welterweight",23,"right-handed",5,4,0,9,0.555555555555556
0.164,"cruiserweight",10,"right-handed",4,1,0,5,0.8
0.163,"super middleweight",8,"right-handed",8,0,0,8,1
0.163,"super featherweight",27,"right-handed",8,24,2,34,0.264705882352941
0.163,"lightweight",14,"right-handed",2,12,2,16,0.1875
0.162,"featherweight",14,"right-handed",4,7,2,13,0.384615384615385
0.162,"cruiserweight",29,"right-handed",9,11,1,21,0.452380952380952
0.162,"bantamweight",9,"right-handed",9,8,1,18,0.527777777777778
0.162,"super welterweight",28,"right-handed",7,22,1,30,0.25
0.162,"super middleweight",15,"right-handed",9,0,0,9,1
0.161,"welterweight",21,"right-handed",7,8,1,16,0.46875
0.16,"super featherweight",19,"right-handed",12,38,5,55,0.263636363636364
0.16,"welterweight",18,"right-handed",12,3,0,15,0.8
0.16,"super middleweight",8,"right-handed",10,0,0,10,1
0.159,"flyweight",22,"right-handed",8,16,1,25,0.34
0.159,"bantamweight",NA,"right-handed",2,8,0,10,0.2
0.159,"light heavyweight",24,"right-handed",21,18,1,40,0.5375
0.159,"lightweight",25,"right-handed",5,9,0,14,0.357142857142857
0.159,"super middleweight",13,"right-handed",6,5,0,11,0.545454545454545
0.159,"minimumweight",10,"right-handed",5,1,0,6,0.833333333333333
0.159,"cruiserweight",NA,"right-handed",6,0,0,6,1
0.159,"lightweight",19,"right-handed",1,1,0,2,0.5
0.158,"heavyweight",27,"right-handed",25,47,2,74,0.351351351351351
0.158,"super flyweight",10,"right-handed",6,7,1,14,0.464285714285714
0.158,"super lightweight",10,"right-handed",8,0,2,10,0.9
0.158,"light heavyweight",10,"right-handed",15,18,1,34,0.455882352941176
0.157,"welterweight",14,"right-handed",28,14,0,42,0.666666666666667
0.157,"featherweight",10,"right-handed",11,0,0,11,1
0.157,"light flyweight",14,"right-handed",14,25,4,43,0.372093023255814
0.156,"super welterweight",8,"right-handed",1,2,0,3,0.333333333333333
0.156,"super featherweight",18,"right-handed",9,18,1,28,0.339285714285714
0.156,"lightweight",14,"right-handed",10,5,0,15,0.666666666666667
0.156,"super flyweight",12,"right-handed",6,12,2,20,0.35
0.155,"super welterweight",20,"right-handed",18,15,0,33,0.545454545454545
0.155,"middleweight",16,"right-handed",8,2,1,11,0.772727272727273
0.155,"super welterweight",10,"right-handed",3,0,0,3,1
0.155,"lightweight",16,"right-handed",1,7,0,8,0.125
0.154,"super welterweight",11,"right-handed",6,12,6,24,0.375
0.154,"super bantamweight",14,"right-handed",6,11,0,17,0.352941176470588
0.154,"lightweight",8,"right-handed",9,1,0,10,0.9
0.154,"heavyweight",16,"right-handed",10,0,0,10,1
0.154,"light flyweight",17,"right-handed",8,4,3,15,0.633333333333333
0.153,"middleweight",10,"right-handed",3,0,0,3,1
0.153,"cruiserweight",20,"right-handed",4,10,1,15,0.3
0.153,"super middleweight",15,"right-handed",5,2,0,7,0.714285714285714
0.153,"lightweight",NA,"right-handed",4,0,0,4,1
0.152,"super bantamweight",13,"right-handed",4,2,1,7,0.642857142857143
0.152,"lightweight",18,"right-handed",7,23,1,31,0.241935483870968
0.151,"super welterweight",12,"right-handed",9,1,0,10,0.9
0.151,"welterweight",22,"right-handed",9,15,1,25,0.38
0.151,"lightweight",13,"right-handed",10,1,0,11,0.909090909090909
0.151,"lightweight",15,"right-handed",12,6,1,19,0.657894736842105
0.151,"super lightweight",10,"right-handed",11,0,0,11,1
0.151,"super welterweight",11,"right-handed",7,0,0,7,1
0.149,"welterweight",10,"right-handed",5,1,0,6,0.833333333333333
0.149,"light heavyweight",27,"right-handed",5,17,1,23,0.239130434782609
0.149,"light flyweight",NA,"right-handed",5,34,4,43,0.162790697674419
0.148,"featherweight",20,"right-handed",22,20,2,44,0.522727272727273
0.148,"lightweight",11,"right-handed",7,0,1,8,0.9375
0.148,"super lightweight",8,"right-handed",6,0,0,6,1
0.148,"welterweight",18,"right-handed",7,3,0,10,0.7
0.148,"lightweight",17,"right-handed",3,11,0,14,0.214285714285714
0.148,"featherweight",17,"right-handed",5,6,1,12,0.458333333333333
0.147,"super featherweight",15,"right-handed",3,3,0,6,0.5
0.147,"super welterweight",23,"right-handed",10,0,1,11,0.954545454545455
0.146,"light flyweight",18,"right-handed",5,9,5,19,0.394736842105263
0.146,"super middleweight",16,"right-handed",2,0,0,2,1
0.145,"super lightweight",13,"right-handed",3,20,1,24,0.145833333333333
0.145,"lightweight",15,"right-handed",27,49,1,77,0.357142857142857
0.145,"super welterweight",26,"right-handed",10,40,1,51,0.205882352941176
0.145,"middleweight",41,"right-handed",17,8,0,25,0.68
0.144,"lightweight",9,"right-handed",7,1,0,8,0.875
0.144,"super welterweight",7,"right-handed",9,1,0,10,0.9
0.144,"super bantamweight",3,"right-handed",7,0,0,7,1
0.144,"flyweight",12,"right-handed",6,1,0,7,0.857142857142857
0.144,"featherweight",16,"right-handed",4,32,1,37,0.121621621621622
0.143,"middleweight",13,"right-handed",6,8,1,15,0.433333333333333
0.143,"super lightweight",8,"right-handed",7,3,0,10,0.7
0.143,"welterweight",8,"right-handed",5,0,0,5,1
0.143,"lightweight",15,"right-handed",4,0,0,4,1
0.143,"super flyweight",6,"right-handed",2,0,1,3,0.833333333333333
0.143,"heavyweight",29,"right-handed",29,33,1,63,0.468253968253968
0.142,"featherweight",16,"right-handed",3,2,0,5,0.6
0.142,"super lightweight",12,"right-handed",7,20,0,27,0.259259259259259
0.141,"super lightweight",11,"right-handed",19,6,0,25,0.76
0.141,"heavyweight",21,"right-handed",5,4,0,9,0.555555555555556
0.141,"super welterweight",11,"right-handed",8,1,2,11,0.818181818181818
0.14,"super featherweight",7,"right-handed",8,1,0,9,0.888888888888889
0.14,"lightweight",16,"right-handed",8,1,2,11,0.818181818181818
0.14,"cruiserweight",19,"right-handed",1,0,0,1,1
0.139,"super middleweight",13,"right-handed",6,1,0,7,0.857142857142857
0.139,"heavyweight",19,"right-handed",1,1,0,2,0.5
0.139,"super lightweight",11,"right-handed",11,0,0,11,1
0.139,"heavyweight",21,"right-handed",9,6,1,16,0.59375
0.139,"welterweight",16,"right-handed",6,19,6,31,0.290322580645161
0.138,"lightweight",20,"right-handed",4,31,2,37,0.135135135135135
0.138,"lightweight",10,"right-handed",4,0,0,4,1
0.138,"super welterweight",26,"right-handed",25,13,1,39,0.653846153846154
0.138,"super lightweight",7,"right-handed",1,0,0,1,1
0.138,"super middleweight",20,"right-handed",6,14,2,22,0.318181818181818
0.138,"super lightweight",10,"right-handed",2,1,0,3,0.666666666666667
0.138,"super welterweight",15,"right-handed",4,1,0,5,0.8
0.138,"lightweight",35,"right-handed",13,39,4,56,0.267857142857143
0.137,"heavyweight",26,"right-handed",14,10,3,27,0.574074074074074
0.136,"heavyweight",14,"right-handed",4,13,0,17,0.235294117647059
0.136,"super featherweight",18,"right-handed",11,34,1,46,0.25
0.136,"super lightweight",13,"right-handed",3,6,0,9,0.333333333333333
0.136,"super middleweight",7,"right-handed",4,0,0,4,1
0.136,"lightweight",13,"right-handed",9,5,0,14,0.642857142857143
0.135,"super featherweight",13,"right-handed",5,6,3,14,0.464285714285714
0.135,"super welterweight",21,"right-handed",7,25,0,32,0.21875
0.134,"middleweight",7,"right-handed",16,17,0,33,0.484848484848485
0.134,"heavyweight",14,"right-handed",6,4,2,12,0.583333333333333
0.134,"cruiserweight",16,"right-handed",7,10,1,18,0.416666666666667
0.133,"lightweight",9,"right-handed",7,16,2,25,0.32
0.133,"middleweight",21,"right-handed",3,8,1,12,0.291666666666667
0.133,"bantamweight",9,"right-handed",6,0,0,6,1
0.133,"super bantamweight",14,"right-handed",8,1,1,10,0.85
0.133,"cruiserweight",26,"right-handed",23,0,0,23,1
0.132,"bantamweight",15,"right-handed",12,2,0,14,0.857142857142857
0.132,"welterweight",19,"right-handed",11,33,6,50,0.28
0.132,"super bantamweight",NA,"right-handed",4,0,0,4,1
0.132,"featherweight",20,"right-handed",9,12,7,28,0.446428571428571
0.132,"featherweight",21,"right-handed",27,29,1,57,0.482456140350877
0.132,"super middleweight",13,"right-handed",8,0,0,8,1
0.131,"cruiserweight",11,"right-handed",13,1,1,15,0.9
0.131,"welterweight",14,"right-handed",8,3,0,11,0.727272727272727
0.131,"middleweight",15,"right-handed",3,0,0,3,1
0.129,"cruiserweight",19,"right-handed",6,2,2,10,0.7
0.129,"super flyweight",7,"right-handed",5,1,0,6,0.833333333333333
0.129,"super lightweight",13,"right-handed",4,1,0,5,0.8
0.129,"light heavyweight",20,"right-handed",6,23,4,33,0.242424242424242
0.129,"welterweight",10,"right-handed",2,10,0,12,0.166666666666667
0.129,"super lightweight",20,"right-handed",13,31,3,47,0.308510638297872
0.128,"cruiserweight",10,"right-handed",4,0,0,4,1
0.128,"super welterweight",14,"right-handed",1,0,0,1,1
0.128,"heavyweight",20,"right-handed",6,3,0,9,0.666666666666667
0.128,"lightweight",10,"right-handed",3,0,0,3,1
0.127,"light heavyweight",14,"right-handed",20,6,0,26,0.769230769230769
0.127,"super lightweight",16,"right-handed",9,23,0,32,0.28125
0.127,"middleweight",7,"right-handed",0,2,1,3,0.166666666666667
0.127,"super featherweight",16,"right-handed",7,7,3,17,0.5
0.126,"super welterweight",14,"right-handed",12,15,1,28,0.446428571428571
0.126,"light flyweight",5,"right-handed",5,0,0,5,1
0.126,"light heavyweight",19,"right-handed",9,1,2,12,0.833333333333333
0.126,"cruiserweight",16,"right-handed",6,2,2,10,0.7
0.125,"welterweight",13,"right-handed",6,6,0,12,0.5
0.125,"lightweight",NA,"right-handed",6,5,2,13,0.538461538461538
0.125,"bantamweight",15,"right-handed",3,17,2,22,0.181818181818182
0.125,"super lightweight",10,"right-handed",11,1,1,13,0.884615384615385
0.124,"heavyweight",27,"right-handed",10,3,0,13,0.769230769230769
0.124,"super lightweight",22,"right-handed",7,6,1,14,0.535714285714286
0.124,"super lightweight",23,"right-handed",11,13,0,24,0.458333333333333
0.124,"welterweight",12,"right-handed",4,0,0,4,1
0.124,"super bantamweight",16,"right-handed",8,9,1,18,0.472222222222222
0.123,"cruiserweight",16,"right-handed",20,7,0,27,0.740740740740741
0.123,"cruiserweight",16,"right-handed",6,7,1,14,0.464285714285714
0.123,"super lightweight",5,"right-handed",3,1,0,4,0.75
0.123,"welterweight",11,"right-handed",2,4,0,6,0.333333333333333
0.123,"heavyweight",25,"right-handed",17,3,2,22,0.818181818181818
0.123,"super welterweight",22,"right-handed",11,13,1,25,0.46
0.123,"bantamweight",9,"right-handed",5,1,0,6,0.833333333333333
0.122,"super featherweight",5,"right-handed",2,3,1,6,0.416666666666667
0.122,"super flyweight",7,"right-handed",15,6,1,22,0.704545454545455
0.122,"welterweight",9,"right-handed",7,0,1,8,0.9375
0.122,"flyweight",9,"right-handed",12,1,2,15,0.866666666666667
0.122,"welterweight",21,"right-handed",28,18,1,47,0.606382978723404
0.122,"middleweight",NA,"right-handed",2,14,1,17,0.147058823529412
0.122,"light flyweight",19,"right-handed",25,23,1,49,0.520408163265306
0.121,"super flyweight",15,"right-handed",18,13,0,31,0.580645161290323
0.121,"bantamweight",13,"right-handed",10,4,4,18,0.666666666666667
0.121,"heavyweight",25,"right-handed",13,2,0,15,0.866666666666667
0.121,"light heavyweight",17,"right-handed",16,39,3,58,0.301724137931034
0.12,"bantamweight",16,"right-handed",8,1,0,9,0.888888888888889
0.12,"light heavyweight",21,"right-handed",9,3,0,12,0.75
0.12,"light heavyweight",13,"right-handed",10,15,5,30,0.416666666666667
0.119,"super welterweight",12,"right-handed",3,0,0,3,1
0.119,"super middleweight",11,"right-handed",9,7,1,17,0.558823529411765
0.119,"super welterweight",17,"right-handed",1,2,2,5,0.4
0.119,"lightweight",15,"right-handed",5,1,1,7,0.785714285714286
0.119,"super bantamweight",12,"right-handed",5,10,0,15,0.333333333333333
0.119,"super bantamweight",18,"right-handed",5,7,2,14,0.428571428571429
0.119,"lightweight",13,"right-handed",6,7,0,13,0.461538461538462
0.119,"bantamweight",14,"right-handed",5,2,1,8,0.6875
0.117,"super featherweight",24,"right-handed",8,4,0,12,0.666666666666667
0.117,"super lightweight",16,"right-handed",8,1,1,10,0.85
0.117,"super featherweight",12,"right-handed",3,2,1,6,0.583333333333333
0.117,"featherweight",10,"right-handed",6,5,0,11,0.545454545454545
0.117,"featherweight",NA,"right-handed",3,2,0,5,0.6
0.117,"featherweight",19,"right-handed",12,6,0,18,0.666666666666667
0.117,"welterweight",10,"right-handed",4,0,0,4,1
0.117,"super welterweight",10,"right-handed",6,0,0,6,1
0.117,"cruiserweight",23,"right-handed",11,5,0,16,0.6875
0.117,"heavyweight",28,"right-handed",25,1,0,26,0.961538461538462
0.117,"super featherweight",13,"right-handed",12,5,0,17,0.705882352941177
0.117,"super middleweight",11,"right-handed",3,0,0,3,1
0.116,"light heavyweight",NA,"right-handed",5,1,0,6,0.833333333333333
0.116,"super middleweight",15,"right-handed",38,25,0,63,0.603174603174603
0.116,"featherweight",7,"right-handed",2,0,1,3,0.833333333333333
0.116,"super welterweight",14,"right-handed",3,0,0,3,1
0.115,"super lightweight",15,"right-handed",3,11,1,15,0.233333333333333
0.115,"super bantamweight",8,"right-handed",6,0,1,7,0.928571428571429
0.115,"featherweight",17,"right-handed",10,1,0,11,0.909090909090909
0.114,"light heavyweight",21,"right-handed",18,39,1,58,0.318965517241379
0.114,"super lightweight",8,"right-handed",9,0,0,9,1
0.114,"super lightweight",14,"right-handed",4,22,1,27,0.166666666666667
0.114,"welterweight",8,"right-handed",4,0,0,4,1
0.114,"bantamweight",10,"right-handed",6,2,1,9,0.722222222222222
0.114,"light heavyweight",5,"right-handed",3,1,0,4,0.75
0.114,"super welterweight",15,"right-handed",6,1,1,8,0.8125
0.113,"middleweight",11,"right-handed",3,0,0,3,1
0.113,"lightweight",12,"right-handed",5,10,0,15,0.333333333333333
0.113,"super welterweight",16,"right-handed",4,15,5,24,0.270833333333333
0.113,"light heavyweight",12,"right-handed",27,16,0,43,0.627906976744186
0.113,"bantamweight",19,"right-handed",14,29,6,49,0.346938775510204
0.113,"super middleweight",20,"right-handed",5,0,0,5,1
0.112,"lightweight",19,"right-handed",23,32,3,58,0.422413793103448
0.112,"super lightweight",8,"right-handed",5,6,0,11,0.454545454545455
0.112,"super welterweight",14,"right-handed",7,4,0,11,0.636363636363636
0.111,"super welterweight",12,"right-handed",4,0,0,4,1
0.111,"welterweight",6,"right-handed",8,0,0,8,1
0.111,"light heavyweight",21,"right-handed",7,25,2,34,0.235294117647059
0.111,"super welterweight",11,"right-handed",4,0,0,4,1
0.111,"super welterweight",18,"right-handed",24,3,0,27,0.888888888888889
0.111,"middleweight",16,"right-handed",5,26,2,33,0.181818181818182
0.111,"super welterweight",13,"right-handed",7,1,0,8,0.875
0.11,"featherweight",10,"right-handed",1,4,0,5,0.2
0.11,"super middleweight",13,"right-handed",7,4,1,12,0.625
0.109,"super lightweight",10,"right-handed",4,1,2,7,0.714285714285714
0.109,"welterweight",10,"right-handed",4,9,3,16,0.34375
0.109,"super bantamweight",14,"right-handed",12,6,0,18,0.666666666666667
0.109,"super welterweight",10,"right-handed",8,0,0,8,1
0.109,"heavyweight",27,"right-handed",14,13,1,28,0.517857142857143
0.109,"welterweight",8,"right-handed",19,18,1,38,0.513157894736842
0.109,"welterweight",9,"right-handed",6,0,0,6,1
0.109,"welterweight",7,"right-handed",4,8,2,14,0.357142857142857
0.108,"lightweight",25,"right-handed",14,20,3,37,0.418918918918919
0.108,"super middleweight",8,"right-handed",6,2,1,9,0.722222222222222
0.108,"welterweight",11,"right-handed",6,1,1,8,0.8125
0.107,"flyweight",11,"right-handed",6,4,0,10,0.6
0.107,"super lightweight",7,"right-handed",7,0,0,7,1
0.107,"heavyweight",24,"right-handed",3,1,1,5,0.7
0.107,"heavyweight",16,"right-handed",2,7,0,9,0.222222222222222
0.107,"super flyweight",6,"right-handed",4,0,0,4,1
0.107,"super featherweight",11,"right-handed",13,18,1,32,0.421875
0.107,"super welterweight",8,"right-handed",4,1,0,5,0.8
0.107,"super lightweight",20,"right-handed",1,5,4,10,0.3
0.106,"welterweight",21,"right-handed",7,4,0,11,0.636363636363636
0.106,"middleweight",22,"right-handed",19,13,1,33,0.590909090909091
0.106,"welterweight",5,"right-handed",2,7,2,11,0.272727272727273
0.106,"super flyweight",12,"right-handed",5,3,1,9,0.611111111111111
0.105,"flyweight",7,"right-handed",13,2,0,15,0.866666666666667
0.105,"super featherweight",17,"right-handed",4,29,0,33,0.121212121212121
0.105,"cruiserweight",21,"right-handed",17,0,0,17,1
0.104,"featherweight",5,"right-handed",13,0,0,13,1
0.104,"light heavyweight",12,"right-handed",3,2,0,5,0.6
0.104,"super lightweight",9,"right-handed",9,0,0,9,1
0.104,"light heavyweight",8,"right-handed",3,0,0,3,1
0.104,"super featherweight",12,"right-handed",8,4,0,12,0.666666666666667
0.103,"super welterweight",23,"right-handed",18,7,0,25,0.72
0.103,"light heavyweight",20,"right-handed",8,35,3,46,0.206521739130435
0.103,"lightweight",9,"right-handed",11,1,0,12,0.916666666666667
0.103,"cruiserweight",21,"right-handed",9,7,0,16,0.5625
0.103,"welterweight",12,"right-handed",2,10,0,12,0.166666666666667
0.103,"featherweight",21,"right-handed",4,2,0,6,0.666666666666667
0.103,"welterweight",21,"right-handed",5,3,0,8,0.625
0.102,"featherweight",7,"right-handed",7,0,0,7,1
0.102,"super bantamweight",7,"right-handed",4,2,1,7,0.642857142857143
0.102,"welterweight",23,"right-handed",5,12,1,18,0.305555555555556
0.102,"super flyweight",22,"right-handed",8,14,0,22,0.363636363636364
0.102,"middleweight",NA,"right-handed",2,0,0,2,1
0.102,"welterweight",11,"right-handed",4,3,1,8,0.5625
0.102,"bantamweight",4,"right-handed",6,2,1,9,0.722222222222222
0.101,"heavyweight",13,"right-handed",3,4,0,7,0.428571428571429
0.101,"super welterweight",9,"right-handed",4,0,0,4,1
0.101,"welterweight",11,"right-handed",5,1,0,6,0.833333333333333
0.101,"flyweight",22,"right-handed",0,17,2,19,0.0526315789473684
0.101,"super middleweight",14,"right-handed",10,1,0,11,0.909090909090909
0.101,"heavyweight",28,"right-handed",16,23,0,39,0.41025641025641
0.101,"welterweight",16,"right-handed",7,4,0,11,0.636363636363636
0.101,"lightweight",9,"right-handed",3,0,0,3,1
0.101,"lightweight",9,"right-handed",4,1,0,5,0.8
0.101,"super welterweight",7,"right-handed",7,1,1,9,0.833333333333333
0.101,"super bantamweight",7,"right-handed",7,1,0,8,0.875
0.1,"welterweight",14,"right-handed",4,2,0,6,0.666666666666667
0.1,"cruiserweight",19,"right-handed",3,7,1,11,0.318181818181818
0.1,"welterweight",14,"right-handed",12,10,1,23,0.543478260869565
0.1,"super featherweight",16,"right-handed",7,1,0,8,0.875
0.1,"bantamweight",4,"right-handed",5,2,0,7,0.714285714285714
0.1,"light heavyweight",8,"right-handed",2,0,0,2,1
0.1,"super lightweight",11,"right-handed",6,0,0,6,1
0.1,"lightweight",12,"right-handed",4,1,0,5,0.8
0.099,"welterweight",9,"right-handed",5,0,0,5,1
0.099,"lightweight",7,"right-handed",5,0,0,5,1
0.099,"super welterweight",17,"right-handed",20,39,2,61,0.344262295081967
0.098,"super featherweight",12,"right-handed",5,3,0,8,0.625
0.098,"bantamweight",16,"right-handed",3,6,2,11,0.363636363636364
0.098,"middleweight",13,"right-handed",9,1,0,10,0.9
0.098,"super featherweight",NA,"right-handed",4,7,0,11,0.363636363636364
0.098,"heavyweight",20,"right-handed",6,6,3,15,0.5
0.097,"lightweight",15,"right-handed",10,0,1,11,0.954545454545455
0.097,"super featherweight",16,"right-handed",8,4,1,13,0.653846153846154
0.097,"lightweight",18,"right-handed",7,41,5,53,0.179245283018868
0.097,"heavyweight",26,"right-handed",29,18,2,49,0.612244897959184
0.097,"super featherweight",13,"right-handed",5,0,0,5,1
0.096,"middleweight",6,"right-handed",4,1,0,5,0.8
0.096,"super lightweight",10,"right-handed",7,0,0,7,1
0.096,"super lightweight",10,"right-handed",4,4,1,9,0.5
0.096,"super featherweight",NA,"right-handed",2,1,0,3,0.666666666666667
0.096,"welterweight",14,"right-handed",2,0,0,2,1
0.096,"flyweight",NA,"right-handed",3,1,0,4,0.75
0.096,"cruiserweight",15,"right-handed",8,4,0,12,0.666666666666667
0.096,"welterweight",13,"right-handed",7,23,2,32,0.25
0.095,"super welterweight",16,"right-handed",5,17,0,22,0.227272727272727
0.095,"flyweight",16,"right-handed",10,1,1,12,0.875
0.095,"lightweight",5,"right-handed",14,0,0,14,1
0.095,"cruiserweight",10,"right-handed",3,0,0,3,1
0.095,"super welterweight",12,"right-handed",6,23,1,30,0.216666666666667
0.094,"featherweight",17,"right-handed",13,7,0,20,0.65
0.094,"super middleweight",20,"right-handed",8,18,0,26,0.307692307692308
0.094,"lightweight",9,"right-handed",10,1,1,12,0.875
0.094,"super lightweight",20,"right-handed",16,1,0,17,0.941176470588235
0.094,"super featherweight",6,"right-handed",5,0,0,5,1
0.094,"super lightweight",21,"right-handed",7,2,1,10,0.75
0.094,"heavyweight",14,"right-handed",6,0,0,6,1
0.093,"welterweight",23,"right-handed",5,0,0,5,1
0.093,"welterweight",8,"right-handed",7,0,0,7,1
0.093,"welterweight",18,"right-handed",5,7,1,13,0.423076923076923
0.093,"super welterweight",14,"right-handed",12,13,5,30,0.483333333333333
0.092,"light heavyweight",26,"right-handed",3,6,2,11,0.363636363636364
0.092,"super welterweight",10,"right-handed",5,0,1,6,0.916666666666667
0.092,"super flyweight",8,"right-handed",4,0,0,4,1
0.092,"lightweight",22,"right-handed",4,14,2,20,0.25
0.092,"middleweight",7,"right-handed",12,0,1,13,0.961538461538462
0.091,"light heavyweight",10,"right-handed",11,0,0,11,1
0.091,"welterweight",16,"right-handed",13,15,0,28,0.464285714285714
0.091,"super lightweight",20,"right-handed",12,19,1,32,0.390625
0.09,"middleweight",12,"right-handed",11,0,0,11,1
0.09,"super featherweight",18,"right-handed",8,17,0,25,0.32
0.09,"middleweight",13,"right-handed",4,0,0,4,1
0.09,"super flyweight",13,"right-handed",6,3,0,9,0.666666666666667
0.09,"cruiserweight",11,"right-handed",6,9,3,18,0.416666666666667
0.09,"super middleweight",14,"right-handed",3,3,1,7,0.5
0.09,"middleweight",5,"right-handed",7,9,2,18,0.444444444444444
0.09,"super welterweight",7,"right-handed",3,0,0,3,1
0.09,"light flyweight",9,"right-handed",8,3,2,13,0.692307692307692
0.09,"light heavyweight",10,"right-handed",7,3,1,11,0.681818181818182
0.089,"welterweight",13,"right-handed",8,5,0,13,0.615384615384615
0.089,"welterweight",22,"right-handed",5,8,1,14,0.392857142857143
0.089,"super middleweight",14,"right-handed",4,7,1,12,0.375
0.089,"light heavyweight",15,"right-handed",7,3,1,11,0.681818181818182
0.089,"cruiserweight",22,"right-handed",6,6,0,12,0.5
0.089,"super featherweight",7,"right-handed",3,3,3,9,0.5
0.089,"super welterweight",14,"right-handed",4,7,4,15,0.4
0.088,"cruiserweight",9,"right-handed",4,0,0,4,1
0.088,"cruiserweight",NA,"right-handed",4,0,0,4,1
0.088,"minimumweight",8,"right-handed",3,0,1,4,0.875
0.088,"super middleweight",11,"right-handed",2,1,0,3,0.666666666666667
0.088,"super lightweight",13,"right-handed",4,6,1,11,0.409090909090909
0.088,"super bantamweight",14,"right-handed",9,6,1,16,0.59375
0.087,"light heavyweight",13,"right-handed",1,1,1,3,0.5
0.087,"middleweight",14,"right-handed",6,0,0,6,1
0.087,"welterweight",10,"right-handed",4,1,1,6,0.75
0.086,"super lightweight",13,"right-handed",8,14,2,24,0.375
0.086,"featherweight",10,"right-handed",11,2,1,14,0.821428571428571
0.086,"middleweight",14,"right-handed",14,43,0,57,0.245614035087719
0.086,"heavyweight",12,"right-handed",10,28,0,38,0.263157894736842
0.086,"featherweight",15,"right-handed",5,3,2,10,0.6
0.086,"cruiserweight",13,"right-handed",6,3,1,10,0.65
0.085,"middleweight",22,"right-handed",12,46,1,59,0.211864406779661
0.085,"welterweight",8,"right-handed",3,4,0,7,0.428571428571429
0.085,"super welterweight",13,"right-handed",3,7,3,13,0.346153846153846
0.085,"heavyweight",13,"right-handed",4,3,1,8,0.5625
0.085,"super featherweight",9,"right-handed",6,0,0,6,1
0.085,"lightweight",10,"right-handed",5,2,2,9,0.666666666666667
0.085,"super middleweight",21,"right-handed",5,4,0,9,0.555555555555556
0.085,"featherweight",10,"right-handed",7,1,0,8,0.875
0.085,"super middleweight",14,"right-handed",18,1,2,21,0.904761904761905
0.085,"super middleweight",12,"right-handed",6,2,0,8,0.75
0.084,"super welterweight",5,"right-handed",5,1,0,6,0.833333333333333
0.084,"super featherweight",11,"right-handed",3,6,2,11,0.363636363636364
0.084,"super lightweight",9,"right-handed",3,3,0,6,0.5
0.084,"featherweight",7,"right-handed",10,1,0,11,0.909090909090909
0.084,"light heavyweight",12,"right-handed",3,1,0,4,0.75
0.084,"featherweight",18,"right-handed",31,16,0,47,0.659574468085106
0.083,"lightweight",5,"right-handed",1,1,0,2,0.5
0.083,"welterweight",10,"right-handed",5,33,4,42,0.166666666666667
0.083,"welterweight",13,"right-handed",23,28,3,54,0.453703703703704
0.083,"welterweight",NA,"right-handed",4,5,1,10,0.45
0.083,"light heavyweight",19,"right-handed",8,13,0,21,0.380952380952381
0.083,"bantamweight",13,"right-handed",6,27,3,36,0.208333333333333
0.083,"super bantamweight",19,"right-handed",7,11,2,20,0.4
0.083,"welterweight",NA,"right-handed",8,7,1,16,0.53125
0.083,"welterweight",20,"right-handed",24,11,0,35,0.685714285714286
0.083,"light heavyweight",10,"right-handed",3,0,0,3,1
0.083,"super flyweight",17,"right-handed",6,14,1,21,0.30952380952381
0.082,"welterweight",15,"right-handed",4,0,1,5,0.9
0.082,"cruiserweight",14,"right-handed",18,15,0,33,0.545454545454545
0.082,"light heavyweight",15,"right-handed",4,6,0,10,0.4
0.082,"super lightweight",13,"right-handed",6,4,0,10,0.6
0.082,"lightweight",12,"right-handed",7,0,0,7,1
0.082,"super welterweight",9,"right-handed",4,0,0,4,1
0.081,"super bantamweight",11,"right-handed",1,1,0,2,0.5
0.081,"lightweight",12,"right-handed",4,0,0,4,1
0.081,"super welterweight",13,"right-handed",9,1,0,10,0.9
0.081,"super welterweight",14,"right-handed",9,2,0,11,0.818181818181818
0.081,"super lightweight",8,"right-handed",6,0,0,6,1
0.081,"featherweight",8,"right-handed",6,0,0,6,1
0.081,"flyweight",9,"right-handed",7,9,0,16,0.4375
0.08,"featherweight",NA,"right-handed",6,2,0,8,0.75
0.08,"welterweight",12,"right-handed",7,3,1,11,0.681818181818182
0.08,"lightweight",21,"right-handed",25,21,2,48,0.541666666666667
0.08,"super welterweight",16,"right-handed",4,0,0,4,1
0.08,"lightweight",14,"right-handed",5,13,2,20,0.3
0.08,"heavyweight",19,"right-handed",6,5,0,11,0.545454545454545
0.08,"heavyweight",28,"right-handed",5,7,0,12,0.416666666666667
0.08,"super featherweight",6,"right-handed",4,0,1,5,0.9
0.08,"super middleweight",16,"right-handed",6,25,0,31,0.193548387096774
0.08,"flyweight",8,"right-handed",3,3,0,6,0.5
0.08,"welterweight",15,"right-handed",4,3,0,7,0.571428571428571
0.079,"middleweight",8,"right-handed",1,2,1,4,0.375
0.079,"middleweight",12,"right-handed",4,0,1,5,0.9
0.079,"super featherweight",7,"right-handed",9,0,0,9,1
0.079,"super featherweight",10,"right-handed",10,2,0,12,0.833333333333333
0.079,"middleweight",17,"right-handed",5,0,0,5,1
0.079,"super lightweight",14,"right-handed",1,6,1,8,0.1875
0.079,"super bantamweight",6,"right-handed",1,2,0,3,0.333333333333333
0.079,"super middleweight",19,"right-handed",12,6,1,19,0.657894736842105
0.079,"super middleweight",8,"right-handed",2,0,0,2,1
0.079,"super flyweight",18,"right-handed",16,22,1,39,0.423076923076923
0.079,"cruiserweight",21,"right-handed",7,2,0,9,0.777777777777778
0.079,"featherweight",5,"right-handed",2,1,0,3,0.666666666666667
0.078,"featherweight",6,"right-handed",2,2,0,4,0.5
0.078,"lightweight",19,"right-handed",6,19,7,32,0.296875
0.078,"super flyweight",10,"right-handed",2,0,0,2,1
0.078,"cruiserweight",25,"right-handed",8,18,0,26,0.307692307692308
0.078,"super lightweight",16,"right-handed",7,14,0,21,0.333333333333333
0.078,"featherweight",12,"right-handed",6,0,0,6,1
0.077,"lightweight",11,"right-handed",2,0,0,2,1
0.077,"lightweight",13,"right-handed",4,1,1,6,0.75
0.077,"middleweight",9,"right-handed",5,0,0,5,1
0.077,"lightweight",16,"right-handed",3,6,1,10,0.35
0.077,"super featherweight",11,"right-handed",5,1,0,6,0.833333333333333
0.077,"super bantamweight",10,"right-handed",0,5,0,5,0
0.076,"welterweight",5,"right-handed",5,0,1,6,0.916666666666667
0.076,"cruiserweight",11,"right-handed",11,10,0,21,0.523809523809524
0.076,"flyweight",7,"right-handed",4,0,0,4,1
0.076,"super featherweight",7,"right-handed",2,0,0,2,1
0.076,"lightweight",NA,"right-handed",7,0,0,7,1
0.076,"welterweight",13,"right-handed",10,25,3,38,0.302631578947368
0.076,"middleweight",16,"right-handed",8,0,0,8,1
0.076,"featherweight",11,"right-handed",7,10,1,18,0.416666666666667
0.076,"lightweight",26,"right-handed",32,29,6,67,0.522388059701492
0.076,"super welterweight",17,"right-handed",8,2,3,13,0.730769230769231
0.076,"lightweight",5,"right-handed",11,2,1,14,0.821428571428571
0.076,"light heavyweight",9,"right-handed",2,2,0,4,0.5
0.076,"lightweight",15,"right-handed",4,0,0,4,1
0.076,"super welterweight",11,"right-handed",4,0,0,4,1
0.075,"middleweight",15,"right-handed",3,4,0,7,0.428571428571429
0.075,"super welterweight",14,"right-handed",1,0,0,1,1
0.075,"super welterweight",17,"right-handed",7,5,0,12,0.583333333333333
0.075,"super lightweight",NA,"right-handed",3,1,0,4,0.75
0.075,"super middleweight",15,"right-handed",12,0,0,12,1
0.075,"welterweight",10,"right-handed",8,0,0,8,1
0.075,"super middleweight",NA,"right-handed",2,39,0,41,0.0487804878048781
0.075,"super welterweight",18,"right-handed",2,2,0,4,0.5
0.075,"welterweight",13,"right-handed",10,16,2,28,0.392857142857143
0.075,"super bantamweight",8,"right-handed",3,13,1,17,0.205882352941176
0.075,"light flyweight",17,"right-handed",11,17,1,29,0.396551724137931
0.075,"super middleweight",7,"right-handed",5,0,0,5,1
0.075,"super lightweight",14,"right-handed",7,10,1,18,0.416666666666667
0.075,"heavyweight",21,"right-handed",16,11,1,28,0.589285714285714
0.075,"light heavyweight",7,"right-handed",4,0,0,4,1
0.075,"super bantamweight",14,"right-handed",9,1,0,10,0.9
0.075,"welterweight",20,"right-handed",4,3,1,8,0.5625
0.075,"super lightweight",14,"right-handed",1,0,0,1,1
0.075,"super lightweight",8,"right-handed",3,3,0,6,0.5
0.074,"middleweight",13,"right-handed",8,6,1,15,0.566666666666667
0.074,"super middleweight",14,"right-handed",4,0,0,4,1
0.074,"super bantamweight",13,"right-handed",3,1,0,4,0.75
0.074,"super welterweight",8,"right-handed",10,0,0,10,1
0.074,"heavyweight",28,"right-handed",11,9,1,21,0.547619047619048
0.074,"light heavyweight",9,"right-handed",8,0,0,8,1
0.073,"super welterweight",14,"right-handed",6,0,0,6,1
0.073,"cruiserweight",10,"right-handed",3,23,5,31,0.17741935483871
0.073,"light heavyweight",16,"right-handed",11,8,2,21,0.571428571428571
0.073,"super middleweight",19,"right-handed",4,0,0,4,1
0.073,"super welterweight",14,"right-handed",6,4,0,10,0.6
0.073,"super lightweight",8,"right-handed",3,0,0,3,1
0.073,"heavyweight",25,"right-handed",6,4,0,10,0.6
0.073,"super featherweight",14,"right-handed",13,0,0,13,1
0.073,"cruiserweight",21,"right-handed",11,0,0,11,1
0.073,"super middleweight",9,"right-handed",6,2,1,9,0.722222222222222
0.073,"super lightweight",9,"right-handed",5,3,0,8,0.625
0.072,"middleweight",27,"right-handed",11,4,1,16,0.71875
0.072,"heavyweight",14,"right-handed",2,0,0,2,1
0.072,"welterweight",8,"right-handed",5,16,1,22,0.25
0.072,"light flyweight",11,"right-handed",6,6,0,12,0.5
0.072,"flyweight",8,"right-handed",3,2,2,7,0.571428571428571
0.072,"super lightweight",14,"right-handed",6,5,3,14,0.535714285714286
0.072,"super welterweight",15,"right-handed",6,2,1,9,0.722222222222222
0.072,"super welterweight",16,"right-handed",2,2,0,4,0.5
0.072,"middleweight",21,"right-handed",7,9,2,18,0.444444444444444
0.072,"super lightweight",11,"right-handed",8,23,1,32,0.265625
0.071,"flyweight",7,"right-handed",4,2,1,7,0.642857142857143
0.071,"flyweight",7,"right-handed",4,2,1,7,0.642857142857143
0.071,"middleweight",19,"right-handed",4,7,0,11,0.363636363636364
0.071,"heavyweight",20,"right-handed",3,0,0,3,1
0.071,"super welterweight",25,"right-handed",14,7,1,22,0.659090909090909
0.071,"light flyweight",NA,"right-handed",4,0,0,4,1
0.071,"super welterweight",31,"right-handed",10,52,3,65,0.176923076923077
0.07,"super featherweight",10,"right-handed",4,0,1,5,0.9
0.07,"super middleweight",28,"right-handed",5,39,0,44,0.113636363636364
0.07,"heavyweight",15,"right-handed",8,2,0,10,0.8
0.07,"super lightweight",13,"right-handed",7,11,1,19,0.394736842105263
0.07,"super lightweight",7,"right-handed",5,0,0,5,1
0.07,"featherweight",8,"right-handed",3,0,1,4,0.875
0.07,"light heavyweight",14,"right-handed",1,0,0,1,1
0.07,"super lightweight",6,"right-handed",6,0,0,6,1
0.07,"bantamweight",11,"right-handed",9,4,0,13,0.692307692307692
0.069,"super lightweight",10,"right-handed",3,0,1,4,0.875
0.069,"middleweight",17,"right-handed",2,0,0,2,1
0.069,"super lightweight",19,"right-handed",13,1,1,15,0.9
0.069,"welterweight",12,"right-handed",6,0,0,6,1
0.069,"welterweight",13,"right-handed",22,2,0,24,0.916666666666667
0.069,"super welterweight",11,"right-handed",2,2,0,4,0.5
0.069,"featherweight",4,"right-handed",2,1,0,3,0.666666666666667
0.069,"lightweight",11,"right-handed",2,3,0,5,0.4
0.069,"heavyweight",6,"right-handed",2,1,0,3,0.666666666666667
0.069,"lightweight",4,"right-handed",8,4,0,12,0.666666666666667
0.069,"heavyweight",32,"right-handed",7,44,3,54,0.157407407407407
0.069,"super middleweight",10,"right-handed",12,3,0,15,0.8
0.069,"featherweight",13,"right-handed",12,3,0,15,0.8
0.069,"cruiserweight",12,"right-handed",5,0,0,5,1
0.068,"featherweight",18,"right-handed",4,3,0,7,0.571428571428571
0.068,"flyweight",8,"right-handed",6,1,1,8,0.8125
0.068,"super middleweight",12,"right-handed",8,0,0,8,1
0.068,"light heavyweight",23,"right-handed",23,29,3,55,0.445454545454545
0.068,"welterweight",22,"right-handed",4,1,0,5,0.8
0.068,"lightweight",15,"right-handed",4,7,3,14,0.392857142857143
0.068,"super lightweight",15,"right-handed",4,0,0,4,1
0.068,"super middleweight",16,"right-handed",6,0,0,6,1
0.068,"super lightweight",19,"right-handed",6,0,0,6,1
0.067,"super welterweight",13,"right-handed",5,3,1,9,0.611111111111111
0.067,"super lightweight",17,"right-handed",6,0,0,6,1
0.067,"cruiserweight",13,"right-handed",5,1,0,6,0.833333333333333
0.067,"super flyweight",13,"right-handed",4,2,1,7,0.642857142857143
0.067,"welterweight",14,"right-handed",10,6,0,16,0.625
0.067,"super lightweight",21,"right-handed",14,26,1,41,0.353658536585366
0.067,"heavyweight",28,"right-handed",0,0,1,1,0.5
0.067,"super bantamweight",13,"right-handed",1,3,1,5,0.3
0.067,"welterweight",11,"right-handed",8,3,1,12,0.708333333333333
0.067,"super lightweight",17,"right-handed",11,5,0,16,0.6875
0.067,"welterweight",NA,"right-handed",7,0,1,8,0.9375
0.067,"super middleweight",16,"right-handed",5,8,1,14,0.392857142857143
0.067,"super bantamweight",10,"right-handed",6,1,0,7,0.857142857142857
0.067,"super featherweight",8,"right-handed",7,0,0,7,1
0.067,"flyweight",9,"right-handed",9,0,0,9,1
0.067,"flyweight",16,"right-handed",6,2,1,9,0.722222222222222
0.067,"super middleweight",NA,"right-handed",1,7,1,9,0.166666666666667
0.067,"super lightweight",20,"right-handed",7,8,2,17,0.470588235294118
0.066,"welterweight",10,"right-handed",2,3,1,6,0.416666666666667
0.066,"bantamweight",7,"right-handed",3,3,0,6,0.5
0.066,"super welterweight",9,"right-handed",3,1,0,4,0.75
0.066,"super welterweight",9,"right-handed",1,0,0,1,1
0.066,"super bantamweight",20,"right-handed",14,10,1,25,0.58
0.066,"super middleweight",14,"right-handed",5,0,0,5,1
0.066,"cruiserweight",27,"right-handed",13,34,0,47,0.276595744680851
0.066,"cruiserweight",14,"right-handed",3,0,0,3,1
0.066,"super bantamweight",11,"right-handed",9,0,3,12,0.875
0.066,"super lightweight",17,"right-handed",7,7,1,15,0.5
0.066,"super welterweight",15,"right-handed",12,9,1,22,0.568181818181818
0.066,"middleweight",9,"right-handed",4,3,0,7,0.571428571428571
0.066,"lightweight",13,"right-handed",2,4,0,6,0.333333333333333
0.066,"middleweight",9,"right-handed",3,0,0,3,1
0.066,"lightweight",5,"right-handed",1,0,0,1,1
0.065,"featherweight",5,"right-handed",1,0,0,1,1
0.065,"super welterweight",13,"right-handed",9,25,0,34,0.264705882352941
0.065,"super lightweight",12,"right-handed",5,0,0,5,1
0.065,"bantamweight",9,"right-handed",8,9,0,17,0.470588235294118
0.065,"super featherweight",10,"right-handed",7,0,0,7,1
0.065,"super lightweight",12,"right-handed",5,2,0,7,0.714285714285714
0.065,"super flyweight",12,"right-handed",5,2,0,7,0.714285714285714
0.065,"bantamweight",6,"right-handed",5,0,0,5,1
0.065,"light heavyweight",33,"right-handed",33,29,0,62,0.532258064516129
0.065,"middleweight",16,"right-handed",3,1,0,4,0.75
0.065,"middleweight",16,"right-handed",6,0,0,6,1
0.065,"welterweight",13,"right-handed",3,4,0,7,0.428571428571429
0.065,"cruiserweight",16,"right-handed",6,0,0,6,1
0.065,"welterweight",13,"right-handed",3,2,0,5,0.6
0.065,"lightweight",13,"right-handed",5,0,0,5,1
0.065,"super lightweight",7,"right-handed",8,0,0,8,1
0.065,"super welterweight",8,"right-handed",6,5,0,11,0.545454545454545
0.065,"super welterweight",13,"right-handed",3,5,1,9,0.388888888888889
0.065,"welterweight",16,"right-handed",10,24,1,35,0.3
0.064,"super middleweight",16,"right-handed",4,0,0,4,1
0.064,"featherweight",4,"right-handed",4,0,0,4,1
0.064,"super middleweight",NA,"right-handed",4,0,0,4,1
0.064,"welterweight",NA,"right-handed",4,0,0,4,1
0.064,"lightweight",19,"right-handed",10,11,3,24,0.479166666666667
0.064,"cruiserweight",NA,"right-handed",2,7,0,9,0.222222222222222
0.064,"super welterweight",19,"right-handed",7,54,2,63,0.126984126984127
0.064,"featherweight",13,"right-handed",11,0,0,11,1
0.064,"flyweight",7,"right-handed",5,4,0,9,0.555555555555556
0.064,"welterweight",8,"right-handed",6,0,0,6,1
0.064,"light heavyweight",10,"right-handed",8,0,0,8,1
0.064,"middleweight",5,"right-handed",3,0,0,3,1
0.064,"super featherweight",NA,"right-handed",3,1,0,4,0.75
0.064,"lightweight",23,"right-handed",8,8,0,16,0.5
0.064,"super middleweight",13,"right-handed",8,9,1,18,0.472222222222222
0.064,"bantamweight",NA,"right-handed",9,2,0,11,0.818181818181818
0.064,"super welterweight",12,"right-handed",2,0,0,2,1
0.064,"flyweight",6,"right-handed",5,2,0,7,0.714285714285714
0.064,"super featherweight",7,"right-handed",2,0,0,2,1
0.064,"lightweight",9,"right-handed",9,0,0,9,1
0.063,"super welterweight",10,"right-handed",5,0,0,5,1
0.063,"cruiserweight",16,"right-handed",2,2,1,5,0.5
0.063,"heavyweight",26,"right-handed",1,5,1,7,0.214285714285714
0.063,"lightweight",4,"right-handed",12,3,0,15,0.8
0.063,"heavyweight",12,"right-handed",2,0,1,3,0.833333333333333
0.063,"super featherweight",15,"right-handed",10,1,0,11,0.909090909090909
0.063,"light heavyweight",10,"right-handed",5,3,0,8,0.625
0.063,"heavyweight",27,"right-handed",6,7,0,13,0.461538461538462
0.063,"super lightweight",31,"right-handed",20,21,0,41,0.48780487804878
0.063,"cruiserweight",12,"right-handed",10,2,0,12,0.833333333333333
0.063,"welterweight",12,"right-handed",13,1,1,15,0.9
0.063,"super featherweight",13,"right-handed",6,0,0,6,1
0.063,"welterweight",17,"right-handed",3,1,1,5,0.7
0.063,"featherweight",10,"right-handed",3,0,0,3,1
0.063,"featherweight",9,"right-handed",3,2,0,5,0.6
0.062,"featherweight",14,"right-handed",1,15,2,18,0.111111111111111
0.062,"super lightweight",11,"right-handed",2,8,2,12,0.25
0.062,"heavyweight",25,"right-handed",26,2,0,28,0.928571428571429
0.062,"lightweight",28,"right-handed",3,3,0,6,0.5
0.062,"cruiserweight",14,"right-handed",6,2,0,8,0.75
0.062,"welterweight",15,"right-handed",9,22,0,31,0.290322580645161
0.062,"featherweight",9,"right-handed",8,0,0,8,1
0.062,"welterweight",9,"right-handed",4,0,0,4,1
0.062,"super bantamweight",12,"right-handed",6,1,0,7,0.857142857142857
0.062,"cruiserweight",16,"right-handed",11,0,0,11,1
0.062,"lightweight",8,"right-handed",2,3,1,6,0.416666666666667
0.062,"super lightweight",22,"right-handed",2,1,0,3,0.666666666666667
0.062,"cruiserweight",16,"right-handed",12,3,2,17,0.764705882352941
0.062,"super lightweight",5,"right-handed",3,0,0,3,1
0.062,"cruiserweight",13,"right-handed",2,13,0,15,0.133333333333333
0.062,"bantamweight",NA,"right-handed",3,2,2,7,0.571428571428571
0.061,"lightweight",23,"right-handed",39,55,7,101,0.420792079207921
0.061,"heavyweight",9,"right-handed",5,0,0,5,1
0.061,"light flyweight",15,"right-handed",13,13,0,26,0.5
0.061,"",14,"right-handed",0,4,0,4,0
0.061,"lightweight",8,"right-handed",4,1,0,5,0.8
0.061,"bantamweight",NA,"right-handed",3,7,1,11,0.318181818181818
0.061,"featherweight",13,"right-handed",8,0,0,8,1
0.061,"middleweight",9,"right-handed",7,39,4,50,0.18
0.061,"lightweight",10,"right-handed",3,0,0,3,1
0.061,"super bantamweight",11,"right-handed",5,9,1,15,0.366666666666667
0.061,"bantamweight",18,"right-handed",4,9,1,14,0.321428571428571
0.061,"middleweight",20,"right-handed",3,0,0,3,1
0.061,"super featherweight",17,"right-handed",6,6,0,12,0.5
0.061,"lightweight",16,"right-handed",3,0,0,3,1
0.061,"super bantamweight",11,"right-handed",5,1,0,6,0.833333333333333
0.061,"welterweight",10,"right-handed",4,0,1,5,0.9
0.061,"heavyweight",21,"right-handed",3,5,0,8,0.375
0.061,"super featherweight",17,"right-handed",14,22,0,36,0.388888888888889
0.061,"heavyweight",15,"right-handed",6,0,1,7,0.928571428571429
0.061,"super lightweight",9,"right-handed",3,3,0,6,0.5
0.061,"bantamweight",18,"right-handed",7,10,0,17,0.411764705882353
0.061,"super middleweight",13,"right-handed",3,0,0,3,1
0.061,"lightweight",12,"right-handed",4,0,0,4,1
0.06,"lightweight",NA,"right-handed",4,1,0,5,0.8
0.06,"welterweight",29,"right-handed",17,2,1,20,0.875
0.06,"featherweight",11,"right-handed",9,0,1,10,0.95
0.06,"middleweight",14,"right-handed",7,1,1,9,0.833333333333333
0.06,"cruiserweight",26,"right-handed",12,25,2,39,0.333333333333333
0.06,"super featherweight",14,"right-handed",4,3,2,9,0.555555555555556
0.06,"cruiserweight",22,"right-handed",5,10,0,15,0.333333333333333
0.06,"super middleweight",9,"right-handed",0,3,1,4,0.125
0.06,"super welterweight",10,"right-handed",3,1,0,4,0.75
0.06,"lightweight",15,"right-handed",11,4,0,15,0.733333333333333
0.06,"cruiserweight",9,"right-handed",5,1,0,6,0.833333333333333
0.06,"super bantamweight",18,"right-handed",6,5,1,12,0.541666666666667
0.06,"super middleweight",19,"right-handed",15,12,0,27,0.555555555555556
0.06,"bantamweight",9,"right-handed",11,2,0,13,0.846153846153846
0.06,"middleweight",14,"right-handed",5,0,0,5,1
0.06,"super welterweight",14,"right-handed",6,22,3,31,0.241935483870968
0.06,"bantamweight",16,"right-handed",21,19,1,41,0.524390243902439
0.06,"super featherweight",11,"right-handed",0,3,0,3,0
0.06,"welterweight",8,"right-handed",1,1,0,2,0.5
0.06,"super middleweight",14,"right-handed",10,0,0,10,1
0.06,"bantamweight",15,"right-handed",7,13,2,22,0.363636363636364
0.06,"flyweight",18,"right-handed",3,8,1,12,0.291666666666667
0.06,"lightweight",8,"right-handed",6,4,1,11,0.590909090909091
0.06,"super bantamweight",15,"right-handed",5,5,1,11,0.5
0.059,"super welterweight",26,"right-handed",5,19,0,24,0.208333333333333
0.059,"welterweight",17,"right-handed",3,1,0,4,0.75
0.059,"super featherweight",7,"right-handed",4,1,0,5,0.8
0.059,"middleweight",16,"right-handed",1,1,0,2,0.5
0.059,"welterweight",15,"right-handed",8,0,0,8,1
0.059,"lightweight",9,"right-handed",1,0,0,1,1
0.059,"featherweight",20,"right-handed",7,14,0,21,0.333333333333333
0.059,"super bantamweight",8,"right-handed",6,0,0,6,1
0.059,"light heavyweight",17,"right-handed",4,3,1,8,0.5625
0.059,"super bantamweight",16,"right-handed",6,12,0,18,0.333333333333333
0.059,"super welterweight",20,"right-handed",1,0,0,1,1
0.059,"middleweight",6,"right-handed",2,0,0,2,1
0.059,"super middleweight",12,"right-handed",2,0,0,2,1
0.059,"super welterweight",10,"right-handed",4,4,1,9,0.5
0.059,"welterweight",21,"right-handed",5,2,0,7,0.714285714285714
0.059,"super lightweight",13,"right-handed",8,0,0,8,1
0.059,"middleweight",8,"right-handed",2,0,0,2,1
0.059,"light heavyweight",34,"right-handed",3,7,0,10,0.3
0.059,"welterweight",20,"right-handed",12,25,2,39,0.333333333333333
0.059,"middleweight",19,"right-handed",5,2,1,8,0.6875
0.058,"lightweight",14,"right-handed",3,17,2,22,0.181818181818182
0.058,"lightweight",16,"right-handed",4,2,2,8,0.625
0.058,"super bantamweight",6,"right-handed",7,0,0,7,1
0.058,"super featherweight",9,"right-handed",6,2,0,8,0.75
0.058,"middleweight",14,"right-handed",4,0,0,4,1
0.058,"super middleweight",10,"right-handed",8,0,0,8,1
0.058,"super middleweight",14,"right-handed",2,1,1,4,0.625
0.058,"super welterweight",8,"right-handed",4,0,0,4,1
0.058,"super lightweight",15,"right-handed",8,0,0,8,1
0.058,"lightweight",5,"right-handed",5,0,0,5,1
0.058,"super middleweight",23,"right-handed",9,9,0,18,0.5
0.058,"heavyweight",19,"right-handed",5,14,3,22,0.295454545454545
0.058,"light heavyweight",15,"right-handed",7,0,0,7,1
0.058,"super lightweight",9,"right-handed",4,0,0,4,1
0.058,"super middleweight",28,"right-handed",0,20,2,22,0.0454545454545455
0.058,"welterweight",8,"right-handed",3,0,0,3,1
0.058,"super featherweight",9,"right-handed",4,0,0,4,1
0.058,"super lightweight",15,"right-handed",4,9,1,14,0.321428571428571
0.058,"super bantamweight",15,"right-handed",4,6,2,12,0.416666666666667
0.058,"super lightweight",8,"right-handed",6,0,0,6,1
0.058,"cruiserweight",28,"right-handed",26,36,0,62,0.419354838709677
0.058,"lightweight",18,"right-handed",10,1,1,12,0.875
0.058,"cruiserweight",20,"right-handed",9,0,0,9,1
0.058,"lightweight",24,"right-handed",8,29,3,40,0.2375
0.058,"super featherweight",20,"right-handed",3,6,2,11,0.363636363636364
0.057,"cruiserweight",15,"right-handed",3,0,0,3,1
0.057,"lightweight",6,"right-handed",11,1,0,12,0.916666666666667
0.057,"welterweight",6,"right-handed",3,0,0,3,1
0.057,"super welterweight",13,"right-handed",1,0,0,1,1
0.057,"super featherweight",16,"right-handed",13,6,0,19,0.684210526315789
0.057,"middleweight",7,"right-handed",4,0,0,4,1
0.057,"welterweight",23,"right-handed",2,8,0,10,0.2
0.057,"heavyweight",23,"right-handed",5,1,2,8,0.75
0.057,"cruiserweight",13,"right-handed",3,0,0,3,1
0.057,"super lightweight",23,"right-handed",9,12,1,22,0.431818181818182
0.057,"super middleweight",26,"right-handed",33,37,0,70,0.471428571428571
0.057,"super bantamweight",11,"right-handed",5,2,1,8,0.6875
0.057,"featherweight",8,"right-handed",3,0,0,3,1
0.057,"bantamweight",7,"right-handed",6,0,1,7,0.928571428571429
0.057,"super lightweight",14,"right-handed",7,1,2,10,0.8
0.057,"light heavyweight",19,"right-handed",9,13,0,22,0.409090909090909
0.057,"light heavyweight",23,"right-handed",14,23,2,39,0.384615384615385
0.057,"featherweight",7,"right-handed",8,2,0,10,0.8
0.057,"super welterweight",18,"right-handed",1,7,0,8,0.125
0.057,"super bantamweight",8,"right-handed",7,4,0,11,0.636363636363636
0.057,"welterweight",NA,"right-handed",2,1,0,3,0.666666666666667
0.057,"super welterweight",8,"right-handed",1,0,0,1,1
0.057,"cruiserweight",16,"right-handed",7,0,0,7,1
0.057,"super bantamweight",9,"right-handed",7,0,1,8,0.9375
0.057,"lightweight",13,"right-handed",3,0,0,3,1
0.057,"light heavyweight",13,"right-handed",6,0,0,6,1
0.057,"middleweight",16,"right-handed",2,0,0,2,1
0.057,"super middleweight",11,"right-handed",8,0,0,8,1
0.057,"super middleweight",17,"right-handed",6,8,0,14,0.428571428571429
0.057,"welterweight",9,"right-handed",4,1,0,5,0.8
0.057,"middleweight",7,"right-handed",2,0,0,2,1
0.057,"welterweight",8,"right-handed",5,1,0,6,0.833333333333333
0.057,"minimumweight",5,"right-handed",5,3,2,10,0.6
0.057,"featherweight",8,"right-handed",3,0,0,3,1
0.057,"middleweight",20,"right-handed",21,30,3,54,0.416666666666667
0.056,"super featherweight",22,"right-handed",3,8,2,13,0.307692307692308
0.056,"welterweight",9,"right-handed",6,0,0,6,1
0.056,"bantamweight",8,"right-handed",4,0,1,5,0.9
0.056,"super lightweight",27,"right-handed",23,40,0,63,0.365079365079365
0.056,"middleweight",13,"right-handed",8,0,0,8,1
0.056,"super middleweight",11,"right-handed",3,0,0,3,1
0.056,"light heavyweight",NA,"right-handed",1,8,0,9,0.111111111111111
0.056,"super flyweight",18,"right-handed",21,46,2,69,0.318840579710145
0.056,"featherweight",10,"right-handed",2,0,0,2,1
0.056,"lightweight",8,"right-handed",4,1,2,7,0.714285714285714
0.056,"light flyweight",4,"right-handed",3,1,2,6,0.666666666666667
0.056,"flyweight",16,"right-handed",3,3,1,7,0.5
0.056,"super lightweight",14,"right-handed",2,0,0,2,1
0.056,"featherweight",7,"right-handed",7,0,0,7,1
0.056,"super bantamweight",7,"right-handed",4,2,0,6,0.666666666666667
0.056,"super lightweight",14,"right-handed",8,25,1,34,0.25
0.056,"super welterweight",12,"right-handed",1,0,0,1,1
0.056,"super featherweight",13,"right-handed",9,0,0,9,1
0.056,"cruiserweight",17,"right-handed",5,1,0,6,0.833333333333333
0.056,"super lightweight",12,"right-handed",5,0,2,7,0.857142857142857
0.056,"light heavyweight",13,"right-handed",6,0,0,6,1
0.056,"lightweight",NA,"right-handed",3,0,0,3,1
0.056,"middleweight",17,"right-handed",3,3,0,6,0.5
0.056,"lightweight",12,"right-handed",4,3,0,7,0.571428571428571
0.056,"heavyweight",18,"right-handed",3,4,0,7,0.428571428571429
0.056,"super bantamweight",9,"right-handed",5,0,1,6,0.916666666666667
0.056,"middleweight",21,"right-handed",9,6,0,15,0.6
0.055,"super bantamweight",11,"right-handed",11,0,0,11,1
0.055,"super lightweight",NA,"right-handed",2,2,1,5,0.5
0.055,"welterweight",12,"right-handed",5,4,1,10,0.55
0.055,"flyweight",14,"right-handed",5,6,2,13,0.461538461538462
0.055,"super welterweight",18,"right-handed",5,1,0,6,0.833333333333333
0.055,"light flyweight",5,"right-handed",7,1,0,8,0.875
0.055,"welterweight",10,"right-handed",4,1,1,6,0.75
0.055,"light heavyweight",10,"right-handed",1,3,1,5,0.3
0.055,"super featherweight",5,"right-handed",1,0,0,1,1
0.055,"super featherweight",NA,"right-handed",9,1,0,10,0.9
0.055,"heavyweight",20,"right-handed",2,0,1,3,0.833333333333333
0.055,"featherweight",10,"right-handed",8,0,0,8,1
0.055,"super middleweight",14,"right-handed",9,0,0,9,1
0.055,"super featherweight",13,"right-handed",5,3,0,8,0.625
0.055,"super bantamweight",10,"right-handed",8,35,0,43,0.186046511627907
0.055,"welterweight",NA,"right-handed",3,0,0,3,1
0.055,"super middleweight",10,"right-handed",23,25,1,49,0.479591836734694
0.055,"super welterweight",17,"right-handed",6,6,0,12,0.5
0.055,"lightweight",9,"right-handed",4,1,0,5,0.8
0.055,"super welterweight",13,"right-handed",3,0,1,4,0.875
0.055,"welterweight",8,"right-handed",4,6,0,10,0.4
0.055,"super middleweight",29,"right-handed",23,16,0,39,0.58974358974359
0.055,"lightweight",22,"right-handed",12,1,0,13,0.923076923076923
0.055,"super welterweight",20,"right-handed",3,4,0,7,0.428571428571429
0.055,"lightweight",20,"right-handed",28,35,2,65,0.446153846153846
0.055,"super lightweight",11,"right-handed",2,0,0,2,1
0.055,"heavyweight",21,"right-handed",4,16,3,23,0.239130434782609
0.055,"featherweight",16,"right-handed",6,3,0,9,0.666666666666667
0.055,"super featherweight",15,"right-handed",6,0,0,6,1
0.055,"heavyweight",20,"right-handed",9,19,4,32,0.34375
0.055,"super featherweight",7,"right-handed",7,2,1,10,0.75
0.055,"super featherweight",11,"right-handed",4,7,1,12,0.375
0.055,"middleweight",17,"right-handed",6,7,2,15,0.466666666666667
0.055,"super lightweight",14,"right-handed",5,13,3,21,0.30952380952381
0.055,"cruiserweight",12,"right-handed",8,0,0,8,1
0.055,"cruiserweight",7,"right-handed",4,2,0,6,0.666666666666667
0.055,"super welterweight",10,"right-handed",5,0,0,5,1
0.055,"super lightweight",21,"right-handed",6,8,0,14,0.428571428571429
0.055,"super welterweight",22,"right-handed",6,40,7,53,0.179245283018868
0.055,"cruiserweight",21,"right-handed",4,1,0,5,0.8
0.055,"featherweight",15,"right-handed",13,4,2,19,0.736842105263158
0.055,"middleweight",20,"right-handed",6,0,1,7,0.928571428571429
0.055,"super welterweight",10,"right-handed",1,0,0,1,1
0.055,"welterweight",7,"right-handed",2,0,0,2,1
0.055,"featherweight",NA,"right-handed",3,2,2,7,0.571428571428571
0.055,"lightweight",7,"right-handed",3,2,0,5,0.6
0.055,"heavyweight",21,"right-handed",4,0,0,4,1
0.055,"featherweight",13,"right-handed",5,1,1,7,0.785714285714286
0.055,"bantamweight",10,"right-handed",4,8,1,13,0.346153846153846
0.054,"super featherweight",10,"right-handed",4,2,0,6,0.666666666666667
0.054,"super lightweight",11,"right-handed",7,0,0,7,1
0.054,"super featherweight",13,"right-handed",9,8,1,18,0.527777777777778
0.054,"heavyweight",22,"right-handed",69,23,3,95,0.742105263157895
0.054,"super bantamweight",6,"right-handed",4,0,0,4,1
0.054,"middleweight",17,"right-handed",2,0,0,2,1
0.054,"super middleweight",18,"right-handed",3,1,1,5,0.7
0.054,"super featherweight",13,"right-handed",5,2,0,7,0.714285714285714
0.054,"middleweight",12,"right-handed",3,0,0,3,1
0.054,"welterweight",10,"right-handed",3,0,0,3,1
0.054,"super featherweight",21,"right-handed",9,2,3,14,0.75
0.054,"cruiserweight",18,"right-handed",4,6,1,11,0.409090909090909
0.054,"lightweight",17,"right-handed",7,43,3,53,0.160377358490566
0.054,"super welterweight",NA,"right-handed",11,3,0,14,0.785714285714286
0.054,"welterweight",25,"right-handed",4,3,1,8,0.5625
0.054,"super featherweight",9,"right-handed",4,1,0,5,0.8
0.054,"welterweight",19,"right-handed",8,17,2,27,0.333333333333333
0.054,"lightweight",12,"right-handed",6,0,0,6,1
0.054,"super lightweight",7,"right-handed",5,0,0,5,1
0.054,"light heavyweight",11,"right-handed",16,10,0,26,0.615384615384615
0.054,"light heavyweight",15,"right-handed",9,1,0,10,0.9
0.054,"super lightweight",NA,"right-handed",1,0,0,1,1
0.054,"super welterweight",23,"right-handed",10,7,1,18,0.583333333333333
0.054,"welterweight",9,"right-handed",5,7,1,13,0.423076923076923
0.054,"middleweight",12,"right-handed",7,1,0,8,0.875
0.054,"featherweight",16,"right-handed",31,27,0,58,0.53448275862069
0.054,"lightweight",7,"right-handed",4,3,0,7,0.571428571428571
0.054,"super featherweight",17,"right-handed",12,2,0,14,0.857142857142857
0.054,"super welterweight",12,"right-handed",1,2,0,3,0.333333333333333
0.054,"super middleweight",10,"right-handed",1,2,0,3,0.333333333333333
0.054,"light heavyweight",25,"right-handed",10,15,2,27,0.407407407407407
0.054,"featherweight",10,"right-handed",4,3,0,7,0.571428571428571
0.054,"bantamweight",17,"right-handed",0,3,0,3,0
0.054,"super welterweight",12,"right-handed",1,0,0,1,1
0.054,"middleweight",8,"right-handed",6,0,0,6,1
0.054,"cruiserweight",18,"right-handed",2,4,0,6,0.333333333333333
0.054,"light heavyweight",16,"right-handed",3,0,0,3,1
0.054,"super welterweight",13,"right-handed",6,1,1,8,0.8125
0.054,"super featherweight",20,"right-handed",4,24,1,29,0.155172413793103
0.054,"bantamweight",21,"right-handed",14,7,1,22,0.659090909090909
0.053,"super bantamweight",17,"right-handed",2,81,5,88,0.0511363636363636
0.053,"welterweight",9,"right-handed",4,0,0,4,1
0.053,"super featherweight",11,"right-handed",6,1,0,7,0.857142857142857
0.053,"welterweight",13,"right-handed",6,3,1,10,0.65
0.053,"cruiserweight",10,"right-handed",4,0,0,4,1
0.053,"super flyweight",5,"right-handed",3,0,1,4,0.875
0.053,"welterweight",13,"right-handed",5,0,1,6,0.916666666666667
0.053,"lightweight",7,"right-handed",10,1,0,11,0.909090909090909
0.053,"lightweight",12,"right-handed",2,0,1,3,0.833333333333333
0.053,"light heavyweight",16,"right-handed",5,1,0,6,0.833333333333333
0.053,"super flyweight",20,"right-handed",5,8,2,15,0.4
0.053,"super lightweight",19,"right-handed",11,10,0,21,0.523809523809524
0.053,"super lightweight",13,"right-handed",5,0,1,6,0.916666666666667
0.053,"heavyweight",21,"right-handed",12,4,0,16,0.75
0.053,"cruiserweight",14,"right-handed",4,0,2,6,0.833333333333333
0.053,"lightweight",9,"right-handed",2,2,0,4,0.5
0.053,"welterweight",14,"right-handed",7,1,0,8,0.875
0.053,"middleweight",26,"right-handed",4,2,0,6,0.666666666666667
0.053,"featherweight",10,"right-handed",4,0,0,4,1
0.053,"super middleweight",11,"right-handed",4,0,0,4,1
0.053,"super lightweight",12,"right-handed",4,0,0,4,1
0.053,"super lightweight",8,"right-handed",5,0,0,5,1
0.053,"middleweight",13,"right-handed",3,0,1,4,0.875
0.053,"super bantamweight",10,"right-handed",2,4,2,8,0.375
0.053,"super welterweight",15,"right-handed",3,0,1,4,0.875
0.053,"super welterweight",21,"right-handed",13,23,3,39,0.371794871794872
0.053,"super welterweight",8,"right-handed",1,0,0,1,1
0.053,"super middleweight",9,"right-handed",4,0,0,4,1
0.053,"welterweight",14,"right-handed",2,3,0,5,0.4
0.053,"cruiserweight",15,"right-handed",20,27,0,47,0.425531914893617
0.053,"lightweight",21,"right-handed",5,18,3,26,0.25
0.053,"lightweight",8,"right-handed",7,0,0,7,1
0.053,"heavyweight",31,"right-handed",16,7,0,23,0.695652173913043
0.053,"light heavyweight",13,"right-handed",5,0,0,5,1
0.053,"cruiserweight",15,"right-handed",4,0,0,4,1
0.053,"super welterweight",28,"right-handed",18,4,1,23,0.804347826086957
0.053,"welterweight",14,"right-handed",2,1,0,3,0.666666666666667
0.053,"middleweight",10,"right-handed",2,0,0,2,1
0.053,"super welterweight",10,"right-handed",8,0,0,8,1
0.053,"cruiserweight",17,"right-handed",4,1,0,5,0.8
0.053,"super lightweight",7,"right-handed",4,6,0,10,0.4
0.053,"lightweight",16,"right-handed",10,0,1,11,0.954545454545455
0.053,"heavyweight",NA,"right-handed",5,6,0,11,0.454545454545455
0.053,"welterweight",22,"right-handed",4,2,0,6,0.666666666666667
0.053,"super featherweight",19,"right-handed",4,7,2,13,0.384615384615385
0.053,"heavyweight",10,"right-handed",9,0,0,9,1
0.053,"welterweight",NA,"right-handed",2,2,1,5,0.5
0.053,"middleweight",16,"right-handed",4,4,2,10,0.5
0.053,"welterweight",10,"right-handed",4,2,0,6,0.666666666666667
0.053,"super flyweight",8,"right-handed",2,0,0,2,1
0.053,"super featherweight",8,"right-handed",6,0,0,6,1
0.053,"lightweight",4,"right-handed",2,0,0,2,1
0.053,"super lightweight",10,"right-handed",7,1,0,8,0.875
0.053,"super middleweight",15,"right-handed",3,3,0,6,0.5
0.053,"middleweight",15,"right-handed",5,0,2,7,0.857142857142857
0.053,"super flyweight",4,"right-handed",5,1,1,7,0.785714285714286
0.052,"super middleweight",14,"right-handed",5,0,0,5,1
0.052,"welterweight",8,"right-handed",3,0,0,3,1
0.052,"super featherweight",10,"right-handed",3,0,2,5,0.8
0.052,"flyweight",13,"right-handed",6,3,2,11,0.636363636363636
0.052,"welterweight",13,"right-handed",3,1,1,5,0.7
0.052,"heavyweight",10,"right-handed",3,0,0,3,1
0.052,"super featherweight",8,"right-handed",2,0,0,2,1
0.052,"super featherweight",13,"right-handed",3,11,1,15,0.233333333333333
0.052,"super lightweight",12,"right-handed",0,0,2,2,0.5
0.052,"super middleweight",21,"right-handed",7,5,0,12,0.583333333333333
0.052,"super featherweight",7,"right-handed",2,4,1,7,0.357142857142857
0.052,"super middleweight",17,"right-handed",9,0,0,9,1
0.052,"lightweight",17,"right-handed",7,0,0,7,1
0.052,"super lightweight",NA,"right-handed",1,0,0,1,1
0.052,"super bantamweight",17,"right-handed",26,12,1,39,0.67948717948718
0.052,"welterweight",12,"right-handed",3,2,2,7,0.571428571428571
0.052,"cruiserweight",10,"right-handed",6,0,0,6,1
0.052,"super welterweight",11,"right-handed",1,0,0,1,1
0.052,"super flyweight",8,"right-handed",9,1,0,10,0.9
0.052,"heavyweight",13,"right-handed",2,0,0,2,1
0.052,"lightweight",8,"right-handed",4,1,1,6,0.75
0.052,"super middleweight",7,"right-handed",10,0,1,11,0.954545454545455
0.052,"super welterweight",8,"right-handed",1,0,0,1,1
0.052,"super featherweight",20,"right-handed",5,6,0,11,0.454545454545455
0.052,"light heavyweight",13,"right-handed",13,47,2,62,0.225806451612903
0.052,"lightweight",19,"right-handed",12,2,1,15,0.833333333333333
0.052,"super featherweight",14,"right-handed",8,6,0,14,0.571428571428571
0.052,"super welterweight",5,"right-handed",1,0,0,1,1
0.052,"flyweight",16,"right-handed",5,2,1,8,0.6875
0.052,"lightweight",10,"right-handed",5,0,0,5,1
0.052,"cruiserweight",7,"right-handed",5,0,0,5,1
0.052,"welterweight",8,"right-handed",4,0,0,4,1
0.052,"middleweight",10,"right-handed",6,3,0,9,0.666666666666667
0.052,"super lightweight",21,"right-handed",12,15,1,28,0.446428571428571
0.052,"light heavyweight",18,"right-handed",2,0,0,2,1
0.052,"super featherweight",13,"right-handed",14,19,0,33,0.424242424242424
0.052,"cruiserweight",12,"right-handed",3,1,1,5,0.7
0.052,"heavyweight",12,"right-handed",4,0,0,4,1
0.052,"super middleweight",25,"right-handed",4,10,2,16,0.3125
0.052,"middleweight",9,"right-handed",2,0,0,2,1
0.052,"super welterweight",14,"right-handed",1,0,0,1,1
0.052,"super featherweight",20,"right-handed",2,0,0,2,1
0.052,"light heavyweight",22,"right-handed",6,5,1,12,0.541666666666667
0.052,"super welterweight",8,"right-handed",5,0,0,5,1
0.052,"super welterweight",9,"right-handed",6,1,0,7,0.857142857142857
0.052,"welterweight",26,"right-handed",4,4,2,10,0.5
0.052,"super middleweight",8,"right-handed",9,0,0,9,1
0.052,"middleweight",12,"right-handed",3,0,0,3,1
0.052,"super lightweight",11,"right-handed",6,0,0,6,1
0.052,"super featherweight",8,"right-handed",9,0,0,9,1
0.052,"super lightweight",16,"right-handed",4,1,0,5,0.8
0.052,"light heavyweight",NA,"right-handed",4,0,0,4,1
0.052,"featherweight",26,"right-handed",2,12,1,15,0.166666666666667
0.052,"super lightweight",9,"right-handed",1,1,0,2,0.5
0.052,"super middleweight",11,"right-handed",3,0,0,3,1
0.052,"super bantamweight",5,"right-handed",13,0,0,13,1
0.052,"lightweight",10,"right-handed",2,0,0,2,1
0.052,"super lightweight",11,"right-handed",1,1,0,2,0.5
0.052,"cruiserweight",26,"right-handed",1,4,1,6,0.25
0.052,"featherweight",13,"right-handed",14,1,1,16,0.90625
0.052,"light heavyweight",10,"right-handed",1,0,0,1,1
0.052,"super featherweight",10,"right-handed",2,3,1,6,0.416666666666667
0.052,"bantamweight",7,"right-handed",5,2,0,7,0.714285714285714
0.052,"middleweight",14,"right-handed",3,0,0,3,1
0.052,"heavyweight",18,"right-handed",5,0,0,5,1
0.052,"light heavyweight",23,"right-handed",11,20,0,31,0.354838709677419
0.052,"super welterweight",16,"right-handed",3,1,3,7,0.642857142857143
0.052,"middleweight",13,"right-handed",1,0,0,1,1
0.052,"super bantamweight",16,"right-handed",4,0,2,6,0.833333333333333
0.052,"cruiserweight",18,"right-handed",7,2,0,9,0.777777777777778
0.052,"featherweight",8,"right-handed",9,0,2,11,0.909090909090909
0.052,"middleweight",16,"right-handed",8,0,0,8,1
0.052,"welterweight",12,"right-handed",6,0,0,6,1
0.052,"welterweight",7,"right-handed",9,1,0,10,0.9
0.052,"heavyweight",31,"right-handed",8,0,0,8,1
0.052,"super flyweight",13,"right-handed",10,1,1,12,0.875
0.052,"lightweight",15,"right-handed",3,0,0,3,1
0.052,"heavyweight",31,"right-handed",8,8,1,17,0.5
0.052,"super welterweight",11,"right-handed",6,0,0,6,1
0.052,"lightweight",14,"right-handed",6,0,1,7,0.928571428571429
0.052,"super bantamweight",16,"right-handed",13,0,0,13,1
0.052,"super featherweight",12,"right-handed",3,0,1,4,0.875
0.052,"heavyweight",14,"right-handed",6,1,0,7,0.857142857142857
0.052,"featherweight",4,"right-handed",10,4,0,14,0.714285714285714
0.052,"super featherweight",11,"right-handed",5,0,0,5,1
0.052,"welterweight",9,"right-handed",15,0,1,16,0.96875
0.052,"featherweight",12,"right-handed",5,7,2,14,0.428571428571429
0.052,"super lightweight",11,"right-handed",6,1,0,7,0.857142857142857
0.052,"light flyweight",14,"right-handed",7,0,0,7,1
0.052,"lightweight",8,"right-handed",4,0,0,4,1
0.052,"cruiserweight",18,"right-handed",7,0,1,8,0.9375
0.052,"super welterweight",11,"right-handed",6,0,0,6,1
0.051,"super lightweight",11,"right-handed",6,3,2,11,0.636363636363636
0.051,"super lightweight",7,"right-handed",5,0,0,5,1
0.051,"super lightweight",8,"right-handed",5,0,0,5,1
0.051,"cruiserweight",NA,"right-handed",5,0,0,5,1
0.051,"heavyweight",15,"right-handed",5,0,0,5,1
0.051,"super middleweight",15,"right-handed",4,0,0,4,1
0.051,"super middleweight",10,"right-handed",4,0,0,4,1
0.051,"cruiserweight",14,"right-handed",5,0,0,5,1
0.051,"flyweight",7,"right-handed",3,1,0,4,0.75
0.051,"featherweight",9,"right-handed",7,1,0,8,0.875
0.051,"super middleweight",10,"right-handed",3,0,0,3,1
0.051,"cruiserweight",9,"right-handed",4,0,0,4,1
0.051,"super featherweight",17,"right-handed",5,7,1,13,0.423076923076923
0.051,"heavyweight",29,"right-handed",13,1,0,14,0.928571428571429
0.051,"middleweight",7,"right-handed",5,0,0,5,1
0.051,"middleweight",13,"right-handed",2,0,1,3,0.833333333333333
0.051,"welterweight",12,"right-handed",6,7,3,16,0.46875
0.051,"middleweight",9,"right-handed",3,0,2,5,0.8
0.051,"super welterweight",10,"right-handed",3,0,0,3,1
0.051,"welterweight",7,"right-handed",3,0,0,3,1
0.051,"featherweight",16,"right-handed",3,0,0,3,1
0.051,"super bantamweight",10,"right-handed",3,0,0,3,1
0.051,"lightweight",19,"right-handed",13,1,0,14,0.928571428571429
0.051,"light heavyweight",24,"right-handed",19,2,0,21,0.904761904761905
0.051,"super featherweight",7,"right-handed",3,0,0,3,1
0.051,"light heavyweight",23,"right-handed",3,0,0,3,1
0.051,"minimumweight",15,"right-handed",3,0,0,3,1
0.051,"welterweight",7,"right-handed",3,1,2,6,0.666666666666667
0.051,"middleweight",12,"right-handed",4,0,0,4,1
0.051,"super featherweight",19,"right-handed",3,0,0,3,1
0.051,"light flyweight",10,"right-handed",4,0,0,4,1
0.051,"super lightweight",8,"right-handed",3,0,0,3,1
0.051,"light flyweight",5,"right-handed",3,0,0,3,1
0.051,"super bantamweight",5,"right-handed",3,0,0,3,1
0.051,"light flyweight",5,"right-handed",3,1,0,4,0.75
0.051,"welterweight",10,"right-handed",3,0,0,3,1
0.051,"cruiserweight",15,"right-handed",6,0,0,6,1
0.051,"cruiserweight",8,"right-handed",3,0,0,3,1
0.051,"super featherweight",NA,"right-handed",3,0,0,3,1
0.051,"welterweight",6,"right-handed",3,0,0,3,1
0.051,"light heavyweight",10,"right-handed",3,0,0,3,1
0.051,"super featherweight",5,"right-handed",3,1,0,4,0.75
0.051,"super welterweight",17,"right-handed",0,6,1,7,0.0714285714285714
0.051,"cruiserweight",NA,"right-handed",3,0,0,3,1
0.051,"light flyweight",NA,"right-handed",2,0,0,2,1
0.051,"super lightweight",20,"right-handed",2,0,0,2,1
0.051,"heavyweight",18,"right-handed",2,0,0,2,1
0.051,"bantamweight",11,"right-handed",2,0,0,2,1
0.051,"cruiserweight",12,"right-handed",2,0,0,2,1
0.051,"super lightweight",9,"right-handed",1,0,2,3,0.666666666666667
0.051,"lightweight",9,"right-handed",2,0,0,2,1
0.051,"super welterweight",14,"right-handed",2,0,2,4,0.75
0.051,"bantamweight",7,"right-handed",2,0,0,2,1
0.051,"lightweight",14,"right-handed",2,0,0,2,1
0.051,"super flyweight",5,"right-handed",2,0,0,2,1
0.051,"heavyweight",7,"right-handed",2,0,0,2,1
0.051,"bantamweight",6,"right-handed",2,0,0,2,1
0.051,"light flyweight",10,"right-handed",1,0,1,2,0.75
0.051,"super welterweight",6,"right-handed",2,0,0,2,1
0.051,"welterweight",7,"right-handed",2,0,0,2,1
0.051,"welterweight",10,"right-handed",2,0,0,2,1
0.051,"flyweight",12,"right-handed",2,0,1,3,0.833333333333333
0.051,"welterweight",13,"right-handed",2,0,0,2,1
0.051,"middleweight",16,"right-handed",2,0,0,2,1
0.051,"featherweight",4,"right-handed",2,0,0,2,1
0.051,"welterweight",5,"right-handed",2,0,0,2,1
0.051,"super featherweight",19,"right-handed",3,4,2,9,0.444444444444444
0.051,"minimumweight",NA,"right-handed",2,0,1,3,0.833333333333333
0.051,"welterweight",11,"right-handed",5,1,1,7,0.785714285714286
0.051,"welterweight",9,"right-handed",2,0,0,2,1
0.051,"light heavyweight",15,"right-handed",2,0,2,4,0.75
0.051,"featherweight",17,"right-handed",2,1,0,3,0.666666666666667
0.051,"super lightweight",13,"right-handed",3,0,0,3,1
0.051,"featherweight",17,"right-handed",2,0,0,2,1
0.051,"heavyweight",13,"right-handed",2,0,0,2,1
0.051,"super bantamweight",5,"right-handed",2,0,0,2,1
0.051,"featherweight",10,"right-handed",2,0,0,2,1
0.051,"super welterweight",11,"right-handed",2,0,0,2,1
0.051,"super welterweight",12,"right-handed",2,0,0,2,1
0.051,"super welterweight",8,"right-handed",6,0,0,6,1
0.051,"middleweight",24,"right-handed",3,39,1,43,0.0813953488372093
0.051,"",8,"right-handed",1,0,0,1,1
0.051,"super welterweight",6,"right-handed",2,0,0,2,1
0.051,"welterweight",10,"right-handed",1,0,0,1,1
0.051,"bantamweight",7,"right-handed",2,1,1,4,0.625
0.051,"super flyweight",12,"right-handed",1,0,0,1,1
0.051,"cruiserweight",23,"right-handed",43,21,2,66,0.666666666666667
0.051,"flyweight",3,"right-handed",1,0,0,1,1
0.051,"super welterweight",6,"right-handed",1,0,0,1,1
0.051,"middleweight",15,"right-handed",13,56,9,78,0.224358974358974
0.051,"super lightweight",9,"right-handed",1,0,0,1,1
0.051,"welterweight",9,"right-handed",4,0,0,4,1
0.051,"welterweight",12,"right-handed",5,0,0,5,1
0.051,"super featherweight",10,"right-handed",4,1,0,5,0.8
0.051,"minimumweight",9,"right-handed",1,0,0,1,1
0.051,"middleweight",11,"right-handed",10,2,1,13,0.807692307692308
0.051,"super middleweight",9,"right-handed",1,0,0,1,1
0.051,"welterweight",14,"right-handed",5,0,0,5,1
0.051,"welterweight",19,"right-handed",1,8,2,11,0.181818181818182
0.051,"lightweight",19,"right-handed",17,3,0,20,0.85
0.051,"featherweight",10,"right-handed",1,0,0,1,1
0.051,"super lightweight",6,"right-handed",1,0,0,1,1
0.051,"super lightweight",11,"right-handed",9,53,4,66,0.166666666666667
0.051,"middleweight",6,"right-handed",2,4,0,6,0.333333333333333
0.051,"super featherweight",5,"right-handed",4,0,0,4,1
0.051,"heavyweight",15,"right-handed",4,0,1,5,0.9
0.051,"lightweight",7,"right-handed",6,0,0,6,1
0.051,"super featherweight",12,"right-handed",9,1,0,10,0.9
0.051,"super lightweight",15,"right-handed",4,0,1,5,0.9
0.051,"super lightweight",14,"right-handed",5,1,0,6,0.833333333333333
0.051,"super lightweight",19,"right-handed",1,0,1,2,0.75
0.051,"super lightweight",17,"right-handed",12,1,1,14,0.892857142857143
0.051,"lightweight",12,"right-handed",2,0,0,2,1
0.051,"welterweight",15,"right-handed",6,2,0,8,0.75
0.051,"heavyweight",21,"right-handed",17,0,0,17,1
0.051,"cruiserweight",13,"right-handed",8,1,0,9,0.888888888888889
0.051,"super welterweight",11,"right-handed",12,1,0,13,0.923076923076923
0.051,"super welterweight",20,"right-handed",5,6,2,13,0.461538461538462
0.051,"super middleweight",19,"right-handed",9,0,0,9,1
0.051,"heavyweight",14,"right-handed",3,0,0,3,1
0.051,"cruiserweight",15,"right-handed",4,0,0,4,1
0.051,"super featherweight",NA,"right-handed",1,0,0,1,1
0.051,"super lightweight",8,"right-handed",3,0,0,3,1
0.051,"lightweight",19,"right-handed",13,47,6,66,0.242424242424242
0.051,"middleweight",7,"right-handed",2,0,0,2,1
0.051,"welterweight",13,"right-handed",7,1,1,9,0.833333333333333
0.051,"super welterweight",11,"right-handed",1,0,0,1,1
0.051,"super bantamweight",25,"right-handed",8,21,2,31,0.290322580645161
0.051,"super featherweight",5,"right-handed",4,0,0,4,1
0.051,"lightweight",18,"right-handed",3,1,0,4,0.75
0.051,"lightweight",10,"right-handed",7,1,2,10,0.8
0.051,"super bantamweight",11,"right-handed",6,7,1,14,0.464285714285714
0.051,"cruiserweight",17,"right-handed",2,0,0,2,1
0.051,"lightweight",9,"right-handed",1,0,0,1,1
0.051,"heavyweight",34,"right-handed",6,0,0,6,1
0.051,"super lightweight",29,"right-handed",21,6,2,29,0.758620689655172
0.051,"light heavyweight",16,"right-handed",3,0,0,3,1
0.051,"super flyweight",9,"right-handed",4,5,2,11,0.454545454545455
0.051,"welterweight",5,"right-handed",10,0,0,10,1
0.051,"light heavyweight",12,"right-handed",7,0,0,7,1
0.051,"welterweight",4,"right-handed",9,0,0,9,1
0.051,"cruiserweight",14,"right-handed",3,0,0,3,1
0.051,"welterweight",27,"right-handed",4,11,4,19,0.315789473684211
0.051,"lightweight",11,"right-handed",5,2,1,8,0.6875
0.051,"super welterweight",16,"right-handed",5,1,0,6,0.833333333333333
0.051,"super featherweight",8,"right-handed",3,0,0,3,1
0.051,"super lightweight",6,"right-handed",10,0,0,10,1
0.051,"super lightweight",23,"right-handed",10,3,0,13,0.769230769230769
0.051,"super lightweight",11,"right-handed",4,1,0,5,0.8
0.051,"middleweight",NA,"right-handed",2,0,0,2,1
0.051,"welterweight",10,"right-handed",7,0,0,7,1
0.051,"super lightweight",NA,"right-handed",3,1,1,5,0.7
0.051,"super middleweight",20,"right-handed",10,2,0,12,0.833333333333333
0.051,"welterweight",12,"right-handed",8,0,0,8,1
0.051,"heavyweight",14,"right-handed",9,0,0,9,1
0.051,"welterweight",19,"right-handed",10,2,1,13,0.807692307692308
0.051,"light heavyweight",10,"right-handed",4,0,0,4,1
0.051,"heavyweight",24,"right-handed",13,6,0,19,0.684210526315789
0.051,"light heavyweight",15,"right-handed",3,1,0,4,0.75
0.051,"heavyweight",NA,"right-handed",6,0,1,7,0.928571428571429
0.051,"light heavyweight",14,"right-handed",8,0,0,8,1
0.051,"super bantamweight",10,"right-handed",6,0,0,6,1
0.051,"super welterweight",20,"right-handed",8,1,0,9,0.888888888888889
0.051,"welterweight",8,"right-handed",4,0,0,4,1
0.051,"middleweight",7,"right-handed",3,0,0,3,1
0.051,"lightweight",5,"right-handed",9,3,2,14,0.714285714285714
0.051,"super lightweight",10,"right-handed",3,2,0,5,0.6
0.051,"light flyweight",13,"right-handed",5,9,2,16,0.375
0.051,"super bantamweight",12,"right-handed",8,0,0,8,1
0.051,"heavyweight",19,"right-handed",7,1,0,8,0.875
0.051,"light heavyweight",23,"right-handed",2,2,0,4,0.5
0.051,"heavyweight",23,"right-handed",5,0,0,5,1
0.051,"light heavyweight",16,"right-handed",1,0,0,1,1
0.051,"super middleweight",20,"right-handed",15,13,0,28,0.535714285714286
0.051,"super middleweight",9,"right-handed",3,0,0,3,1
0.051,"bantamweight",17,"right-handed",7,0,1,8,0.9375
0.051,"light heavyweight",18,"right-handed",7,0,0,7,1
0.051,"super lightweight",15,"right-handed",1,0,0,1,1
0.051,"light heavyweight",11,"right-handed",2,0,0,2,1
0.051,"welterweight",13,"right-handed",7,0,1,8,0.9375
0.051,"super featherweight",8,"right-handed",6,1,0,7,0.857142857142857
0.051,"light heavyweight",13,"right-handed",2,0,0,2,1
0.051,"heavyweight",12,"right-handed",2,0,0,2,1
0.051,"middleweight",12,"right-handed",7,0,0,7,1
0.051,"super bantamweight",10,"right-handed",6,2,1,9,0.722222222222222
0.051,"super welterweight",16,"right-handed",7,1,0,8,0.875
0.051,"cruiserweight",18,"right-handed",6,0,0,6,1
0.051,"cruiserweight",9,"right-handed",13,10,0,23,0.565217391304348
0.051,"super welterweight",11,"right-handed",6,0,0,6,1
0.051,"middleweight",21,"right-handed",6,0,0,6,1
0.051,"bantamweight",7,"right-handed",4,0,1,5,0.9
0.051,"middleweight",6,"right-handed",6,0,0,6,1
0.051,"super featherweight",7,"right-handed",3,1,0,4,0.75
0.051,"featherweight",11,"right-handed",8,2,0,10,0.8
0.051,"lightweight",13,"right-handed",7,2,0,9,0.777777777777778
0.051,"super welterweight",5,"right-handed",6,0,0,6,1
0.051,"super welterweight",15,"right-handed",6,0,0,6,1
0.051,"lightweight",7,"right-handed",1,0,0,1,1
0.051,"super featherweight",7,"right-handed",6,0,0,6,1
0.051,"super featherweight",13,"right-handed",6,2,3,11,0.681818181818182
0.051,"super welterweight",8,"right-handed",7,0,0,7,1
0.051,"super welterweight",12,"right-handed",6,0,0,6,1
0.051,"super featherweight",6,"right-handed",7,0,0,7,1
0.051,"super lightweight",8,"right-handed",6,0,0,6,1
0.051,"super featherweight",19,"right-handed",4,2,0,6,0.666666666666667
0.051,"heavyweight",17,"right-handed",2,0,0,2,1
0.051,"super lightweight",16,"right-handed",6,1,1,8,0.8125
0.051,"welterweight",14,"right-handed",7,0,1,8,0.9375
0.05,"super welterweight",8,"right-handed",4,0,0,4,1
0.05,"super lightweight",7,"right-handed",5,0,0,5,1
0.05,"flyweight",12,"right-handed",5,1,0,6,0.833333333333333
0.05,"lightweight",15,"right-handed",5,0,0,5,1
0.05,"lightweight",10,"right-handed",5,2,0,7,0.714285714285714
0.05,"light heavyweight",21,"right-handed",4,0,1,5,0.9
0.05,"featherweight",11,"right-handed",4,1,0,5,0.8
0.05,"welterweight",10,"right-handed",4,4,0,8,0.5
0.05,"welterweight",10,"right-handed",3,0,0,3,1
0.05,"middleweight",10,"right-handed",5,5,2,12,0.5
0.05,"lightweight",9,"right-handed",4,0,1,5,0.9
0.05,"lightweight",4,"right-handed",5,1,1,7,0.785714285714286
0.05,"heavyweight",26,"right-handed",3,4,0,7,0.428571428571429
0.05,"flyweight",8,"right-handed",5,0,0,5,1
0.05,"super middleweight",12,"right-handed",5,0,0,5,1
0.05,"welterweight",6,"right-handed",5,0,0,5,1
0.05,"super bantamweight",11,"right-handed",3,0,1,4,0.875
0.05,"featherweight",6,"right-handed",6,1,0,7,0.857142857142857
0.05,"lightweight",16,"right-handed",1,0,0,1,1
0.05,"flyweight",7,"right-handed",6,8,4,18,0.444444444444444
0.05,"welterweight",9,"right-handed",2,0,0,2,1
0.05,"heavyweight",18,"right-handed",4,0,0,4,1
0.05,"welterweight",10,"right-handed",3,0,0,3,1
0.05,"lightweight",6,"right-handed",4,0,1,5,0.9
0.05,"welterweight",6,"right-handed",3,0,0,3,1
0.05,"super flyweight",5,"right-handed",4,1,2,7,0.714285714285714
0.05,"bantamweight",15,"right-handed",6,4,1,11,0.590909090909091
0.05,"welterweight",12,"right-handed",4,1,2,7,0.714285714285714
0.05,"bantamweight",12,"right-handed",4,0,1,5,0.9
0.05,"super welterweight",5,"right-handed",4,0,0,4,1
0.05,"featherweight",7,"right-handed",4,0,1,5,0.9
0.05,"super flyweight",19,"right-handed",5,0,0,5,1
0.05,"super lightweight",3,"right-handed",4,0,1,5,0.9
0.05,"middleweight",14,"right-handed",5,0,0,5,1
0.05,"super lightweight",12,"right-handed",5,1,0,6,0.833333333333333
0.05,"super lightweight",7,"right-handed",3,0,0,3,1
0.05,"super lightweight",12,"right-handed",4,4,1,9,0.5
0.05,"bantamweight",6,"right-handed",5,0,1,6,0.916666666666667
0.05,"super lightweight",11,"right-handed",5,2,0,7,0.714285714285714
0.05,"super flyweight",8,"right-handed",3,2,1,6,0.583333333333333
0.05,"super bantamweight",4,"right-handed",5,0,0,5,1
0.05,"super featherweight",24,"right-handed",5,0,1,6,0.916666666666667
0.05,"bantamweight",17,"right-handed",5,1,0,6,0.833333333333333
0.05,"heavyweight",10,"right-handed",6,2,0,8,0.75
0.05,"super featherweight",6,"right-handed",5,1,0,6,0.833333333333333
0.05,"heavyweight",16,"right-handed",5,0,0,5,1
0.05,"welterweight",10,"right-handed",2,0,0,2,1
0.05,"super bantamweight",6,"right-handed",5,0,0,5,1
0.05,"super welterweight",14,"right-handed",5,0,0,5,1
0.05,"super middleweight",12,"right-handed",2,0,0,2,1
0.05,"lightweight",15,"right-handed",4,1,1,6,0.75
0.05,"cruiserweight",30,"right-handed",8,6,0,14,0.571428571428571
0.05,"super welterweight",9,"right-handed",5,0,0,5,1
0.05,"light heavyweight",18,"right-handed",5,5,0,10,0.5
0.05,"welterweight",12,"right-handed",5,2,0,7,0.714285714285714
0.05,"middleweight",14,"right-handed",6,4,1,11,0.590909090909091
0.05,"cruiserweight",25,"right-handed",4,2,1,7,0.642857142857143
0.05,"lightweight",8,"right-handed",4,0,0,4,1
0.05,"super featherweight",13,"right-handed",5,2,0,7,0.714285714285714
0.05,"light heavyweight",15,"right-handed",5,1,0,6,0.833333333333333
0.05,"middleweight",8,"right-handed",2,0,0,2,1
0.05,"super bantamweight",8,"right-handed",5,0,0,5,1
0.05,"flyweight",5,"right-handed",5,0,0,5,1
0.05,"middleweight",12,"right-handed",6,2,0,8,0.75
0.05,"super featherweight",19,"right-handed",1,1,0,2,0.5
0.05,"heavyweight",24,"right-handed",4,1,2,7,0.714285714285714
0.05,"middleweight",25,"right-handed",3,0,0,3,1
0.05,"super bantamweight",14,"right-handed",3,1,0,4,0.75
0.05,"light heavyweight",20,"right-handed",3,0,0,3,1
0.05,"bantamweight",NA,"right-handed",4,0,0,4,1
0.05,"welterweight",9,"right-handed",3,0,0,3,1
0.05,"light flyweight",9,"right-handed",4,3,1,8,0.5625
0.05,"super welterweight",18,"right-handed",4,0,0,4,1
0.05,"super featherweight",14,"right-handed",3,1,0,4,0.75
0.05,"super bantamweight",13,"right-handed",3,0,0,3,1
0.05,"light heavyweight",10,"right-handed",3,2,1,6,0.583333333333333
0.05,"super welterweight",9,"right-handed",4,0,0,4,1
0.05,"featherweight",8,"right-handed",3,0,0,3,1
0.05,"lightweight",5,"right-handed",3,0,0,3,1
0.05,"super featherweight",14,"right-handed",3,1,0,4,0.75
0.05,"cruiserweight",19,"right-handed",4,0,0,4,1
0.05,"super middleweight",9,"right-handed",4,1,0,5,0.8
0.05,"middleweight",12,"right-handed",2,0,2,4,0.75
0.05,"heavyweight",11,"right-handed",4,0,0,4,1
0.05,"heavyweight",25,"right-handed",4,2,0,6,0.666666666666667
0.05,"middleweight",10,"right-handed",4,0,0,4,1
0.05,"super lightweight",8,"right-handed",4,0,0,4,1
0.05,"super bantamweight",5,"right-handed",4,1,0,5,0.8
0.05,"light heavyweight",15,"right-handed",3,0,0,3,1
0.05,"lightweight",13,"right-handed",3,0,0,3,1
0.05,"cruiserweight",11,"right-handed",4,0,0,4,1
0.05,"light flyweight",7,"right-handed",5,5,0,10,0.5
0.05,"minimumweight",NA,"right-handed",3,1,0,4,0.75
0.05,"super middleweight",13,"right-handed",3,0,0,3,1
0.05,"light flyweight",6,"right-handed",3,0,0,3,1
0.05,"light flyweight",3,"right-handed",4,0,0,4,1
0.05,"super lightweight",12,"right-handed",4,2,0,6,0.666666666666667
0.05,"cruiserweight",20,"right-handed",4,0,0,4,1
0.05,"lightweight",5,"right-handed",3,0,0,3,1
0.05,"super flyweight",8,"right-handed",4,0,0,4,1
0.05,"lightweight",12,"right-handed",3,4,0,7,0.428571428571429
0.05,"middleweight",23,"right-handed",4,0,0,4,1
0.05,"super middleweight",12,"right-handed",3,0,0,3,1
0.05,"super lightweight",8,"right-handed",3,0,0,3,1
0.05,"light flyweight",9,"right-handed",3,0,0,3,1
0.05,"super flyweight",NA,"right-handed",4,1,0,5,0.8
0.05,"welterweight",8,"right-handed",3,0,0,3,1
0.05,"featherweight",15,"right-handed",3,2,0,5,0.6
0.05,"middleweight",10,"right-handed",3,0,0,3,1
0.05,"cruiserweight",9,"right-handed",3,1,1,5,0.7
0.05,"featherweight",18,"right-handed",4,2,0,6,0.666666666666667
0.05,"light heavyweight",5,"right-handed",2,0,0,2,1
0.05,"super bantamweight",9,"right-handed",4,0,0,4,1
0.05,"super lightweight",12,"right-handed",3,1,0,4,0.75
0.05,"super lightweight",8,"right-handed",3,0,1,4,0.875
0.05,"cruiserweight",20,"right-handed",4,0,0,4,1
0.05,"lightweight",23,"right-handed",3,1,0,4,0.75
0.05,"super featherweight",6,"right-handed",3,0,0,3,1
0.05,"middleweight",14,"right-handed",4,0,0,4,1
0.05,"super featherweight",10,"right-handed",3,0,0,3,1
0.05,"featherweight",9,"right-handed",4,0,0,4,1
0.05,"super lightweight",12,"right-handed",3,5,0,8,0.375
0.05,"super lightweight",15,"right-handed",3,1,0,4,0.75
0.05,"lightweight",10,"right-handed",2,0,0,2,1
0.05,"flyweight",5,"right-handed",4,0,0,4,1
0.05,"super middleweight",14,"right-handed",3,0,0,3,1
0.05,"cruiserweight",7,"right-handed",3,0,0,3,1
0.05,"super middleweight",8,"right-handed",1,0,1,2,0.75
0.05,"flyweight",4,"right-handed",3,1,1,5,0.7
0.05,"super middleweight",11,"right-handed",4,0,0,4,1
0.05,"middleweight",18,"right-handed",3,1,0,4,0.75
0.05,"middleweight",24,"right-handed",4,4,1,9,0.5
0.05,"super middleweight",15,"right-handed",3,1,0,4,0.75
0.05,"welterweight",12,"right-handed",6,2,0,8,0.75
0.05,"bantamweight",5,"right-handed",4,0,0,4,1
0.05,"welterweight",14,"right-handed",3,1,0,4,0.75
0.05,"welterweight",12,"right-handed",4,0,1,5,0.9
0.05,"middleweight",21,"right-handed",3,5,1,9,0.388888888888889
0.05,"super featherweight",10,"right-handed",3,0,0,3,1
0.05,"welterweight",14,"right-handed",3,0,0,3,1
0.05,"super lightweight",21,"right-handed",4,2,0,6,0.666666666666667
0.05,"flyweight",4,"right-handed",3,0,2,5,0.8
0.05,"super bantamweight",18,"right-handed",3,1,2,6,0.666666666666667
0.05,"",5,"right-handed",3,0,0,3,1
0.05,"featherweight",6,"right-handed",2,0,2,4,0.75
0.05,"lightweight",7,"right-handed",3,1,0,4,0.75
0.05,"welterweight",NA,"right-handed",4,3,0,7,0.571428571428571
0.05,"light flyweight",16,"right-handed",4,3,0,7,0.571428571428571
0.05,"super middleweight",13,"right-handed",2,0,0,2,1
0.05,"welterweight",5,"right-handed",3,0,0,3,1
0.05,"featherweight",7,"right-handed",3,0,0,3,1
0.05,"heavyweight",24,"right-handed",3,0,0,3,1
0.05,"heavyweight",22,"right-handed",2,1,2,5,0.6
0.05,"super lightweight",5,"right-handed",2,0,0,2,1
0.05,"super welterweight",7,"right-handed",3,1,0,4,0.75
0.05,"super welterweight",19,"right-handed",3,0,0,3,1
0.05,"light flyweight",5,"right-handed",3,1,0,4,0.75
0.05,"super featherweight",6,"right-handed",3,0,0,3,1
0.05,"super welterweight",8,"right-handed",3,0,0,3,1
0.05,"middleweight",NA,"right-handed",4,1,0,5,0.8
0.05,"cruiserweight",14,"right-handed",3,0,0,3,1
0.05,"featherweight",6,"right-handed",3,0,0,3,1
0.05,"lightweight",15,"right-handed",3,0,0,3,1
0.05,"cruiserweight",11,"right-handed",3,0,0,3,1
0.05,"flyweight",6,"right-handed",3,0,0,3,1
0.05,"light heavyweight",20,"right-handed",3,0,0,3,1
0.05,"super bantamweight",10,"right-handed",4,2,0,6,0.666666666666667
0.05,"featherweight",7,"right-handed",4,1,0,5,0.8
0.05,"super middleweight",17,"right-handed",3,1,0,4,0.75
0.05,"super bantamweight",8,"right-handed",2,0,0,2,1
0.05,"welterweight",12,"right-handed",3,0,0,3,1
0.05,"welterweight",13,"right-handed",2,3,1,6,0.416666666666667
0.05,"super middleweight",7,"right-handed",4,2,0,6,0.666666666666667
0.05,"cruiserweight",26,"right-handed",3,0,0,3,1
0.05,"welterweight",10,"right-handed",4,0,0,4,1
0.05,"super bantamweight",6,"right-handed",3,1,0,4,0.75
0.05,"super welterweight",14,"right-handed",4,0,0,4,1
0.05,"welterweight",17,"right-handed",4,1,0,5,0.8
0.05,"super flyweight",7,"right-handed",4,0,0,4,1
0.05,"super welterweight",12,"right-handed",3,0,1,4,0.875
0.05,"light heavyweight",13,"right-handed",3,0,0,3,1
0.05,"middleweight",8,"right-handed",3,2,1,6,0.583333333333333
0.05,"super flyweight",7,"right-handed",4,1,1,6,0.75
0.05,"heavyweight",21,"right-handed",3,3,0,6,0.5
0.05,"super middleweight",7,"right-handed",2,0,1,3,0.833333333333333
0.05,"welterweight",17,"right-handed",3,0,1,4,0.875
0.05,"featherweight",12,"right-handed",3,3,0,6,0.5
0.05,"heavyweight",21,"right-handed",5,6,0,11,0.454545454545455
0.05,"light flyweight",9,"right-handed",4,0,0,4,1
0.05,"super middleweight",14,"right-handed",4,0,0,4,1
0.05,"light heavyweight",15,"right-handed",4,0,0,4,1
0.05,"super featherweight",10,"right-handed",3,1,0,4,0.75
0.05,"super featherweight",4,"right-handed",3,0,0,3,1
0.05,"super lightweight",9,"right-handed",4,0,0,4,1
0.05,"",6,"right-handed",4,0,0,4,1
0.05,"featherweight",14,"right-handed",4,0,0,4,1
0.05,"super flyweight",8,"right-handed",3,0,0,3,1
0.05,"super middleweight",12,"right-handed",3,1,0,4,0.75
0.05,"super flyweight",9,"right-handed",3,0,0,3,1
0.05,"lightweight",2,"right-handed",3,0,0,3,1
0.05,"light heavyweight",9,"right-handed",3,0,2,5,0.8
0.05,"super bantamweight",6,"right-handed",3,1,0,4,0.75
0.05,"super featherweight",8,"right-handed",3,1,2,6,0.666666666666667
0.05,"super lightweight",13,"right-handed",4,0,0,4,1
0.05,"lightweight",3,"right-handed",3,0,0,3,1
0.05,"super featherweight",14,"right-handed",3,0,0,3,1
0.05,"light heavyweight",5,"right-handed",3,0,0,3,1
0.05,"lightweight",15,"right-handed",3,2,0,5,0.6
0.05,"light heavyweight",7,"right-handed",3,0,0,3,1
0.05,"super welterweight",7,"right-handed",4,1,0,5,0.8
0.05,"bantamweight",7,"right-handed",3,2,0,5,0.6
0.05,"super middleweight",7,"right-handed",4,1,0,5,0.8
0.05,"super bantamweight",5,"right-handed",3,0,2,5,0.8
0.05,"super bantamweight",7,"right-handed",3,1,1,5,0.7
0.05,"super bantamweight",7,"right-handed",3,0,0,3,1
0.05,"super welterweight",10,"right-handed",3,0,0,3,1
0.05,"middleweight",11,"right-handed",3,0,0,3,1
0.05,"super flyweight",5,"right-handed",3,0,1,4,0.875
0.05,"heavyweight",13,"right-handed",4,0,0,4,1
0.05,"light heavyweight",5,"right-handed",3,0,0,3,1
0.05,"featherweight",12,"right-handed",3,0,0,3,1
0.05,"",12,"right-handed",4,0,0,4,1
0.05,"lightweight",8,"right-handed",1,0,0,1,1
0.05,"super flyweight",6,"right-handed",3,0,2,5,0.8
0.05,"middleweight",11,"right-handed",3,0,0,3,1
0.05,"bantamweight",6,"right-handed",3,0,0,3,1
0.05,"welterweight",6,"right-handed",3,0,0,3,1
0.05,"super middleweight",12,"right-handed",3,0,0,3,1
0.05,"middleweight",14,"right-handed",4,0,0,4,1
0.05,"super middleweight",11,"right-handed",3,0,0,3,1
0.05,"cruiserweight",11,"right-handed",3,1,1,5,0.7
0.05,"cruiserweight",25,"right-handed",3,1,0,4,0.75
0.05,"super featherweight",8,"right-handed",3,1,0,4,0.75
0.05,"super bantamweight",22,"right-handed",2,1,2,5,0.6
0.05,"super featherweight",5,"right-handed",4,0,0,4,1
0.05,"super lightweight",12,"right-handed",3,1,0,4,0.75
0.05,"featherweight",12,"right-handed",4,2,0,6,0.666666666666667
0.05,"super welterweight",NA,"right-handed",2,1,0,3,0.666666666666667
0.05,"super featherweight",18,"right-handed",2,0,0,2,1
0.05,"super featherweight",NA,"right-handed",2,0,0,2,1
0.05,"heavyweight",14,"right-handed",2,0,0,2,1
0.05,"super lightweight",8,"right-handed",2,1,0,3,0.666666666666667
0.05,"welterweight",11,"right-handed",2,1,0,3,0.666666666666667
0.05,"light flyweight",NA,"right-handed",2,0,0,2,1
0.05,"featherweight",9,"right-handed",2,0,0,2,1
0.05,"super bantamweight",NA,"right-handed",2,0,1,3,0.833333333333333
0.05,"super welterweight",14,"right-handed",2,0,0,2,1
0.05,"super featherweight",9,"right-handed",3,1,0,4,0.75
0.05,"middleweight",6,"right-handed",2,0,0,2,1
0.05,"lightweight",16,"right-handed",2,4,0,6,0.333333333333333
0.05,"super middleweight",6,"right-handed",2,0,0,2,1
0.05,"super flyweight",5,"right-handed",2,0,0,2,1
0.05,"light heavyweight",NA,"right-handed",2,0,0,2,1
0.05,"super middleweight",12,"right-handed",3,2,0,5,0.6
0.05,"featherweight",6,"right-handed",2,0,0,2,1
0.05,"lightweight",8,"right-handed",2,0,0,2,1
0.05,"super bantamweight",5,"right-handed",2,0,0,2,1
0.05,"light heavyweight",10,"right-handed",2,0,0,2,1
0.05,"welterweight",10,"right-handed",2,0,0,2,1
0.05,"lightweight",5,"right-handed",2,0,0,2,1
0.05,"middleweight",11,"right-handed",2,0,0,2,1
0.05,"featherweight",4,"right-handed",2,0,0,2,1
0.05,"",NA,"right-handed",2,0,1,3,0.833333333333333
0.05,"super middleweight",NA,"right-handed",2,1,0,3,0.666666666666667
0.05,"heavyweight",NA,"right-handed",2,0,0,2,1
0.05,"super flyweight",14,"right-handed",2,0,0,2,1
0.05,"lightweight",11,"right-handed",2,0,0,2,1
0.05,"lightweight",27,"right-handed",3,3,0,6,0.5
0.05,"super lightweight",5,"right-handed",2,0,0,2,1
0.05,"super welterweight",3,"right-handed",2,0,0,2,1
0.05,"heavyweight",NA,"right-handed",3,1,0,4,0.75
0.05,"super welterweight",18,"right-handed",1,0,1,2,0.75
0.05,"heavyweight",32,"right-handed",2,5,1,8,0.3125
0.05,"heavyweight",16,"right-handed",2,0,1,3,0.833333333333333
0.05,"middleweight",8,"right-handed",0,0,1,1,0.5
0.05,"lightweight",13,"right-handed",2,0,0,2,1
0.05,"heavyweight",9,"right-handed",2,0,0,2,1
0.05,"welterweight",10,"right-handed",2,0,0,2,1
0.05,"middleweight",6,"right-handed",2,0,0,2,1
0.05,"super featherweight",13,"right-handed",2,0,0,2,1
0.05,"heavyweight",21,"right-handed",2,1,0,3,0.666666666666667
0.05,"featherweight",11,"right-handed",2,6,0,8,0.25
0.05,"super lightweight",14,"right-handed",2,1,0,3,0.666666666666667
0.05,"super middleweight",17,"right-handed",2,0,0,2,1
0.05,"welterweight",16,"right-handed",2,0,0,2,1
0.05,"featherweight",NA,"right-handed",2,0,0,2,1
0.05,"super lightweight",10,"right-handed",2,1,0,3,0.666666666666667
0.05,"light heavyweight",31,"right-handed",3,4,0,7,0.428571428571429
0.05,"welterweight",15,"right-handed",4,5,1,10,0.45
0.05,"minimumweight",6,"right-handed",2,0,1,3,0.833333333333333
0.05,"super lightweight",10,"right-handed",2,0,0,2,1
0.05,"featherweight",6,"right-handed",2,0,0,2,1
0.05,"light flyweight",NA,"right-handed",2,1,1,4,0.625
0.05,"super bantamweight",9,"right-handed",2,3,1,6,0.416666666666667
0.05,"super bantamweight",6,"right-handed",1,0,0,1,1
0.05,"super welterweight",NA,"right-handed",2,0,0,2,1
0.05,"light heavyweight",20,"right-handed",2,0,0,2,1
0.05,"lightweight",11,"right-handed",2,0,0,2,1
0.05,"super lightweight",4,"right-handed",2,0,0,2,1
0.05,"super lightweight",17,"right-handed",2,0,0,2,1
0.05,"welterweight",4,"right-handed",2,0,0,2,1
0.05,"lightweight",9,"right-handed",2,0,0,2,1
0.05,"bantamweight",10,"right-handed",2,1,1,4,0.625
0.05,"welterweight",14,"right-handed",2,3,0,5,0.4
0.05,"super lightweight",15,"right-handed",2,1,0,3,0.666666666666667
0.05,"bantamweight",6,"right-handed",2,4,2,8,0.375
0.05,"super featherweight",4,"right-handed",2,0,0,2,1
0.05,"featherweight",4,"right-handed",2,0,1,3,0.833333333333333
0.05,"lightweight",NA,"right-handed",1,0,0,1,1
0.05,"featherweight",NA,"right-handed",2,3,0,5,0.4
0.05,"lightweight",8,"right-handed",2,0,0,2,1
0.05,"welterweight",9,"right-handed",2,0,0,2,1
0.05,"featherweight",6,"right-handed",2,0,0,2,1
0.05,"super middleweight",10,"right-handed",2,0,0,2,1
0.05,"super flyweight",7,"right-handed",2,0,0,2,1
0.05,"featherweight",6,"right-handed",2,0,0,2,1
0.05,"super featherweight",8,"right-handed",2,0,0,2,1
0.05,"middleweight",9,"right-handed",1,1,2,4,0.5
0.05,"lightweight",20,"right-handed",2,0,0,2,1
0.05,"welterweight",5,"right-handed",2,0,0,2,1
0.05,"middleweight",9,"right-handed",2,0,0,2,1
0.05,"welterweight",5,"right-handed",2,0,0,2,1
0.05,"light heavyweight",17,"right-handed",2,1,0,3,0.666666666666667
0.05,"super welterweight",12,"right-handed",2,0,1,3,0.833333333333333
0.05,"super bantamweight",8,"right-handed",2,0,0,2,1
0.05,"heavyweight",12,"right-handed",2,0,0,2,1
0.05,"super lightweight",13,"right-handed",2,0,0,2,1
0.05,"cruiserweight",15,"right-handed",2,0,0,2,1
0.05,"super lightweight",5,"right-handed",2,0,0,2,1
0.05,"",13,"right-handed",2,0,0,2,1
0.05,"super featherweight",8,"right-handed",2,1,0,3,0.666666666666667
0.05,"cruiserweight",16,"right-handed",2,0,0,2,1
0.05,"minimumweight",9,"right-handed",2,0,0,2,1
0.05,"heavyweight",14,"right-handed",2,0,0,2,1
0.05,"heavyweight",25,"right-handed",3,4,0,7,0.428571428571429
0.05,"minimumweight",4,"right-handed",2,0,0,2,1
0.05,"heavyweight",9,"right-handed",4,9,0,13,0.307692307692308
0.05,"super flyweight",5,"right-handed",2,0,0,2,1
0.05,"super lightweight",5,"right-handed",2,0,0,2,1
0.05,"super welterweight",8,"right-handed",2,0,0,2,1
0.05,"super middleweight",8,"right-handed",2,0,0,2,1
0.05,"lightweight",15,"right-handed",2,0,0,2,1
0.05,"heavyweight",NA,"right-handed",2,1,0,3,0.666666666666667
0.05,"cruiserweight",13,"right-handed",2,0,0,2,1
0.05,"super flyweight",8,"right-handed",2,0,0,2,1
0.05,"super featherweight",6,"right-handed",2,0,0,2,1
0.05,"light heavyweight",11,"right-handed",4,12,0,16,0.25
0.05,"super welterweight",22,"right-handed",2,0,0,2,1
0.05,"super middleweight",20,"right-handed",2,0,0,2,1
0.05,"light flyweight",4,"right-handed",2,0,0,2,1
0.05,"super bantamweight",4,"right-handed",2,0,0,2,1
0.05,"super bantamweight",19,"right-handed",2,0,0,2,1
0.05,"super lightweight",7,"right-handed",2,0,0,2,1
0.05,"welterweight",6,"right-handed",2,0,1,3,0.833333333333333
0.05,"super lightweight",9,"right-handed",3,3,0,6,0.5
0.05,"super lightweight",10,"right-handed",2,0,0,2,1
0.05,"super featherweight",5,"right-handed",2,0,0,2,1
0.05,"super lightweight",15,"right-handed",2,1,0,3,0.666666666666667
0.05,"super flyweight",7,"right-handed",2,0,0,2,1
0.05,"super flyweight",NA,"right-handed",1,0,2,3,0.666666666666667
0.05,"featherweight",9,"right-handed",2,0,0,2,1
0.05,"welterweight",9,"right-handed",2,0,1,3,0.833333333333333
0.05,"super welterweight",5,"right-handed",2,0,0,2,1
0.05,"middleweight",19,"right-handed",2,0,1,3,0.833333333333333
0.05,"welterweight",7,"right-handed",2,0,0,2,1
0.05,"welterweight",17,"right-handed",3,5,0,8,0.375
0.05,"super flyweight",5,"right-handed",2,0,1,3,0.833333333333333
0.05,"super bantamweight",4,"right-handed",2,0,1,3,0.833333333333333
0.05,"super bantamweight",4,"right-handed",2,1,0,3,0.666666666666667
0.05,"lightweight",8,"right-handed",2,0,0,2,1
0.05,"featherweight",18,"right-handed",2,0,0,2,1
0.05,"light flyweight",NA,"right-handed",2,1,1,4,0.625
0.05,"light heavyweight",NA,"right-handed",2,0,0,2,1
0.05,"super bantamweight",13,"right-handed",3,16,0,19,0.157894736842105
0.05,"bantamweight",6,"right-handed",2,0,0,2,1
0.05,"middleweight",39,"right-handed",1,0,2,3,0.666666666666667
0.05,"cruiserweight",11,"right-handed",4,13,0,17,0.235294117647059
0.05,"lightweight",11,"right-handed",2,0,0,2,1
0.05,"middleweight",8,"right-handed",2,1,1,4,0.625
0.05,"super featherweight",22,"right-handed",4,7,0,11,0.363636363636364
0.05,"featherweight",7,"right-handed",2,0,0,2,1
0.05,"super flyweight",11,"right-handed",3,9,0,12,0.25
0.05,"super featherweight",14,"right-handed",3,1,0,4,0.75
0.05,"super featherweight",18,"right-handed",2,0,0,2,1
0.05,"middleweight",4,"right-handed",2,0,0,2,1
0.05,"super featherweight",11,"right-handed",2,0,0,2,1
0.05,"heavyweight",8,"right-handed",2,0,0,2,1
0.05,"super lightweight",5,"right-handed",2,0,0,2,1
0.05,"lightweight",12,"right-handed",2,0,0,2,1
0.05,"super featherweight",22,"right-handed",1,0,1,2,0.75
0.05,"middleweight",9,"right-handed",2,0,0,2,1
0.05,"flyweight",NA,"right-handed",2,0,0,2,1
0.05,"super bantamweight",4,"right-handed",2,0,0,2,1
0.05,"lightweight",14,"right-handed",2,1,1,4,0.625
0.05,"lightweight",12,"right-handed",2,0,1,3,0.833333333333333
0.05,"lightweight",8,"right-handed",2,0,0,2,1
0.05,"super lightweight",9,"right-handed",2,0,0,2,1
0.05,"featherweight",9,"right-handed",2,2,0,4,0.5
0.05,"super bantamweight",8,"right-handed",2,3,1,6,0.416666666666667
0.05,"super middleweight",26,"right-handed",2,0,0,2,1
0.05,"heavyweight",12,"right-handed",2,0,0,2,1
0.05,"featherweight",4,"right-handed",2,0,0,2,1
0.05,"super welterweight",NA,"right-handed",3,2,0,5,0.6
0.05,"super lightweight",13,"right-handed",2,0,0,2,1
0.05,"super featherweight",8,"right-handed",2,0,1,3,0.833333333333333
0.05,"cruiserweight",6,"right-handed",2,0,0,2,1
0.05,"super middleweight",11,"right-handed",2,0,0,2,1
0.05,"featherweight",7,"right-handed",2,0,0,2,1
0.05,"super featherweight",NA,"right-handed",2,0,0,2,1
0.05,"light heavyweight",13,"right-handed",2,0,0,2,1
0.05,"bantamweight",8,"right-handed",2,0,0,2,1
0.05,"super bantamweight",4,"right-handed",2,0,0,2,1
0.05,"heavyweight",12,"right-handed",3,1,0,4,0.75
0.05,"super welterweight",9,"right-handed",2,0,0,2,1
0.05,"super welterweight",10,"right-handed",2,0,0,2,1
0.05,"cruiserweight",15,"right-handed",2,5,0,7,0.285714285714286
0.05,"super middleweight",10,"right-handed",2,0,0,2,1
0.05,"middleweight",15,"right-handed",2,0,0,2,1
0.05,"super lightweight",11,"right-handed",2,0,1,3,0.833333333333333
0.05,"super middleweight",5,"right-handed",2,0,0,2,1
0.05,"cruiserweight",11,"right-handed",2,0,1,3,0.833333333333333
0.05,"super bantamweight",5,"right-handed",3,1,0,4,0.75
0.05,"lightweight",7,"right-handed",2,0,0,2,1
0.05,"bantamweight",NA,"right-handed",2,0,0,2,1
0.05,"light flyweight",6,"right-handed",2,0,0,2,1
0.05,"super flyweight",7,"right-handed",2,0,1,3,0.833333333333333
0.05,"super featherweight",9,"right-handed",2,0,0,2,1
0.05,"super flyweight",8,"right-handed",2,2,0,4,0.5
0.05,"bantamweight",6,"right-handed",2,0,0,2,1
0.05,"light flyweight",7,"right-handed",2,1,0,3,0.666666666666667
0.05,"lightweight",7,"right-handed",2,0,0,2,1
0.05,"heavyweight",NA,"right-handed",2,1,0,3,0.666666666666667
0.05,"lightweight",11,"right-handed",3,1,0,4,0.75
0.05,"lightweight",8,"right-handed",2,0,0,2,1
0.05,"welterweight",NA,"right-handed",2,0,0,2,1
0.05,"lightweight",4,"right-handed",2,0,1,3,0.833333333333333
0.05,"middleweight",NA,"right-handed",2,0,0,2,1
0.05,"lightweight",3,"right-handed",2,0,0,2,1
0.05,"heavyweight",NA,"right-handed",2,0,0,2,1
0.05,"lightweight",10,"right-handed",2,0,0,2,1
0.05,"cruiserweight",NA,"right-handed",2,0,0,2,1
0.05,"super lightweight",10,"right-handed",2,0,0,2,1
0.05,"bantamweight",18,"right-handed",2,0,0,2,1
0.05,"welterweight",16,"right-handed",2,2,0,4,0.5
0.05,"welterweight",8,"right-handed",2,0,0,2,1
0.05,"middleweight",4,"right-handed",2,0,0,2,1
0.05,"lightweight",5,"right-handed",2,1,0,3,0.666666666666667
0.05,"lightweight",5,"right-handed",1,0,2,3,0.666666666666667
0.05,"super featherweight",18,"right-handed",5,7,4,16,0.4375
0.05,"super flyweight",5,"right-handed",2,0,0,2,1
0.05,"bantamweight",4,"right-handed",2,0,0,2,1
0.05,"flyweight",8,"right-handed",2,1,1,4,0.625
0.05,"super flyweight",NA,"right-handed",2,0,0,2,1
0.05,"heavyweight",10,"right-handed",1,0,0,1,1
0.05,"cruiserweight",8,"right-handed",1,0,0,1,1
0.05,"super lightweight",8,"right-handed",0,0,1,1,0.5
0.05,"lightweight",7,"right-handed",1,0,0,1,1
0.05,"super featherweight",11,"right-handed",1,0,0,1,1
0.05,"super middleweight",13,"right-handed",1,0,0,1,1
0.05,"cruiserweight",17,"right-handed",1,0,0,1,1
0.05,"super lightweight",9,"right-handed",1,0,0,1,1
0.05,"heavyweight",14,"right-handed",1,0,0,1,1
0.05,"super bantamweight",5,"right-handed",1,1,0,2,0.5
0.05,"bantamweight",11,"right-handed",1,3,0,4,0.25
0.05,"super lightweight",17,"right-handed",1,0,1,2,0.75
0.05,"lightweight",12,"right-handed",1,0,0,1,1
0.05,"super lightweight",6,"right-handed",1,0,0,1,1
0.05,"featherweight",9,"right-handed",2,1,0,3,0.666666666666667
0.05,"bantamweight",4,"right-handed",1,0,1,2,0.75
0.05,"minimumweight",5,"right-handed",1,0,0,1,1
0.05,"super featherweight",NA,"right-handed",1,0,0,1,1
0.05,"cruiserweight",8,"right-handed",1,0,0,1,1
0.05,"welterweight",14,"right-handed",1,0,0,1,1
0.05,"welterweight",11,"right-handed",1,0,0,1,1
0.05,"welterweight",12,"right-handed",1,0,0,1,1
0.05,"lightweight",10,"right-handed",1,0,0,1,1
0.05,"super welterweight",18,"right-handed",1,1,0,2,0.5
0.05,"welterweight",7,"right-handed",1,0,1,2,0.75
0.05,"middleweight",13,"right-handed",1,0,0,1,1
0.05,"super middleweight",21,"right-handed",1,0,0,1,1
0.05,"heavyweight",14,"right-handed",1,0,0,1,1
0.05,"welterweight",5,"right-handed",1,0,0,1,1
0.05,"light heavyweight",12,"right-handed",1,0,0,1,1
0.05,"light flyweight",9,"right-handed",1,0,0,1,1
0.05,"lightweight",NA,"right-handed",1,0,0,1,1
0.05,"welterweight",17,"right-handed",6,2,0,8,0.75
0.05,"super middleweight",10,"right-handed",1,0,0,1,1
0.05,"super lightweight",6,"right-handed",1,0,0,1,1
0.05,"super welterweight",8,"right-handed",11,8,0,19,0.578947368421053
0.05,"super bantamweight",7,"right-handed",1,0,0,1,1
0.05,"super flyweight",8,"right-handed",1,0,0,1,1
0.05,"bantamweight",5,"right-handed",1,1,0,2,0.5
0.05,"lightweight",19,"right-handed",0,0,1,1,0.5
0.05,"super bantamweight",NA,"right-handed",0,0,1,1,0.5
0.05,"super bantamweight",NA,"right-handed",1,1,0,2,0.5
0.05,"super lightweight",7,"right-handed",1,0,0,1,1
0.05,"light heavyweight",19,"right-handed",0,0,1,1,0.5
0.05,"lightweight",19,"right-handed",1,1,0,2,0.5
0.05,"middleweight",13,"right-handed",1,0,0,1,1
0.05,"heavyweight",24,"right-handed",1,0,0,1,1
0.05,"super lightweight",9,"right-handed",1,0,1,2,0.75
0.05,"featherweight",3,"right-handed",1,0,0,1,1
0.05,"bantamweight",NA,"right-handed",1,1,0,2,0.5
0.05,"welterweight",6,"right-handed",1,0,0,1,1
0.05,"light heavyweight",17,"right-handed",1,0,0,1,1
0.05,"cruiserweight",12,"right-handed",1,0,0,1,1
0.05,"featherweight",8,"right-handed",1,0,0,1,1
0.05,"welterweight",NA,"right-handed",1,1,0,2,0.5
0.05,"featherweight",7,"right-handed",1,0,0,1,1
0.05,"",NA,"right-handed",1,0,0,1,1
0.05,"super featherweight",NA,"right-handed",1,0,0,1,1
0.05,"heavyweight",10,"right-handed",1,0,0,1,1
0.05,"middleweight",23,"right-handed",1,0,0,1,1
0.05,"super featherweight",3,"right-handed",1,1,0,2,0.5
0.05,"lightweight",9,"right-handed",1,0,0,1,1
0.05,"super lightweight",9,"right-handed",1,0,0,1,1
0.05,"flyweight",16,"right-handed",1,1,0,2,0.5
0.05,"welterweight",6,"right-handed",1,0,0,1,1
0.05,"super middleweight",5,"right-handed",1,0,0,1,1
0.05,"middleweight",13,"right-handed",1,0,0,1,1
0.05,"super middleweight",14,"right-handed",1,0,0,1,1
0.05,"light heavyweight",5,"right-handed",1,0,0,1,1
0.05,"lightweight",NA,"right-handed",1,0,0,1,1
0.05,"lightweight",19,"right-handed",1,0,0,1,1
0.05,"bantamweight",12,"right-handed",1,0,1,2,0.75
0.05,"super bantamweight",4,"right-handed",1,0,0,1,1
0.05,"welterweight",8,"right-handed",1,0,0,1,1
0.05,"flyweight",12,"right-handed",1,0,0,1,1
0.05,"super lightweight",15,"right-handed",1,0,0,1,1
0.05,"welterweight",8,"right-handed",6,15,0,21,0.285714285714286
0.05,"lightweight",5,"right-handed",1,2,0,3,0.333333333333333
0.05,"lightweight",6,"right-handed",1,0,0,1,1
0.05,"lightweight",7,"right-handed",1,0,0,1,1
0.05,"super lightweight",8,"right-handed",1,0,0,1,1
0.05,"super featherweight",9,"right-handed",1,1,0,2,0.5
0.05,"featherweight",4,"right-handed",1,0,0,1,1
0.05,"flyweight",NA,"right-handed",1,0,0,1,1
0.05,"minimumweight",9,"right-handed",1,0,0,1,1
0.05,"lightweight",6,"right-handed",1,0,0,1,1
0.05,"lightweight",5,"right-handed",1,0,1,2,0.75
0.05,"super welterweight",34,"right-handed",0,0,1,1,0.5
0.05,"welterweight",10,"right-handed",1,0,0,1,1
0.05,"super bantamweight",8,"right-handed",0,0,1,1,0.5
0.05,"welterweight",15,"right-handed",1,0,0,1,1
0.05,"light flyweight",4,"right-handed",0,0,1,1,0.5
0.05,"welterweight",8,"right-handed",1,0,0,1,1
0.05,"super welterweight",5,"right-handed",1,0,0,1,1
0.05,"",6,"right-handed",1,0,0,1,1
0.05,"cruiserweight",15,"right-handed",1,0,0,1,1
0.05,"super middleweight",8,"right-handed",1,0,0,1,1
0.05,"minimumweight",NA,"right-handed",1,0,0,1,1
0.05,"super middleweight",13,"right-handed",1,0,0,1,1
0.05,"lightweight",7,"right-handed",1,0,0,1,1
0.05,"super flyweight",NA,"right-handed",1,0,0,1,1
0.05,"bantamweight",8,"right-handed",0,0,1,1,0.5
0.05,"super middleweight",13,"right-handed",1,1,0,2,0.5
0.05,"lightweight",6,"right-handed",1,0,1,2,0.75
0.05,"super featherweight",13,"right-handed",0,0,1,1,0.5
0.05,"minimumweight",5,"right-handed",1,0,1,2,0.75
0.05,"minimumweight",9,"right-handed",1,0,0,1,1
0.05,"super featherweight",NA,"right-handed",1,0,0,1,1
0.05,"super bantamweight",2,"right-handed",1,0,1,2,0.75
0.05,"heavyweight",22,"right-handed",1,0,0,1,1
0.05,"super lightweight",8,"right-handed",1,0,0,1,1
0.05,"super lightweight",19,"right-handed",3,3,1,7,0.5
0.05,"super featherweight",13,"right-handed",2,12,0,14,0.142857142857143
0.05,"featherweight",5,"right-handed",1,0,0,1,1
0.05,"lightweight",10,"right-handed",1,0,0,1,1
0.05,"super middleweight",13,"right-handed",1,0,0,1,1
0.05,"heavyweight",12,"right-handed",1,0,0,1,1
0.05,"cruiserweight",17,"right-handed",1,0,0,1,1
0.05,"welterweight",21,"right-handed",3,3,1,7,0.5
0.05,"super middleweight",8,"right-handed",1,0,0,1,1
0.05,"cruiserweight",11,"right-handed",1,0,0,1,1
0.05,"super middleweight",16,"right-handed",1,0,0,1,1
0.05,"bantamweight",4,"right-handed",1,0,0,1,1
0.05,"lightweight",7,"right-handed",1,0,0,1,1
0.05,"super bantamweight",8,"right-handed",1,0,0,1,1
0.05,"bantamweight",6,"right-handed",1,2,0,3,0.333333333333333
0.05,"cruiserweight",10,"right-handed",10,12,0,22,0.454545454545455
0.05,"light flyweight",9,"right-handed",1,0,0,1,1
0.05,"light heavyweight",NA,"right-handed",1,0,0,1,1
0.05,"super welterweight",15,"right-handed",1,0,0,1,1
0.05,"cruiserweight",5,"right-handed",1,1,0,2,0.5
0.05,"flyweight",11,"right-handed",1,0,0,1,1
0.05,"bantamweight",NA,"right-handed",0,0,1,1,0.5
0.05,"light heavyweight",11,"right-handed",1,0,0,1,1
0.05,"heavyweight",17,"right-handed",1,0,0,1,1
0.05,"super middleweight",11,"right-handed",1,0,0,1,1
0.05,"flyweight",6,"right-handed",1,0,0,1,1
0.05,"super featherweight",18,"right-handed",0,0,1,1,0.5
0.05,"lightweight",7,"right-handed",1,0,0,1,1
0.05,"middleweight",3,"right-handed",0,0,1,1,0.5
0.05,"featherweight",7,"right-handed",0,0,1,1,0.5
0.05,"featherweight",6,"right-handed",1,0,0,1,1
0.05,"super welterweight",8,"right-handed",1,0,0,1,1
0.05,"super featherweight",7,"right-handed",1,2,0,3,0.333333333333333
0.05,"super bantamweight",6,"right-handed",0,0,1,1,0.5
0.05,"super welterweight",26,"right-handed",0,0,1,1,0.5
0.05,"welterweight",10,"right-handed",0,0,1,1,0.5
0.05,"welterweight",9,"right-handed",0,0,1,1,0.5
0.05,"featherweight",3,"right-handed",0,0,2,2,0.5
0.05,"heavyweight",15,"right-handed",1,0,0,1,1
0.05,"lightweight",14,"right-handed",1,0,0,1,1
0.05,"super bantamweight",10,"right-handed",1,0,0,1,1
0.05,"featherweight",9,"right-handed",1,0,0,1,1
0.05,"super bantamweight",4,"right-handed",1,0,0,1,1
0.05,"heavyweight",22,"right-handed",1,0,0,1,1
0.05,"light heavyweight",11,"right-handed",1,0,0,1,1
0.05,"featherweight",6,"right-handed",1,0,0,1,1
0.05,"middleweight",10,"right-handed",1,3,0,4,0.25
0.05,"lightweight",4,"right-handed",1,0,0,1,1
0.05,"light flyweight",21,"right-handed",1,0,1,2,0.75
0.05,"super flyweight",8,"right-handed",1,1,0,2,0.5
0.05,"super bantamweight",8,"right-handed",1,0,0,1,1
0.05,"super lightweight",7,"right-handed",1,0,0,1,1
0.05,"featherweight",8,"right-handed",1,1,1,3,0.5
0.05,"super flyweight",8,"right-handed",1,0,0,1,1
0.05,"super welterweight",14,"right-handed",1,0,0,1,1
0.05,"lightweight",21,"right-handed",1,0,0,1,1
0.05,"super lightweight",20,"right-handed",1,1,1,3,0.5
0.05,"lightweight",NA,"right-handed",1,0,0,1,1
0.05,"welterweight",3,"right-handed",1,0,0,1,1
0.05,"bantamweight",6,"right-handed",1,0,0,1,1
0.05,"super middleweight",10,"right-handed",1,0,0,1,1
0.05,"super welterweight",19,"right-handed",0,0,1,1,0.5
0.05,"lightweight",5,"right-handed",1,0,0,1,1
0.05,"super bantamweight",6,"right-handed",1,0,0,1,1
0.05,"lightweight",9,"right-handed",1,0,1,2,0.75
0.05,"super lightweight",11,"right-handed",1,0,0,1,1
0.05,"bantamweight",5,"right-handed",1,0,0,1,1
0.05,"lightweight",18,"right-handed",1,0,0,1,1
0.05,"middleweight",19,"right-handed",1,0,0,1,1
0.05,"super lightweight",10,"right-handed",1,0,1,2,0.75
0.05,"light heavyweight",14,"right-handed",1,0,0,1,1
0.05,"middleweight",12,"right-handed",1,0,0,1,1
0.05,"welterweight",12,"right-handed",1,0,0,1,1
0.05,"super featherweight",19,"right-handed",1,0,0,1,1
0.05,"middleweight",7,"right-handed",0,0,1,1,0.5
0.05,"",16,"right-handed",1,0,0,1,1
0.05,"super flyweight",8,"right-handed",1,0,0,1,1
0.05,"bantamweight",13,"right-handed",1,0,0,1,1
0.05,"light flyweight",4,"right-handed",0,0,1,1,0.5
0.05,"featherweight",8,"right-handed",0,0,1,1,0.5
0.05,"super lightweight",8,"right-handed",1,0,0,1,1
0.05,"",NA,"right-handed",1,0,0,1,1
0.05,"heavyweight",14,"right-handed",1,0,0,1,1
0.05,"welterweight",9,"right-handed",1,0,1,2,0.75
0.05,"lightweight",13,"right-handed",17,4,0,21,0.80952380952381
0.05,"super featherweight",NA,"right-handed",0,0,1,1,0.5
0.05,"welterweight",5,"right-handed",1,0,0,1,1
0.05,"super featherweight",NA,"right-handed",1,0,0,1,1
0.05,"bantamweight",6,"right-handed",0,0,1,1,0.5
0.05,"featherweight",16,"right-handed",1,3,0,4,0.25
0.05,"super featherweight",4,"right-handed",0,0,1,1,0.5
0.05,"super featherweight",6,"right-handed",1,0,0,1,1
0.05,"super bantamweight",8,"right-handed",1,0,0,1,1
0.05,"flyweight",14,"right-handed",1,1,0,2,0.5
0.05,"super flyweight",9,"right-handed",1,0,0,1,1
0.05,"light flyweight",7,"right-handed",1,0,0,1,1
0.05,"cruiserweight",10,"right-handed",1,0,0,1,1
0.05,"featherweight",12,"right-handed",1,0,0,1,1
0.05,"lightweight",2,"right-handed",1,0,0,1,1
0.05,"super welterweight",4,"right-handed",1,0,1,2,0.75
0.05,"super lightweight",11,"right-handed",1,0,0,1,1
0.05,"super bantamweight",3,"right-handed",1,0,0,1,1
0.05,"welterweight",8,"right-handed",0,0,1,1,0.5
0.05,"super flyweight",8,"right-handed",1,0,1,2,0.75
0.05,"super bantamweight",11,"right-handed",1,0,0,1,1
0.05,"bantamweight",11,"right-handed",1,0,0,1,1
0.05,"bantamweight",9,"right-handed",1,2,0,3,0.333333333333333
0.05,"light flyweight",9,"right-handed",1,0,0,1,1
0.05,"super flyweight",7,"right-handed",1,1,0,2,0.5
0.05,"featherweight",15,"right-handed",1,3,0,4,0.25
0.05,"lightweight",9,"right-handed",0,0,1,1,0.5
0.05,"super bantamweight",5,"right-handed",1,0,0,1,1
0.05,"super bantamweight",4,"right-handed",1,0,0,1,1
0.05,"welterweight",9,"right-handed",1,0,0,1,1
0.05,"bantamweight",6,"right-handed",1,0,0,1,1
0.05,"middleweight",12,"right-handed",1,0,0,1,1
0.05,"featherweight",15,"right-handed",1,0,0,1,1
0.05,"super lightweight",8,"right-handed",1,0,0,1,1
0.05,"welterweight",NA,"right-handed",1,0,0,1,1
0.05,"heavyweight",27,"right-handed",1,0,0,1,1
0.05,"super featherweight",15,"right-handed",1,0,0,1,1
0.05,"bantamweight",4,"right-handed",1,1,0,2,0.5
0.05,"minimumweight",NA,"right-handed",1,0,0,1,1
0.05,"heavyweight",17,"right-handed",0,0,1,1,0.5
0.05,"super bantamweight",6,"right-handed",1,0,0,1,1
0.05,"super lightweight",9,"right-handed",1,1,1,3,0.5
0.05,"super middleweight",11,"right-handed",1,1,0,2,0.5
0.05,"bantamweight",NA,"right-handed",0,0,1,1,0.5
0.05,"welterweight",11,"right-handed",1,0,0,1,1
0.05,"bantamweight",11,"right-handed",0,0,1,1,0.5
0.05,"lightweight",4,"right-handed",1,0,0,1,1
0.05,"middleweight",15,"right-handed",1,1,0,2,0.5
0.05,"super lightweight",13,"right-handed",1,0,0,1,1
0.05,"super middleweight",14,"right-handed",1,0,0,1,1
0.05,"middleweight",5,"right-handed",1,0,0,1,1
0.05,"super featherweight",4,"right-handed",1,0,0,1,1
0.05,"middleweight",6,"right-handed",1,0,0,1,1
0.05,"super middleweight",7,"right-handed",1,0,0,1,1
0.05,"heavyweight",14,"right-handed",1,0,0,1,1
0.05,"middleweight",16,"right-handed",1,0,0,1,1
0.05,"lightweight",6,"right-handed",1,0,0,1,1
0.05,"middleweight",14,"right-handed",1,0,0,1,1
0.05,"light heavyweight",10,"right-handed",1,0,0,1,1
0.05,"welterweight",18,"right-handed",1,0,0,1,1
0.05,"heavyweight",NA,"right-handed",1,0,0,1,1
0.05,"welterweight",11,"right-handed",1,0,0,1,1
0.05,"welterweight",10,"right-handed",1,0,0,1,1
0.05,"featherweight",10,"right-handed",1,2,0,3,0.333333333333333
0.05,"super featherweight",NA,"right-handed",1,0,0,1,1
0.05,"lightweight",6,"right-handed",1,0,0,1,1
0.05,"middleweight",8,"right-handed",0,0,1,1,0.5
0.05,"lightweight",8,"right-handed",1,0,1,2,0.75
0.05,"super middleweight",10,"right-handed",1,0,0,1,1
0.05,"super welterweight",15,"right-handed",1,0,0,1,1
0.05,"bantamweight",5,"right-handed",1,0,0,1,1
0.05,"flyweight",NA,"right-handed",0,0,2,2,0.5
0.05,"super bantamweight",4,"right-handed",0,0,1,1,0.5
0.05,"super lightweight",12,"right-handed",1,0,0,1,1
0.05,"lightweight",5,"right-handed",1,0,1,2,0.75
0.05,"minimumweight",15,"right-handed",1,0,1,2,0.75
0.05,"featherweight",14,"right-handed",1,0,1,2,0.75
0.05,"heavyweight",10,"right-handed",1,2,0,3,0.333333333333333
0.05,"lightweight",NA,"right-handed",1,0,1,2,0.75
0.05,"heavyweight",32,"right-handed",1,0,0,1,1
0.05,"lightweight",22,"right-handed",1,0,0,1,1
0.05,"lightweight",10,"right-handed",1,0,0,1,1
0.05,"super flyweight",14,"right-handed",1,0,0,1,1
0.05,"super lightweight",8,"right-handed",1,0,1,2,0.75
0.05,"cruiserweight",10,"right-handed",1,0,0,1,1
0.05,"middleweight",10,"right-handed",1,0,1,2,0.75
0.05,"heavyweight",16,"right-handed",1,0,0,1,1
0.05,"",15,"right-handed",1,0,0,1,1
0.05,"light flyweight",5,"right-handed",0,0,1,1,0.5
0.05,"super welterweight",5,"right-handed",1,0,0,1,1
0.05,"super welterweight",NA,"right-handed",0,0,2,2,0.5
0.05,"",13,"right-handed",0,0,1,1,0.5
0.05,"lightweight",16,"right-handed",1,2,0,3,0.333333333333333
0.05,"",11,"right-handed",1,0,0,1,1
0.05,"light heavyweight",21,"right-handed",1,0,0,1,1
0.05,"flyweight",NA,"right-handed",1,1,1,3,0.5
0.05,"super lightweight",11,"right-handed",1,0,0,1,1
0.05,"cruiserweight",31,"right-handed",1,0,0,1,1
0.05,"lightweight",10,"right-handed",1,1,1,3,0.5
0.05,"super featherweight",9,"right-handed",1,0,0,1,1
0.05,"heavyweight",19,"right-handed",1,0,1,2,0.75
0.05,"super welterweight",5,"right-handed",1,0,0,1,1
0.05,"super welterweight",15,"right-handed",1,0,0,1,1
0.05,"super bantamweight",6,"right-handed",1,0,0,1,1
0.05,"cruiserweight",14,"right-handed",1,0,0,1,1
0.05,"cruiserweight",4,"right-handed",1,0,0,1,1
0.05,"cruiserweight",24,"right-handed",1,0,0,1,1
0.05,"super bantamweight",NA,"right-handed",1,0,0,1,1
0.05,"middleweight",7,"right-handed",1,0,1,2,0.75
0.05,"flyweight",7,"right-handed",1,0,0,1,1
0.05,"welterweight",9,"right-handed",1,0,0,1,1
0.05,"bantamweight",6,"right-handed",1,0,1,2,0.75
0.05,"bantamweight",12,"right-handed",1,0,0,1,1
0.05,"heavyweight",12,"right-handed",1,0,0,1,1
0.05,"lightweight",13,"right-handed",1,0,0,1,1
0.05,"super lightweight",NA,"right-handed",1,0,0,1,1
0.05,"super bantamweight",3,"right-handed",0,0,1,1,0.5
0.05,"lightweight",8,"right-handed",1,0,0,1,1
0.05,"super bantamweight",17,"right-handed",1,1,0,2,0.5
0.05,"lightweight",8,"right-handed",1,0,0,1,1
0.05,"minimumweight",16,"right-handed",1,0,0,1,1
0.05,"super featherweight",9,"right-handed",1,0,0,1,1
0.05,"super flyweight",12,"right-handed",1,0,0,1,1
0.05,"super featherweight",9,"right-handed",1,0,0,1,1
0.05,"lightweight",12,"right-handed",1,0,0,1,1
0.05,"cruiserweight",16,"right-handed",1,0,0,1,1
0.05,"heavyweight",22,"right-handed",1,0,0,1,1
0.05,"welterweight",10,"right-handed",1,0,0,1,1
0.05,"welterweight",13,"right-handed",1,0,0,1,1
0.05,"bantamweight",13,"right-handed",0,0,1,1,0.5
0.05,"featherweight",9,"right-handed",1,0,0,1,1
0.05,"featherweight",NA,"right-handed",1,0,0,1,1
0.05,"heavyweight",NA,"right-handed",0,0,1,1,0.5
0.05,"welterweight",12,"right-handed",1,8,0,9,0.111111111111111
0.05,"super middleweight",22,"right-handed",1,0,0,1,1
0.05,"lightweight",NA,"right-handed",1,1,0,2,0.5
0.05,"super bantamweight",8,"right-handed",1,0,0,1,1
0.05,"light flyweight",11,"right-handed",1,0,0,1,1
0.05,"lightweight",5,"right-handed",1,0,0,1,1
0.05,"featherweight",5,"right-handed",1,0,0,1,1
0.05,"",11,"right-handed",1,0,0,1,1
0.05,"light heavyweight",14,"right-handed",1,0,1,2,0.75
0.05,"cruiserweight",16,"right-handed",1,0,0,1,1
0.05,"welterweight",20,"right-handed",1,0,1,2,0.75
0.05,"bantamweight",8,"right-handed",1,1,0,2,0.5
0.05,"bantamweight",9,"right-handed",1,0,0,1,1
0.05,"featherweight",12,"right-handed",1,0,0,1,1
0.05,"super bantamweight",18,"right-handed",1,0,0,1,1
0.05,"super flyweight",4,"right-handed",1,0,0,1,1
0.05,"super featherweight",11,"right-handed",1,3,0,4,0.25
0.05,"",10,"right-handed",1,2,0,3,0.333333333333333
0.05,"lightweight",9,"right-handed",1,0,1,2,0.75
0.05,"featherweight",11,"right-handed",0,0,1,1,0.5
0.05,"light heavyweight",8,"right-handed",1,0,0,1,1
0.05,"cruiserweight",20,"right-handed",1,0,0,1,1
0.05,"super middleweight",13,"right-handed",0,0,1,1,0.5
0.05,"super middleweight",NA,"right-handed",1,0,0,1,1
0.05,"welterweight",16,"right-handed",1,0,0,1,1
0.05,"middleweight",16,"right-handed",1,0,0,1,1
0.05,"featherweight",6,"right-handed",0,0,1,1,0.5
0.05,"light flyweight",15,"right-handed",1,1,0,2,0.5
0.05,"bantamweight",6,"right-handed",1,0,1,2,0.75
0.05,"bantamweight",5,"right-handed",1,0,0,1,1
0.05,"super featherweight",16,"right-handed",1,0,0,1,1
0.05,"super lightweight",9,"right-handed",0,0,1,1,0.5
0.05,"bantamweight",8,"right-handed",1,0,0,1,1
0.05,"super welterweight",4,"right-handed",1,0,0,1,1
0.05,"middleweight",7,"right-handed",0,0,1,1,0.5
0.05,"light flyweight",8,"right-handed",0,0,2,2,0.5
0.05,"welterweight",17,"right-handed",1,0,0,1,1
0.05,"middleweight",13,"right-handed",1,0,0,1,1
0.05,"super bantamweight",2,"right-handed",0,0,1,1,0.5
0.05,"super welterweight",4,"right-handed",0,0,2,2,0.5
0.05,"super welterweight",7,"right-handed",1,0,0,1,1
0.05,"super welterweight",18,"right-handed",7,5,3,15,0.566666666666667
0.05,"welterweight",11,"right-handed",10,1,0,11,0.909090909090909
0.05,"cruiserweight",19,"right-handed",13,1,0,14,0.928571428571429
0.05,"super bantamweight",9,"right-handed",4,3,0,7,0.571428571428571
0.05,"super lightweight",16,"right-handed",2,2,0,4,0.5
0.05,"super welterweight",22,"right-handed",8,18,1,27,0.314814814814815
0.05,"super featherweight",15,"right-handed",7,3,0,10,0.7
0.05,"welterweight",15,"right-handed",4,1,0,5,0.8
0.05,"cruiserweight",9,"right-handed",0,0,0,0,NA
0.05,"cruiserweight",16,"right-handed",0,0,0,0,NA
0.05,"super middleweight",25,"right-handed",0,0,0,0,NA
0.05,"super bantamweight",19,"right-handed",7,5,0,12,0.583333333333333
0.05,"cruiserweight",10,"right-handed",0,0,0,0,NA
0.05,"welterweight",32,"right-handed",5,13,1,19,0.289473684210526
0.05,"super welterweight",16,"right-handed",0,0,0,0,NA
0.05,"featherweight",7,"right-handed",3,1,0,4,0.75
0.05,"super bantamweight",11,"right-handed",3,3,1,7,0.5
0.05,"cruiserweight",12,"right-handed",0,0,0,0,NA
0.05,"super lightweight",22,"right-handed",9,16,1,26,0.365384615384615
0.05,"light heavyweight",34,"right-handed",0,0,0,0,NA
0.05,"welterweight",15,"right-handed",1,1,0,2,0.5
0.05,"super bantamweight",19,"right-handed",2,3,0,5,0.4
0.05,"cruiserweight",11,"right-handed",8,2,1,11,0.772727272727273
0.05,"welterweight",8,"right-handed",2,9,0,11,0.181818181818182
0.05,"heavyweight",31,"right-handed",30,4,2,36,0.861111111111111
0.05,"middleweight",16,"right-handed",3,2,0,5,0.6
0.05,"cruiserweight",18,"right-handed",2,1,0,3,0.666666666666667
0.05,"lightweight",16,"right-handed",2,1,1,4,0.625
0.05,"super featherweight",8,"right-handed",2,9,0,11,0.181818181818182
0.05,"heavyweight",26,"right-handed",15,5,0,20,0.75
0.05,"lightweight",15,"right-handed",23,5,0,28,0.821428571428571
0.05,"flyweight",5,"right-handed",6,2,0,8,0.75
0.05,"minimumweight",16,"right-handed",6,4,1,11,0.590909090909091
0.05,"cruiserweight",9,"right-handed",5,2,0,7,0.714285714285714
0.05,"light heavyweight",15,"right-handed",10,1,0,11,0.909090909090909
0.05,"super bantamweight",20,"right-handed",22,26,0,48,0.458333333333333
0.05,"flyweight",13,"right-handed",21,18,1,40,0.5375
0.05,"welterweight",18,"right-handed",13,2,0,15,0.866666666666667
0.05,"welterweight",15,"right-handed",5,1,1,7,0.785714285714286
0.05,"welterweight",5,"right-handed",9,1,0,10,0.9
0.05,"super featherweight",5,"right-handed",4,8,1,13,0.346153846153846
0.05,"super lightweight",12,"right-handed",6,8,0,14,0.428571428571429
0.05,"heavyweight",21,"right-handed",10,1,0,11,0.909090909090909
0.05,"welterweight",NA,"right-handed",2,2,0,4,0.5
0.05,"welterweight",18,"right-handed",7,2,0,9,0.777777777777778
0.05,"super middleweight",13,"right-handed",10,1,1,12,0.875
0.05,"super bantamweight",9,"right-handed",2,2,1,5,0.5
0.05,"cruiserweight",13,"right-handed",8,1,0,9,0.888888888888889
0.05,"welterweight",7,"right-handed",1,1,0,2,0.5
0.05,"lightweight",16,"right-handed",2,1,0,3,0.666666666666667
0.05,"super flyweight",11,"right-handed",9,3,1,13,0.730769230769231
0.05,"light flyweight",16,"right-handed",2,4,0,6,0.333333333333333
0.05,"flyweight",8,"right-handed",12,9,1,22,0.568181818181818
0.05,"lightweight",19,"right-handed",10,4,0,14,0.714285714285714
0.05,"middleweight",15,"right-handed",6,2,1,9,0.722222222222222
0.05,"heavyweight",10,"right-handed",7,2,1,10,0.75
0.05,"light heavyweight",13,"right-handed",11,6,1,18,0.638888888888889
0.05,"super lightweight",15,"right-handed",2,3,0,5,0.4
0.05,"super featherweight",15,"right-handed",8,1,0,9,0.888888888888889
0.05,"welterweight",12,"right-handed",7,1,1,9,0.833333333333333
0.05,"heavyweight",NA,"right-handed",7,1,0,8,0.875
0.05,"lightweight",15,"right-handed",1,11,0,12,0.0833333333333333
0.05,"super welterweight",17,"right-handed",7,4,1,12,0.625
0.05,"super bantamweight",7,"right-handed",7,6,0,13,0.538461538461538
0.05,"welterweight",13,"right-handed",5,1,1,7,0.785714285714286
0.05,"middleweight",8,"right-handed",7,1,0,8,0.875
0.05,"super middleweight",15,"right-handed",3,7,0,10,0.3
0.05,"super welterweight",13,"right-handed",8,1,0,9,0.888888888888889
0.05,"super lightweight",13,"right-handed",10,8,0,18,0.555555555555556
0.05,"bantamweight",6,"right-handed",7,2,1,10,0.75
0.05,"super flyweight",6,"right-handed",7,2,2,11,0.727272727272727
0.05,"middleweight",14,"right-handed",6,1,1,8,0.8125
0.05,"heavyweight",20,"right-handed",7,2,0,9,0.777777777777778
0.05,"super welterweight",23,"right-handed",8,1,0,9,0.888888888888889
0.05,"super bantamweight",19,"right-handed",8,4,0,12,0.666666666666667
0.049,"super lightweight",18,"right-handed",7,6,0,13,0.538461538461538
0.049,"middleweight",16,"right-handed",5,1,0,6,0.833333333333333
0.049,"welterweight",8,"right-handed",6,7,0,13,0.461538461538462
0.049,"welterweight",8,"right-handed",5,1,0,6,0.833333333333333
0.049,"super lightweight",9,"right-handed",0,1,0,1,0
0.049,"super welterweight",14,"right-handed",5,1,1,7,0.785714285714286
0.049,"lightweight",14,"right-handed",5,1,0,6,0.833333333333333
0.049,"super middleweight",20,"right-handed",6,5,0,11,0.545454545454545
0.049,"flyweight",30,"right-handed",5,1,0,6,0.833333333333333
0.049,"super bantamweight",7,"right-handed",5,1,0,6,0.833333333333333
0.049,"heavyweight",16,"right-handed",5,1,0,6,0.833333333333333
0.049,"middleweight",26,"right-handed",6,16,2,24,0.291666666666667
0.049,"super bantamweight",NA,"right-handed",5,1,0,6,0.833333333333333
0.049,"featherweight",11,"right-handed",3,1,1,5,0.7
0.049,"lightweight",23,"right-handed",5,3,1,9,0.611111111111111
0.049,"flyweight",10,"right-handed",5,5,1,11,0.5
0.049,"light heavyweight",15,"right-handed",7,8,0,15,0.466666666666667
0.049,"super flyweight",8,"right-handed",4,3,2,9,0.555555555555556
0.049,"super lightweight",6,"right-handed",6,6,1,13,0.5
0.049,"featherweight",8,"right-handed",4,1,4,9,0.666666666666667
0.049,"super featherweight",12,"right-handed",6,1,0,7,0.857142857142857
0.049,"lightweight",15,"right-handed",4,2,1,7,0.642857142857143
0.049,"super bantamweight",8,"right-handed",4,2,0,6,0.666666666666667
0.049,"welterweight",22,"right-handed",6,2,0,8,0.75
0.049,"bantamweight",5,"right-handed",7,4,0,11,0.636363636363636
0.049,"welterweight",19,"right-handed",5,1,1,7,0.785714285714286
0.049,"cruiserweight",15,"right-handed",6,3,0,9,0.666666666666667
0.049,"super lightweight",23,"right-handed",8,3,0,11,0.727272727272727
0.049,"cruiserweight",16,"right-handed",5,1,0,6,0.833333333333333
0.049,"light heavyweight",14,"right-handed",12,13,0,25,0.48
0.049,"light flyweight",9,"right-handed",6,3,1,10,0.65
0.049,"super flyweight",4,"right-handed",5,2,0,7,0.714285714285714
0.049,"super welterweight",10,"right-handed",6,1,0,7,0.857142857142857
0.049,"cruiserweight",9,"right-handed",7,11,0,18,0.388888888888889
0.049,"super lightweight",6,"right-handed",5,1,0,6,0.833333333333333
0.049,"minimumweight",7,"right-handed",5,2,0,7,0.714285714285714
0.049,"super featherweight",12,"right-handed",5,2,0,7,0.714285714285714
0.049,"cruiserweight",16,"right-handed",1,4,0,5,0.2
0.049,"super welterweight",NA,"right-handed",3,3,1,7,0.5
0.049,"featherweight",6,"right-handed",0,2,1,3,0.166666666666667
0.049,"heavyweight",19,"right-handed",1,1,0,2,0.5
0.049,"lightweight",20,"right-handed",4,4,0,8,0.5
0.049,"lightweight",12,"right-handed",1,1,1,3,0.5
0.049,"heavyweight",18,"right-handed",4,2,0,6,0.666666666666667
0.049,"light heavyweight",9,"right-handed",3,1,0,4,0.75
0.049,"cruiserweight",18,"right-handed",3,1,0,4,0.75
0.049,"bantamweight",16,"right-handed",14,20,1,35,0.414285714285714
0.049,"super welterweight",16,"right-handed",4,1,0,5,0.8
0.049,"middleweight",8,"right-handed",2,1,2,5,0.6
0.049,"super middleweight",13,"right-handed",3,1,0,4,0.75
0.049,"heavyweight",21,"right-handed",4,1,0,5,0.8
0.049,"super lightweight",20,"right-handed",4,1,0,5,0.8
0.049,"middleweight",11,"right-handed",4,1,0,5,0.8
0.049,"cruiserweight",18,"right-handed",3,2,1,6,0.583333333333333
0.049,"middleweight",NA,"right-handed",4,6,2,12,0.416666666666667
0.049,"welterweight",9,"right-handed",4,1,0,5,0.8
0.049,"super flyweight",7,"right-handed",1,6,1,8,0.1875
0.049,"super bantamweight",11,"right-handed",2,2,2,6,0.5
0.049,"super lightweight",14,"right-handed",3,2,1,6,0.583333333333333
0.049,"super lightweight",8,"right-handed",3,1,0,4,0.75
0.049,"bantamweight",6,"right-handed",4,3,0,7,0.571428571428571
0.049,"middleweight",9,"right-handed",4,3,0,7,0.571428571428571
0.049,"featherweight",15,"right-handed",4,4,0,8,0.5
0.049,"bantamweight",12,"right-handed",4,2,0,6,0.666666666666667
0.049,"flyweight",9,"right-handed",2,1,1,4,0.625
0.049,"super bantamweight",14,"right-handed",5,7,0,12,0.416666666666667
0.049,"super featherweight",10,"right-handed",3,3,4,10,0.5
0.049,"super bantamweight",12,"right-handed",3,1,1,5,0.7
0.049,"flyweight",7,"right-handed",2,5,1,8,0.3125
0.049,"super lightweight",9,"right-handed",2,2,3,7,0.5
0.049,"super welterweight",10,"right-handed",3,1,1,5,0.7
0.049,"light heavyweight",9,"right-handed",4,1,0,5,0.8
0.049,"super middleweight",10,"right-handed",6,6,0,12,0.5
0.049,"light heavyweight",18,"right-handed",4,1,2,7,0.714285714285714
0.049,"super featherweight",11,"right-handed",4,1,0,5,0.8
0.049,"heavyweight",20,"right-handed",5,2,1,8,0.6875
0.049,"featherweight",9,"right-handed",4,4,1,9,0.5
0.049,"featherweight",9,"right-handed",4,4,1,9,0.5
0.049,"flyweight",7,"right-handed",3,2,0,5,0.6
0.049,"super bantamweight",8,"right-handed",3,1,0,4,0.75
0.049,"welterweight",NA,"right-handed",5,6,0,11,0.454545454545455
0.049,"flyweight",9,"right-handed",3,1,1,5,0.7
0.049,"light flyweight",10,"right-handed",4,1,0,5,0.8
0.049,"super bantamweight",9,"right-handed",2,2,3,7,0.5
0.049,"lightweight",16,"right-handed",5,5,0,10,0.5
0.049,"heavyweight",15,"right-handed",4,1,1,6,0.75
0.049,"welterweight",11,"right-handed",4,1,0,5,0.8
0.049,"lightweight",19,"right-handed",4,4,0,8,0.5
0.049,"welterweight",27,"right-handed",4,1,0,5,0.8
0.049,"super bantamweight",13,"right-handed",3,2,1,6,0.583333333333333
0.049,"super featherweight",7,"right-handed",3,1,1,5,0.7
0.049,"super bantamweight",NA,"right-handed",5,3,0,8,0.625
0.049,"super featherweight",6,"right-handed",3,1,0,4,0.75
0.049,"welterweight",10,"right-handed",0,2,0,2,0
0.049,"super flyweight",14,"right-handed",5,8,0,13,0.384615384615385
0.049,"featherweight",10,"right-handed",3,2,1,6,0.583333333333333
0.049,"featherweight",8,"right-handed",5,3,1,9,0.611111111111111
0.049,"super featherweight",18,"right-handed",5,7,2,14,0.428571428571429
0.049,"welterweight",10,"right-handed",3,1,0,4,0.75
0.049,"lightweight",13,"right-handed",6,7,3,16,0.46875
0.049,"featherweight",12,"right-handed",3,4,1,8,0.4375
0.049,"lightweight",13,"right-handed",4,6,0,10,0.4
0.049,"super lightweight",5,"right-handed",3,1,2,6,0.666666666666667
0.049,"minimumweight",7,"right-handed",3,1,1,5,0.7
0.049,"super bantamweight",16,"right-handed",2,1,0,3,0.666666666666667
0.049,"super flyweight",11,"right-handed",2,3,0,5,0.4
0.049,"middleweight",13,"right-handed",1,1,2,4,0.5
0.049,"bantamweight",4,"right-handed",2,2,1,5,0.5
0.049,"welterweight",10,"right-handed",2,1,0,3,0.666666666666667
0.049,"welterweight",7,"right-handed",2,1,0,3,0.666666666666667
0.049,"super lightweight",19,"right-handed",1,8,2,11,0.181818181818182
0.049,"lightweight",5,"right-handed",2,2,0,4,0.5
0.049,"lightweight",NA,"right-handed",3,1,0,4,0.75
0.049,"super lightweight",13,"right-handed",2,1,0,3,0.666666666666667
0.049,"super featherweight",10,"right-handed",2,1,0,3,0.666666666666667
0.049,"featherweight",4,"right-handed",2,2,0,4,0.5
0.049,"middleweight",NA,"right-handed",2,1,0,3,0.666666666666667
0.049,"middleweight",23,"right-handed",2,7,1,10,0.25
0.049,"super middleweight",22,"right-handed",2,1,0,3,0.666666666666667
0.049,"heavyweight",10,"right-handed",1,1,3,5,0.5
0.049,"super lightweight",NA,"right-handed",3,1,0,4,0.75
0.049,"middleweight",6,"right-handed",2,1,0,3,0.666666666666667
0.049,"super flyweight",4,"right-handed",2,1,0,3,0.666666666666667
0.049,"featherweight",5,"right-handed",1,15,2,18,0.111111111111111
0.049,"bantamweight",14,"right-handed",2,1,0,3,0.666666666666667
0.049,"cruiserweight",9,"right-handed",3,2,0,5,0.6
0.049,"featherweight",12,"right-handed",3,3,0,6,0.5
0.049,"super featherweight",6,"right-handed",2,1,0,3,0.666666666666667
0.049,"flyweight",16,"right-handed",2,1,0,3,0.666666666666667
0.049,"cruiserweight",15,"right-handed",2,1,1,4,0.625
0.049,"super bantamweight",16,"right-handed",3,9,0,12,0.25
0.049,"middleweight",9,"right-handed",2,1,1,4,0.625
0.049,"flyweight",9,"right-handed",1,4,2,7,0.285714285714286
0.049,"lightweight",19,"right-handed",2,3,0,5,0.4
0.049,"featherweight",16,"right-handed",2,14,0,16,0.125
0.049,"flyweight",9,"right-handed",2,1,0,3,0.666666666666667
0.049,"welterweight",6,"right-handed",2,1,0,3,0.666666666666667
0.049,"super welterweight",8,"right-handed",2,1,1,4,0.625
0.049,"super flyweight",14,"right-handed",3,5,1,9,0.388888888888889
0.049,"super featherweight",20,"right-handed",2,2,0,4,0.5
0.049,"super lightweight",18,"right-handed",2,2,2,6,0.5
0.049,"super bantamweight",6,"right-handed",1,1,2,4,0.5
0.049,"middleweight",19,"right-handed",2,1,0,3,0.666666666666667
0.049,"bantamweight",6,"right-handed",2,1,0,3,0.666666666666667
0.049,"minimumweight",16,"right-handed",2,1,0,3,0.666666666666667
0.049,"bantamweight",10,"right-handed",2,1,0,3,0.666666666666667
0.049,"super welterweight",NA,"right-handed",2,1,0,3,0.666666666666667
0.049,"super lightweight",11,"right-handed",2,1,0,3,0.666666666666667
0.049,"bantamweight",10,"right-handed",2,3,1,6,0.416666666666667
0.049,"super welterweight",11,"right-handed",2,1,0,3,0.666666666666667
0.049,"heavyweight",15,"right-handed",2,8,1,11,0.227272727272727
0.049,"super flyweight",10,"right-handed",2,1,0,3,0.666666666666667
0.049,"featherweight",9,"right-handed",3,6,0,9,0.333333333333333
0.049,"welterweight",6,"right-handed",3,3,0,6,0.5
0.049,"lightweight",9,"right-handed",2,2,0,4,0.5
0.049,"flyweight",1,"right-handed",2,1,0,3,0.666666666666667
0.049,"heavyweight",22,"right-handed",2,3,2,7,0.428571428571429
0.049,"featherweight",13,"right-handed",1,1,0,2,0.5
0.049,"super lightweight",14,"right-handed",7,10,0,17,0.411764705882353
0.049,"super welterweight",15,"right-handed",2,2,0,4,0.5
0.049,"super lightweight",7,"right-handed",2,2,1,5,0.5
0.049,"super featherweight",7,"right-handed",2,1,0,3,0.666666666666667
0.049,"super bantamweight",6,"right-handed",2,2,0,4,0.5
0.049,"minimumweight",6,"right-handed",3,2,0,5,0.6
0.049,"lightweight",18,"right-handed",2,2,0,4,0.5
0.049,"lightweight",8,"right-handed",3,2,0,5,0.6
0.049,"welterweight",7,"right-handed",2,3,0,5,0.4
0.049,"super lightweight",6,"right-handed",2,4,2,8,0.375
0.049,"super middleweight",NA,"right-handed",3,1,0,4,0.75
0.049,"cruiserweight",15,"right-handed",2,2,2,6,0.5
0.049,"flyweight",NA,"right-handed",3,1,0,4,0.75
0.049,"middleweight",9,"right-handed",3,3,0,6,0.5
0.049,"super welterweight",4,"right-handed",2,1,0,3,0.666666666666667
0.049,"heavyweight",22,"right-handed",3,1,0,4,0.75
0.049,"super flyweight",8,"right-handed",2,1,1,4,0.625
0.049,"lightweight",6,"right-handed",2,1,0,3,0.666666666666667
0.049,"bantamweight",7,"right-handed",2,2,1,5,0.5
0.049,"welterweight",12,"right-handed",2,2,2,6,0.5
0.049,"super featherweight",9,"right-handed",3,2,0,5,0.6
0.049,"flyweight",16,"right-handed",2,2,1,5,0.5
0.049,"super featherweight",16,"right-handed",2,1,0,3,0.666666666666667
0.049,"featherweight",9,"right-handed",3,4,1,8,0.4375
0.049,"welterweight",12,"right-handed",3,1,0,4,0.75
0.049,"flyweight",12,"right-handed",2,5,2,9,0.333333333333333
0.049,"middleweight",12,"right-handed",3,1,0,4,0.75
0.049,"light flyweight",10,"right-handed",2,3,1,6,0.416666666666667
0.049,"lightweight",5,"right-handed",3,4,0,7,0.428571428571429
0.049,"super featherweight",8,"right-handed",2,1,0,3,0.666666666666667
0.049,"featherweight",7,"right-handed",2,1,0,3,0.666666666666667
0.049,"light heavyweight",8,"right-handed",2,1,0,3,0.666666666666667
0.049,"bantamweight",9,"right-handed",2,2,0,4,0.5
0.049,"heavyweight",20,"right-handed",3,2,0,5,0.6
0.049,"featherweight",NA,"right-handed",2,1,0,3,0.666666666666667
0.049,"light heavyweight",13,"right-handed",2,1,1,4,0.625
0.049,"super flyweight",4,"right-handed",2,3,0,5,0.4
0.049,"super featherweight",16,"right-handed",3,3,0,6,0.5
0.049,"welterweight",11,"right-handed",3,2,0,5,0.6
0.049,"super welterweight",16,"right-handed",1,1,0,2,0.5
0.049,"cruiserweight",NA,"right-handed",2,2,0,4,0.5
0.049,"featherweight",9,"right-handed",2,1,1,4,0.625
0.049,"super flyweight",9,"right-handed",2,1,1,4,0.625
0.049,"super lightweight",15,"right-handed",3,2,0,5,0.6
0.049,"flyweight",5,"right-handed",2,1,0,3,0.666666666666667
0.049,"featherweight",9,"right-handed",2,3,0,5,0.4
0.049,"super lightweight",4,"right-handed",3,5,0,8,0.375
0.049,"flyweight",5,"right-handed",2,1,1,4,0.625
0.049,"cruiserweight",30,"right-handed",5,67,1,73,0.0753424657534247
0.049,"heavyweight",10,"right-handed",3,5,0,8,0.375
0.049,"super lightweight",8,"right-handed",2,2,0,4,0.5
0.049,"featherweight",11,"right-handed",3,2,0,5,0.6
0.049,"light flyweight",18,"right-handed",2,1,0,3,0.666666666666667
0.049,"light heavyweight",24,"right-handed",2,1,0,3,0.666666666666667
0.049,"welterweight",14,"right-handed",3,1,0,4,0.75
0.049,"super bantamweight",12,"right-handed",3,6,0,9,0.333333333333333
0.049,"lightweight",6,"right-handed",1,1,2,4,0.5
0.049,"super middleweight",14,"right-handed",2,1,0,3,0.666666666666667
0.049,"welterweight",14,"right-handed",2,1,0,3,0.666666666666667
0.049,"minimumweight",19,"right-handed",2,1,0,3,0.666666666666667
0.049,"welterweight",10,"right-handed",3,1,0,4,0.75
0.049,"cruiserweight",23,"right-handed",2,3,0,5,0.4
0.049,"cruiserweight",16,"right-handed",3,1,0,4,0.75
0.049,"lightweight",7,"right-handed",3,1,0,4,0.75
0.049,"welterweight",13,"right-handed",2,1,1,4,0.625
0.049,"super welterweight",23,"right-handed",3,4,0,7,0.428571428571429
0.049,"flyweight",17,"right-handed",2,1,0,3,0.666666666666667
0.049,"welterweight",12,"right-handed",2,1,0,3,0.666666666666667
0.049,"super lightweight",12,"right-handed",2,1,0,3,0.666666666666667
0.049,"heavyweight",7,"right-handed",2,4,0,6,0.333333333333333
0.049,"light heavyweight",24,"right-handed",2,1,0,3,0.666666666666667
0.049,"super featherweight",8,"right-handed",2,1,0,3,0.666666666666667
0.049,"minimumweight",19,"right-handed",1,1,0,2,0.5
0.049,"light heavyweight",9,"right-handed",1,1,0,2,0.5
0.049,"lightweight",11,"right-handed",1,1,1,3,0.5
0.049,"super flyweight",10,"right-handed",1,1,0,2,0.5
0.049,"bantamweight",15,"right-handed",2,6,0,8,0.25
0.049,"featherweight",7,"right-handed",1,1,1,3,0.5
0.049,"super lightweight",6,"right-handed",1,2,0,3,0.333333333333333
0.049,"super welterweight",11,"right-handed",1,1,1,3,0.5
0.049,"middleweight",17,"right-handed",1,2,0,3,0.333333333333333
0.049,"super lightweight",9,"right-handed",1,1,1,3,0.5
0.049,"featherweight",14,"right-handed",1,1,0,2,0.5
0.049,"lightweight",10,"right-handed",1,1,0,2,0.5
0.049,"super lightweight",13,"right-handed",1,1,0,2,0.5
0.049,"lightweight",7,"right-handed",1,1,0,2,0.5
0.049,"cruiserweight",18,"right-handed",1,1,1,3,0.5
0.049,"heavyweight",22,"right-handed",1,1,0,2,0.5
0.049,"super lightweight",16,"right-handed",1,1,0,2,0.5
0.049,"cruiserweight",29,"right-handed",1,1,0,2,0.5
0.049,"middleweight",10,"right-handed",1,1,0,2,0.5
0.049,"super bantamweight",9,"right-handed",1,13,0,14,0.0714285714285714
0.049,"",7,"right-handed",1,1,0,2,0.5
0.049,"light heavyweight",16,"right-handed",1,2,0,3,0.333333333333333
0.049,"super lightweight",15,"right-handed",1,1,0,2,0.5
0.049,"cruiserweight",23,"right-handed",1,1,0,2,0.5
0.049,"super welterweight",NA,"right-handed",0,1,1,2,0.25
0.049,"lightweight",13,"right-handed",1,1,0,2,0.5
0.049,"super lightweight",18,"right-handed",1,1,0,2,0.5
0.049,"light heavyweight",14,"right-handed",5,3,1,9,0.611111111111111
0.049,"super welterweight",8,"right-handed",0,1,1,2,0.25
0.049,"middleweight",16,"right-handed",1,1,0,2,0.5
0.049,"super featherweight",4,"right-handed",1,1,0,2,0.5
0.049,"welterweight",7,"right-handed",1,2,1,4,0.375
0.049,"heavyweight",20,"right-handed",1,1,0,2,0.5
0.049,"super featherweight",NA,"right-handed",1,1,0,2,0.5
0.049,"super lightweight",NA,"right-handed",1,1,1,3,0.5
0.049,"super lightweight",21,"right-handed",17,6,0,23,0.739130434782609
0.049,"super flyweight",4,"right-handed",1,2,0,3,0.333333333333333
0.049,"welterweight",15,"right-handed",1,1,1,3,0.5
0.049,"welterweight",3,"right-handed",1,4,1,6,0.25
0.049,"super welterweight",18,"right-handed",1,2,0,3,0.333333333333333
0.049,"super bantamweight",9,"right-handed",1,1,0,2,0.5
0.049,"welterweight",8,"right-handed",1,1,0,2,0.5
0.049,"heavyweight",9,"right-handed",1,1,0,2,0.5
0.049,"flyweight",NA,"right-handed",1,1,0,2,0.5
0.049,"middleweight",23,"right-handed",1,3,0,4,0.25
0.049,"bantamweight",11,"right-handed",1,1,0,2,0.5
0.049,"super lightweight",24,"right-handed",6,8,1,15,0.433333333333333
0.049,"middleweight",17,"right-handed",1,1,1,3,0.5
0.049,"welterweight",6,"right-handed",1,1,0,2,0.5
0.049,"featherweight",15,"right-handed",1,1,1,3,0.5
0.049,"minimumweight",12,"right-handed",1,2,1,4,0.375
0.049,"super lightweight",22,"right-handed",1,1,0,2,0.5
0.049,"light heavyweight",11,"right-handed",1,1,0,2,0.5
0.049,"light heavyweight",19,"right-handed",1,2,1,4,0.375
0.049,"featherweight",23,"right-handed",1,1,0,2,0.5
0.049,"super bantamweight",7,"right-handed",1,1,0,2,0.5
0.049,"lightweight",15,"right-handed",1,1,0,2,0.5
0.049,"super featherweight",16,"right-handed",1,3,0,4,0.25
0.049,"super welterweight",3,"right-handed",1,1,1,3,0.5
0.049,"super featherweight",24,"right-handed",1,1,0,2,0.5
0.049,"heavyweight",NA,"right-handed",1,1,0,2,0.5
0.049,"super bantamweight",5,"right-handed",0,1,3,4,0.375
0.049,"welterweight",7,"right-handed",1,2,0,3,0.333333333333333
0.049,"flyweight",4,"right-handed",1,2,1,4,0.375
0.049,"welterweight",13,"right-handed",1,1,0,2,0.5
0.049,"lightweight",17,"right-handed",1,1,0,2,0.5
0.049,"super featherweight",11,"right-handed",1,2,0,3,0.333333333333333
0.049,"",NA,"right-handed",1,1,0,2,0.5
0.049,"lightweight",18,"right-handed",1,2,0,3,0.333333333333333
0.049,"welterweight",15,"right-handed",1,1,1,3,0.5
0.049,"super lightweight",15,"right-handed",1,1,1,3,0.5
0.049,"super middleweight",14,"right-handed",1,2,1,4,0.375
0.049,"super featherweight",6,"right-handed",1,1,0,2,0.5
0.049,"cruiserweight",30,"right-handed",2,20,2,24,0.125
0.049,"super lightweight",10,"right-handed",1,1,0,2,0.5
0.049,"bantamweight",16,"right-handed",1,1,0,2,0.5
0.049,"bantamweight",9,"right-handed",1,2,0,3,0.333333333333333
0.049,"welterweight",14,"right-handed",1,1,0,2,0.5
0.049,"flyweight",5,"right-handed",1,1,1,3,0.5
0.049,"super featherweight",9,"right-handed",1,1,0,2,0.5
0.049,"featherweight",5,"right-handed",1,2,1,4,0.375
0.049,"super middleweight",23,"right-handed",2,15,1,18,0.138888888888889
0.049,"super welterweight",6,"right-handed",1,1,0,2,0.5
0.049,"bantamweight",NA,"right-handed",1,1,0,2,0.5
0.049,"super flyweight",16,"right-handed",1,1,0,2,0.5
0.049,"flyweight",NA,"right-handed",1,1,0,2,0.5
0.049,"flyweight",13,"right-handed",1,1,0,2,0.5
0.049,"minimumweight",NA,"right-handed",1,1,0,2,0.5
0.049,"super lightweight",8,"right-handed",1,1,0,2,0.5
0.049,"welterweight",14,"right-handed",1,2,0,3,0.333333333333333
0.049,"light heavyweight",4,"right-handed",1,1,0,2,0.5
0.049,"super welterweight",21,"right-handed",1,1,0,2,0.5
0.049,"super featherweight",6,"right-handed",1,1,0,2,0.5
0.049,"super welterweight",18,"right-handed",1,1,0,2,0.5
0.049,"super welterweight",6,"right-handed",1,5,0,6,0.166666666666667
0.049,"super lightweight",9,"right-handed",1,1,0,2,0.5
0.049,"super middleweight",NA,"right-handed",1,1,0,2,0.5
0.049,"super bantamweight",7,"right-handed",1,1,0,2,0.5
0.049,"super featherweight",17,"right-handed",2,5,0,7,0.285714285714286
0.049,"featherweight",8,"right-handed",1,1,0,2,0.5
0.049,"super bantamweight",11,"right-handed",1,3,0,4,0.25
0.049,"featherweight",8,"right-handed",1,2,0,3,0.333333333333333
0.049,"cruiserweight",13,"right-handed",1,1,0,2,0.5
0.049,"lightweight",8,"right-handed",1,1,0,2,0.5
0.049,"featherweight",6,"right-handed",1,2,0,3,0.333333333333333
0.049,"super lightweight",6,"right-handed",1,1,0,2,0.5
0.049,"light flyweight",6,"right-handed",1,1,0,2,0.5
0.049,"light flyweight",NA,"right-handed",1,1,0,2,0.5
0.049,"super flyweight",22,"right-handed",1,4,1,6,0.25
0.049,"lightweight",5,"right-handed",1,1,1,3,0.5
0.049,"flyweight",5,"right-handed",1,1,0,2,0.5
0.049,"lightweight",11,"right-handed",0,1,2,3,0.333333333333333
0.049,"super welterweight",16,"right-handed",2,5,0,7,0.285714285714286
0.049,"welterweight",10,"right-handed",1,1,0,2,0.5
0.049,"super featherweight",17,"right-handed",1,1,1,3,0.5
0.049,"cruiserweight",21,"right-handed",1,1,0,2,0.5
0.049,"welterweight",6,"right-handed",1,2,0,3,0.333333333333333
0.049,"super lightweight",7,"right-handed",1,1,0,2,0.5
0.049,"bantamweight",11,"right-handed",1,1,0,2,0.5
0.049,"flyweight",9,"right-handed",1,2,0,3,0.333333333333333
0.049,"bantamweight",10,"right-handed",1,1,0,2,0.5
0.049,"super featherweight",12,"right-handed",2,5,0,7,0.285714285714286
0.049,"featherweight",10,"right-handed",1,1,0,2,0.5
0.049,"super welterweight",13,"right-handed",1,1,0,2,0.5
0.049,"cruiserweight",8,"right-handed",1,1,0,2,0.5
0.049,"super flyweight",NA,"right-handed",1,1,1,3,0.5
0.049,"light flyweight",10,"right-handed",1,2,0,3,0.333333333333333
0.049,"lightweight",12,"right-handed",1,1,0,2,0.5
0.049,"middleweight",14,"right-handed",1,1,0,2,0.5
0.049,"super lightweight",16,"right-handed",1,1,0,2,0.5
0.049,"super lightweight",17,"right-handed",1,3,1,5,0.3
0.049,"",8,"right-handed",1,1,0,2,0.5
0.049,"heavyweight",18,"right-handed",1,1,0,2,0.5
0.049,"flyweight",9,"right-handed",1,1,0,2,0.5
0.049,"bantamweight",5,"right-handed",1,1,0,2,0.5
0.049,"welterweight",10,"right-handed",1,1,0,2,0.5
0.049,"middleweight",17,"right-handed",1,1,1,3,0.5
0.049,"bantamweight",19,"right-handed",1,1,0,2,0.5
0.049,"super lightweight",13,"right-handed",1,1,0,2,0.5
0.049,"heavyweight",10,"right-handed",1,1,0,2,0.5
0.049,"super flyweight",NA,"right-handed",1,1,0,2,0.5
0.049,"super bantamweight",6,"right-handed",1,2,0,3,0.333333333333333
0.049,"featherweight",9,"right-handed",1,1,0,2,0.5
0.049,"welterweight",17,"right-handed",1,12,1,14,0.107142857142857
0.049,"heavyweight",20,"right-handed",1,1,0,2,0.5
0.049,"super flyweight",13,"right-handed",1,1,0,2,0.5
0.049,"super lightweight",5,"right-handed",1,1,0,2,0.5
0.049,"super lightweight",11,"right-handed",1,2,0,3,0.333333333333333
0.049,"super bantamweight",4,"right-handed",1,1,1,3,0.5
0.049,"heavyweight",17,"right-handed",1,1,0,2,0.5
0.049,"middleweight",11,"right-handed",1,1,0,2,0.5
0.049,"middleweight",22,"right-handed",1,1,0,2,0.5
0.049,"light flyweight",6,"right-handed",1,1,1,3,0.5
0.049,"super bantamweight",6,"right-handed",1,2,1,4,0.375
0.049,"super bantamweight",22,"right-handed",1,1,0,2,0.5
0.049,"super bantamweight",18,"right-handed",1,2,0,3,0.333333333333333
0.049,"lightweight",9,"right-handed",1,1,0,2,0.5
0.049,"featherweight",10,"right-handed",1,1,0,2,0.5
0.049,"super bantamweight",9,"right-handed",1,1,0,2,0.5
0.049,"lightweight",14,"right-handed",1,1,0,2,0.5
0.049,"super featherweight",14,"right-handed",1,5,0,6,0.166666666666667
0.049,"heavyweight",19,"right-handed",1,1,0,2,0.5
0.049,"light heavyweight",27,"right-handed",1,4,1,6,0.25
0.049,"middleweight",19,"right-handed",1,1,0,2,0.5
0.049,"flyweight",NA,"right-handed",1,3,0,4,0.25
0.049,"super featherweight",6,"right-handed",1,1,1,3,0.5
0.049,"middleweight",16,"right-handed",1,1,0,2,0.5
0.049,"super featherweight",5,"right-handed",1,1,0,2,0.5
0.049,"cruiserweight",19,"right-handed",1,1,0,2,0.5
0.049,"welterweight",4,"right-handed",1,1,0,2,0.5
0.049,"lightweight",11,"right-handed",1,1,0,2,0.5
0.049,"super flyweight",4,"right-handed",1,1,0,2,0.5
0.049,"welterweight",19,"right-handed",2,8,0,10,0.2
0.049,"super lightweight",18,"right-handed",1,1,0,2,0.5
0.049,"featherweight",12,"right-handed",1,1,1,3,0.5
0.049,"lightweight",9,"right-handed",0,1,0,1,0
0.049,"middleweight",15,"right-handed",0,1,0,1,0
0.049,"super middleweight",3,"right-handed",0,1,0,1,0
0.049,"lightweight",16,"right-handed",0,1,0,1,0
0.049,"cruiserweight",13,"right-handed",0,1,0,1,0
0.049,"flyweight",NA,"right-handed",0,1,1,2,0.25
0.049,"super lightweight",NA,"right-handed",0,1,0,1,0
0.049,"heavyweight",15,"right-handed",0,1,0,1,0
0.049,"light heavyweight",NA,"right-handed",0,1,0,1,0
0.049,"light flyweight",8,"right-handed",0,1,0,1,0
0.049,"lightweight",3,"right-handed",0,1,0,1,0
0.049,"super lightweight",16,"right-handed",0,1,0,1,0
0.049,"lightweight",17,"right-handed",0,1,0,1,0
0.049,"super welterweight",6,"right-handed",0,1,1,2,0.25
0.049,"super bantamweight",NA,"right-handed",0,1,0,1,0
0.049,"cruiserweight",19,"right-handed",0,1,0,1,0
0.049,"super featherweight",5,"right-handed",0,1,0,1,0
0.049,"flyweight",7,"right-handed",0,1,0,1,0
0.049,"lightweight",13,"right-handed",0,1,0,1,0
0.049,"middleweight",21,"right-handed",0,1,0,1,0
0.049,"minimumweight",NA,"right-handed",0,1,0,1,0
0.049,"super featherweight",NA,"right-handed",0,1,0,1,0
0.049,"lightweight",20,"right-handed",0,1,0,1,0
0.049,"welterweight",16,"right-handed",0,1,0,1,0
0.049,"flyweight",4,"right-handed",0,1,1,2,0.25
0.049,"middleweight",8,"right-handed",0,1,0,1,0
0.049,"welterweight",5,"right-handed",0,1,0,1,0
0.049,"middleweight",16,"right-handed",0,1,0,1,0
0.049,"featherweight",10,"right-handed",0,1,0,1,0
0.049,"super middleweight",8,"right-handed",0,1,0,1,0
0.049,"super lightweight",10,"right-handed",0,1,0,1,0
0.049,"welterweight",19,"right-handed",0,1,0,1,0
0.049,"cruiserweight",15,"right-handed",0,1,0,1,0
0.049,"cruiserweight",16,"right-handed",0,1,0,1,0
0.049,"super featherweight",11,"right-handed",0,1,0,1,0
0.049,"minimumweight",11,"right-handed",0,1,0,1,0
0.049,"super middleweight",14,"right-handed",0,1,0,1,0
0.049,"heavyweight",24,"right-handed",0,1,0,1,0
0.049,"featherweight",9,"right-handed",0,1,0,1,0
0.049,"lightweight",3,"right-handed",0,1,0,1,0
0.049,"super lightweight",10,"right-handed",0,1,0,1,0
0.049,"light heavyweight",17,"right-handed",0,1,0,1,0
0.049,"flyweight",11,"right-handed",0,1,0,1,0
0.049,"minimumweight",NA,"right-handed",0,1,0,1,0
0.049,"super middleweight",6,"right-handed",0,1,0,1,0
0.049,"super welterweight",15,"right-handed",0,1,0,1,0
0.049,"heavyweight",11,"right-handed",0,1,0,1,0
0.049,"super lightweight",5,"right-handed",0,1,0,1,0
0.049,"light heavyweight",5,"right-handed",0,1,0,1,0
0.049,"heavyweight",12,"right-handed",0,1,0,1,0
0.049,"featherweight",4,"right-handed",0,1,0,1,0
0.049,"lightweight",16,"right-handed",0,1,0,1,0
0.049,"lightweight",18,"right-handed",0,1,0,1,0
0.049,"light flyweight",3,"right-handed",0,1,0,1,0
0.049,"welterweight",12,"right-handed",0,1,0,1,0
0.049,"middleweight",23,"right-handed",0,1,0,1,0
0.049,"welterweight",10,"right-handed",0,1,0,1,0
0.049,"welterweight",6,"right-handed",0,1,1,2,0.25
0.049,"super welterweight",NA,"right-handed",0,1,0,1,0
0.049,"",8,"right-handed",0,1,0,1,0
0.049,"flyweight",NA,"right-handed",0,1,0,1,0
0.049,"welterweight",6,"right-handed",0,1,0,1,0
0.049,"lightweight",11,"right-handed",0,1,0,1,0
0.049,"featherweight",6,"right-handed",0,1,0,1,0
0.049,"cruiserweight",16,"right-handed",0,1,0,1,0
0.049,"",7,"right-handed",0,1,0,1,0
0.049,"light heavyweight",12,"right-handed",0,1,0,1,0
0.049,"cruiserweight",19,"right-handed",0,1,0,1,0
0.049,"cruiserweight",20,"right-handed",0,1,0,1,0
0.049,"",9,"right-handed",0,1,0,1,0
0.049,"welterweight",19,"right-handed",0,1,0,1,0
0.049,"featherweight",7,"right-handed",0,1,0,1,0
0.049,"light flyweight",14,"right-handed",0,1,0,1,0
0.049,"middleweight",17,"right-handed",0,1,0,1,0
0.049,"light heavyweight",19,"right-handed",0,1,0,1,0
0.049,"middleweight",16,"right-handed",0,1,0,1,0
0.049,"",11,"right-handed",0,1,0,1,0
0.049,"lightweight",10,"right-handed",0,1,0,1,0
0.049,"super featherweight",9,"right-handed",0,1,0,1,0
0.049,"super bantamweight",5,"right-handed",0,1,0,1,0
0.049,"bantamweight",NA,"right-handed",0,1,0,1,0
0.049,"super flyweight",5,"right-handed",0,1,0,1,0
0.049,"light heavyweight",17,"right-handed",0,1,0,1,0
0.049,"featherweight",NA,"right-handed",0,1,0,1,0
0.049,"cruiserweight",11,"right-handed",0,1,0,1,0
0.049,"flyweight",11,"right-handed",0,1,0,1,0
0.049,"super flyweight",9,"right-handed",0,1,0,1,0
0.049,"bantamweight",NA,"right-handed",0,1,1,2,0.25
0.049,"heavyweight",7,"right-handed",0,1,0,1,0
0.049,"light flyweight",11,"right-handed",0,1,0,1,0
0.049,"welterweight",22,"right-handed",0,1,0,1,0
0.049,"super featherweight",10,"right-handed",0,1,0,1,0
0.049,"lightweight",7,"right-handed",0,1,0,1,0
0.049,"super bantamweight",NA,"right-handed",0,1,0,1,0
0.049,"super lightweight",11,"right-handed",0,1,0,1,0
0.049,"welterweight",NA,"right-handed",0,1,0,1,0
0.049,"super lightweight",NA,"right-handed",0,1,0,1,0
0.049,"super featherweight",4,"right-handed",0,1,0,1,0
0.049,"light heavyweight",NA,"right-handed",0,1,0,1,0
0.049,"flyweight",23,"right-handed",0,1,0,1,0
0.049,"super middleweight",17,"right-handed",0,1,0,1,0
0.049,"light flyweight",8,"right-handed",0,1,0,1,0
0.049,"super featherweight",4,"right-handed",0,1,0,1,0
0.049,"lightweight",10,"right-handed",0,1,0,1,0
0.049,"light heavyweight",23,"right-handed",0,1,1,2,0.25
0.049,"super featherweight",5,"right-handed",0,1,0,1,0
0.049,"lightweight",13,"right-handed",0,1,0,1,0
0.049,"featherweight",NA,"right-handed",0,1,0,1,0
0.049,"super middleweight",20,"right-handed",0,1,0,1,0
0.049,"welterweight",11,"right-handed",0,1,0,1,0
0.049,"featherweight",NA,"right-handed",0,1,0,1,0
0.049,"super middleweight",15,"right-handed",0,1,0,1,0
0.049,"lightweight",5,"right-handed",0,1,0,1,0
0.049,"super featherweight",5,"right-handed",0,1,0,1,0
0.049,"bantamweight",6,"right-handed",0,1,0,1,0
0.049,"cruiserweight",21,"right-handed",0,1,0,1,0
0.049,"middleweight",8,"right-handed",0,1,0,1,0
0.049,"bantamweight",8,"right-handed",0,1,0,1,0
0.049,"super lightweight",5,"right-handed",0,1,0,1,0
0.049,"flyweight",7,"right-handed",0,1,0,1,0
0.049,"super featherweight",11,"right-handed",0,1,0,1,0
0.049,"super bantamweight",16,"right-handed",0,1,0,1,0
0.049,"super bantamweight",7,"right-handed",0,1,0,1,0
0.049,"light flyweight",9,"right-handed",0,1,0,1,0
0.049,"super flyweight",4,"right-handed",0,1,0,1,0
0.049,"super featherweight",11,"right-handed",0,1,0,1,0
0.049,"super flyweight",12,"right-handed",0,1,0,1,0
0.049,"bantamweight",4,"right-handed",0,1,0,1,0
0.049,"super bantamweight",3,"right-handed",0,1,0,1,0
0.049,"super lightweight",15,"right-handed",0,1,0,1,0
0.049,"cruiserweight",16,"right-handed",0,1,0,1,0
0.049,"light heavyweight",22,"right-handed",0,1,0,1,0
0.049,"heavyweight",17,"right-handed",0,1,0,1,0
0.049,"cruiserweight",10,"right-handed",0,1,0,1,0
0.049,"cruiserweight",22,"right-handed",0,1,0,1,0
0.049,"lightweight",10,"right-handed",0,1,0,1,0
0.049,"super lightweight",22,"right-handed",0,1,0,1,0
0.049,"cruiserweight",8,"right-handed",0,1,0,1,0
0.049,"bantamweight",NA,"right-handed",0,1,0,1,0
0.049,"super welterweight",14,"right-handed",0,1,0,1,0
0.049,"light heavyweight",16,"right-handed",0,1,0,1,0
0.049,"middleweight",6,"right-handed",0,1,0,1,0
0.049,"featherweight",12,"right-handed",0,1,0,1,0
0.049,"super welterweight",NA,"right-handed",0,1,0,1,0
0.049,"featherweight",10,"right-handed",0,1,0,1,0
0.049,"super middleweight",NA,"right-handed",0,1,1,2,0.25
0.049,"featherweight",19,"right-handed",0,1,0,1,0
0.049,"light flyweight",10,"right-handed",0,1,0,1,0
0.049,"minimumweight",NA,"right-handed",0,1,0,1,0
0.049,"light flyweight",6,"right-handed",0,1,0,1,0
0.049,"super lightweight",4,"right-handed",0,1,0,1,0
0.049,"super lightweight",13,"right-handed",0,1,0,1,0
0.049,"featherweight",11,"right-handed",0,1,0,1,0
0.049,"super welterweight",NA,"right-handed",0,1,0,1,0
0.049,"heavyweight",12,"right-handed",0,1,0,1,0
0.049,"super featherweight",9,"right-handed",0,1,0,1,0
0.049,"super welterweight",15,"right-handed",0,1,0,1,0
0.049,"lightweight",7,"right-handed",0,1,0,1,0
0.049,"featherweight",10,"right-handed",0,1,0,1,0
0.049,"super bantamweight",18,"right-handed",0,1,0,1,0
0.049,"super flyweight",8,"right-handed",0,1,0,1,0
0.049,"minimumweight",3,"right-handed",0,1,1,2,0.25
0.049,"middleweight",9,"right-handed",0,1,0,1,0
0.049,"middleweight",32,"right-handed",0,1,0,1,0
0.049,"super welterweight",14,"right-handed",9,18,3,30,0.35
0.049,"light flyweight",6,"right-handed",0,1,0,1,0
0.049,"super lightweight",14,"right-handed",0,1,0,1,0
0.049,"middleweight",19,"right-handed",0,1,0,1,0
0.049,"heavyweight",11,"right-handed",0,1,0,1,0
0.049,"lightweight",9,"right-handed",0,1,0,1,0
0.049,"",11,"right-handed",0,1,0,1,0
0.049,"featherweight",7,"right-handed",0,1,0,1,0
0.049,"super featherweight",5,"right-handed",0,1,0,1,0
0.049,"light heavyweight",20,"right-handed",0,1,0,1,0
0.049,"super lightweight",8,"right-handed",0,1,0,1,0
0.049,"middleweight",12,"right-handed",0,1,0,1,0
0.049,"super lightweight",15,"right-handed",0,1,0,1,0
0.049,"super welterweight",5,"right-handed",0,1,0,1,0
0.049,"super welterweight",7,"right-handed",0,1,0,1,0
0.049,"super featherweight",6,"right-handed",0,1,0,1,0
0.049,"super featherweight",6,"right-handed",0,1,1,2,0.25
0.049,"super featherweight",11,"right-handed",0,1,0,1,0
0.049,"minimumweight",NA,"right-handed",0,1,1,2,0.25
0.049,"",6,"right-handed",0,1,0,1,0
0.049,"minimumweight",NA,"right-handed",0,1,0,1,0
0.049,"super lightweight",5,"right-handed",0,1,0,1,0
0.049,"lightweight",14,"right-handed",0,1,0,1,0
0.049,"super lightweight",NA,"right-handed",0,1,0,1,0
0.049,"super flyweight",4,"right-handed",0,1,0,1,0
0.049,"featherweight",20,"right-handed",0,1,0,1,0
0.049,"middleweight",11,"right-handed",0,1,0,1,0
0.049,"super bantamweight",7,"right-handed",0,1,0,1,0
0.049,"super welterweight",12,"right-handed",0,1,0,1,0
0.049,"super welterweight",5,"right-handed",0,1,0,1,0
0.049,"super bantamweight",10,"right-handed",0,1,0,1,0
0.049,"middleweight",16,"right-handed",0,1,0,1,0
0.049,"cruiserweight",10,"right-handed",0,1,0,1,0
0.049,"middleweight",29,"right-handed",0,1,0,1,0
0.049,"featherweight",21,"right-handed",0,1,0,1,0
0.049,"",19,"right-handed",0,1,0,1,0
0.049,"super middleweight",6,"right-handed",0,1,0,1,0
0.049,"minimumweight",17,"right-handed",0,1,0,1,0
0.049,"super flyweight",23,"right-handed",0,1,0,1,0
0.049,"super featherweight",4,"right-handed",0,1,0,1,0
0.049,"welterweight",17,"right-handed",0,1,0,1,0
0.049,"lightweight",20,"right-handed",0,1,0,1,0
0.049,"super flyweight",NA,"right-handed",0,1,1,2,0.25
0.049,"super middleweight",12,"right-handed",0,1,1,2,0.25
0.049,"middleweight",17,"right-handed",0,1,0,1,0
0.049,"super flyweight",11,"right-handed",0,1,1,2,0.25
0.049,"light flyweight",5,"right-handed",0,1,0,1,0
0.049,"super featherweight",16,"right-handed",0,1,0,1,0
0.049,"lightweight",5,"right-handed",0,1,0,1,0
0.049,"super middleweight",24,"right-handed",0,1,0,1,0
0.049,"super bantamweight",12,"right-handed",0,1,0,1,0
0.049,"super featherweight",18,"right-handed",0,1,1,2,0.25
0.049,"minimumweight",14,"right-handed",9,10,2,21,0.476190476190476
0.049,"super lightweight",20,"right-handed",0,1,0,1,0
0.049,"super bantamweight",8,"right-handed",0,1,0,1,0
0.049,"",12,"right-handed",0,1,0,1,0
0.049,"super lightweight",16,"right-handed",0,1,0,1,0
0.049,"super featherweight",8,"right-handed",0,1,0,1,0
0.049,"bantamweight",8,"right-handed",0,1,0,1,0
0.049,"super flyweight",22,"right-handed",0,1,0,1,0
0.049,"welterweight",19,"right-handed",0,1,0,1,0
0.049,"featherweight",NA,"right-handed",0,1,0,1,0
0.049,"super bantamweight",13,"right-handed",0,1,0,1,0
0.049,"middleweight",8,"right-handed",0,1,0,1,0
0.049,"featherweight",5,"right-handed",0,1,1,2,0.25
0.049,"super bantamweight",12,"right-handed",0,1,1,2,0.25
0.049,"lightweight",19,"right-handed",0,1,0,1,0
0.049,"super welterweight",8,"right-handed",0,1,0,1,0
0.049,"lightweight",8,"right-handed",0,1,0,1,0
0.049,"light flyweight",4,"right-handed",0,1,0,1,0
0.049,"super bantamweight",9,"right-handed",0,1,0,1,0
0.049,"super lightweight",11,"right-handed",0,1,0,1,0
0.049,"super bantamweight",8,"right-handed",0,1,0,1,0
0.049,"featherweight",12,"right-handed",0,1,0,1,0
0.049,"",30,"right-handed",0,1,0,1,0
0.049,"lightweight",15,"right-handed",0,1,1,2,0.25
0.049,"welterweight",4,"right-handed",0,1,0,1,0
0.049,"lightweight",4,"right-handed",0,1,0,1,0
0.049,"middleweight",14,"right-handed",0,1,0,1,0
0.049,"super lightweight",NA,"right-handed",0,1,0,1,0
0.049,"middleweight",NA,"right-handed",0,1,0,1,0
0.049,"featherweight",NA,"right-handed",0,1,0,1,0
0.049,"flyweight",NA,"right-handed",0,1,0,1,0
0.049,"super bantamweight",7,"right-handed",0,1,0,1,0
0.049,"super middleweight",10,"right-handed",0,1,0,1,0
0.049,"light flyweight",2,"right-handed",0,1,0,1,0
0.049,"super middleweight",16,"right-handed",0,1,0,1,0
0.049,"heavyweight",15,"right-handed",0,1,0,1,0
0.049,"super middleweight",13,"right-handed",0,1,0,1,0
0.049,"lightweight",4,"right-handed",0,1,0,1,0
0.049,"featherweight",NA,"right-handed",0,1,0,1,0
0.049,"super lightweight",10,"right-handed",0,1,0,1,0
0.049,"super lightweight",NA,"right-handed",0,1,0,1,0
0.049,"welterweight",6,"right-handed",0,1,0,1,0
0.049,"super middleweight",16,"right-handed",0,1,0,1,0
0.049,"flyweight",7,"right-handed",0,1,0,1,0
0.049,"lightweight",14,"right-handed",0,1,1,2,0.25
0.049,"welterweight",19,"right-handed",0,1,0,1,0
0.049,"super lightweight",10,"right-handed",0,1,0,1,0
0.049,"super lightweight",5,"right-handed",0,1,0,1,0
0.049,"super welterweight",12,"right-handed",0,1,0,1,0
0.049,"bantamweight",10,"right-handed",0,1,0,1,0
0.049,"super welterweight",17,"right-handed",0,1,0,1,0
0.049,"light flyweight",9,"right-handed",0,1,0,1,0
0.049,"light flyweight",5,"right-handed",0,1,0,1,0
0.049,"super featherweight",6,"right-handed",0,1,0,1,0
0.049,"welterweight",17,"right-handed",0,1,0,1,0
0.049,"super welterweight",17,"right-handed",0,1,0,1,0
0.049,"featherweight",NA,"right-handed",0,1,0,1,0
0.049,"lightweight",21,"right-handed",0,1,0,1,0
0.049,"super flyweight",8,"right-handed",0,1,1,2,0.25
0.049,"",7,"right-handed",0,1,0,1,0
0.049,"",16,"right-handed",0,1,0,1,0
0.049,"featherweight",11,"right-handed",0,1,0,1,0
0.049,"featherweight",10,"right-handed",0,1,0,1,0
0.049,"super middleweight",9,"right-handed",0,1,0,1,0
0.049,"heavyweight",26,"right-handed",0,1,0,1,0
0.049,"super bantamweight",9,"right-handed",0,1,0,1,0
0.049,"super welterweight",17,"right-handed",0,1,0,1,0
0.049,"super welterweight",12,"right-handed",0,1,0,1,0
0.049,"super featherweight",6,"right-handed",0,1,0,1,0
0.049,"super welterweight",11,"right-handed",0,1,0,1,0
0.049,"minimumweight",13,"right-handed",0,1,0,1,0
0.049,"super welterweight",9,"right-handed",0,1,0,1,0
0.049,"super lightweight",12,"right-handed",0,1,0,1,0
0.049,"super bantamweight",4,"right-handed",0,1,0,1,0
0.049,"flyweight",17,"right-handed",0,1,0,1,0
0.049,"super flyweight",21,"right-handed",0,1,0,1,0
0.049,"lightweight",7,"right-handed",0,1,0,1,0
0.049,"super lightweight",13,"right-handed",0,1,0,1,0
0.049,"",5,"right-handed",0,1,0,1,0
0.049,"",20,"right-handed",0,1,0,1,0
0.049,"welterweight",9,"right-handed",0,1,0,1,0
0.049,"flyweight",6,"right-handed",0,1,0,1,0
0.049,"heavyweight",11,"right-handed",0,1,0,1,0
0.049,"cruiserweight",12,"right-handed",0,1,0,1,0
0.049,"welterweight",14,"right-handed",0,1,1,2,0.25
0.049,"super welterweight",15,"right-handed",0,1,0,1,0
0.049,"middleweight",10,"right-handed",0,1,1,2,0.25
0.049,"bantamweight",20,"right-handed",0,1,0,1,0
0.049,"minimumweight",7,"right-handed",0,1,1,2,0.25
0.049,"lightweight",6,"right-handed",0,1,0,1,0
0.049,"super lightweight",8,"right-handed",0,1,0,1,0
0.049,"featherweight",8,"right-handed",0,1,0,1,0
0.049,"welterweight",5,"right-handed",0,1,0,1,0
0.049,"lightweight",19,"right-handed",0,1,0,1,0
0.049,"flyweight",12,"right-handed",0,1,0,1,0
0.049,"super flyweight",23,"right-handed",0,1,0,1,0
0.049,"super bantamweight",11,"right-handed",0,1,0,1,0
0.049,"super welterweight",16,"right-handed",0,1,0,1,0
0.049,"lightweight",4,"right-handed",0,1,0,1,0
0.049,"super middleweight",18,"right-handed",0,1,0,1,0
0.049,"featherweight",16,"right-handed",0,1,0,1,0
0.049,"super lightweight",4,"right-handed",0,1,0,1,0
0.049,"light flyweight",NA,"right-handed",0,1,0,1,0
0.049,"super featherweight",6,"right-handed",0,1,0,1,0
0.049,"super flyweight",16,"right-handed",0,1,0,1,0
0.049,"cruiserweight",20,"right-handed",0,1,1,2,0.25
0.049,"super welterweight",18,"right-handed",0,1,0,1,0
0.049,"bantamweight",NA,"right-handed",0,1,0,1,0
0.049,"flyweight",13,"right-handed",0,1,0,1,0
0.049,"flyweight",NA,"right-handed",0,1,0,1,0
0.049,"bantamweight",8,"right-handed",0,1,0,1,0
0.049,"super bantamweight",4,"right-handed",0,1,0,1,0
0.049,"super lightweight",3,"right-handed",0,1,0,1,0
0.049,"super lightweight",7,"right-handed",0,1,0,1,0
0.049,"welterweight",NA,"right-handed",0,1,0,1,0
0.049,"welterweight",NA,"right-handed",0,1,0,1,0
0.049,"super featherweight",NA,"right-handed",0,1,0,1,0
0.049,"bantamweight",8,"right-handed",0,1,0,1,0
0.049,"welterweight",12,"right-handed",0,1,0,1,0
0.049,"featherweight",9,"right-handed",0,1,0,1,0
0.049,"super lightweight",4,"right-handed",0,1,0,1,0
0.049,"featherweight",11,"right-handed",0,1,0,1,0
0.049,"super welterweight",13,"right-handed",0,1,0,1,0
0.049,"super welterweight",11,"right-handed",0,1,0,1,0
0.049,"cruiserweight",4,"right-handed",0,1,0,1,0
0.049,"lightweight",10,"right-handed",0,1,0,1,0
0.049,"super bantamweight",4,"right-handed",0,1,0,1,0
0.049,"super featherweight",14,"right-handed",0,1,0,1,0
0.049,"super middleweight",8,"right-handed",0,1,0,1,0
0.049,"cruiserweight",15,"right-handed",0,1,0,1,0
0.049,"heavyweight",8,"right-handed",0,1,0,1,0
0.049,"cruiserweight",16,"right-handed",0,1,0,1,0
0.049,"light heavyweight",14,"right-handed",0,1,0,1,0
0.049,"",12,"right-handed",0,1,0,1,0
0.049,"heavyweight",15,"right-handed",0,1,0,1,0
0.049,"super welterweight",13,"right-handed",0,1,0,1,0
0.049,"featherweight",6,"right-handed",0,1,0,1,0
0.049,"super featherweight",8,"right-handed",0,1,0,1,0
0.049,"featherweight",15,"right-handed",0,1,0,1,0
0.049,"super middleweight",22,"right-handed",0,1,0,1,0
0.049,"super bantamweight",5,"right-handed",0,1,0,1,0
0.049,"super lightweight",13,"right-handed",0,1,0,1,0
0.049,"cruiserweight",NA,"right-handed",0,1,0,1,0
0.049,"welterweight",11,"right-handed",0,1,0,1,0
0.049,"super flyweight",15,"right-handed",0,1,0,1,0
0.049,"featherweight",NA,"right-handed",0,1,0,1,0
0.049,"super bantamweight",8,"right-handed",0,1,0,1,0
0.049,"super featherweight",5,"right-handed",0,1,0,1,0
0.049,"middleweight",4,"right-handed",0,1,0,1,0
0.049,"middleweight",13,"right-handed",0,1,0,1,0
0.049,"cruiserweight",16,"right-handed",0,1,0,1,0
0.049,"bantamweight",15,"right-handed",0,1,0,1,0
0.049,"featherweight",14,"right-handed",0,1,1,2,0.25
0.049,"welterweight",3,"right-handed",0,1,1,2,0.25
0.049,"featherweight",7,"right-handed",0,1,0,1,0
0.049,"welterweight",17,"right-handed",0,1,0,1,0
0.049,"super featherweight",18,"right-handed",0,1,0,1,0
0.049,"",10,"right-handed",0,1,0,1,0
0.049,"welterweight",29,"right-handed",0,1,0,1,0
0.049,"welterweight",20,"right-handed",0,1,0,1,0
0.049,"super bantamweight",8,"right-handed",0,1,0,1,0
0.049,"",7,"right-handed",0,1,0,1,0
0.049,"welterweight",17,"right-handed",2,6,0,8,0.25
0.049,"super middleweight",18,"right-handed",4,6,0,10,0.4
0.049,"welterweight",12,"right-handed",4,6,2,12,0.416666666666667
0.049,"lightweight",30,"right-handed",16,52,2,70,0.242857142857143
0.049,"super featherweight",13,"right-handed",3,4,0,7,0.428571428571429
0.049,"lightweight",14,"right-handed",5,82,2,89,0.0674157303370786
0.049,"super lightweight",12,"right-handed",2,7,1,10,0.25
0.049,"super middleweight",NA,"right-handed",3,2,0,5,0.6
0.049,"lightweight",7,"right-handed",9,2,1,12,0.791666666666667
0.049,"cruiserweight",20,"right-handed",15,7,2,24,0.666666666666667
0.049,"lightweight",16,"right-handed",1,4,1,6,0.25
0.049,"lightweight",12,"right-handed",2,1,1,4,0.625
0.049,"flyweight",23,"right-handed",9,2,0,11,0.818181818181818
0.049,"super middleweight",14,"right-handed",10,4,1,15,0.7
0.049,"super welterweight",16,"right-handed",27,86,3,116,0.245689655172414
0.049,"light heavyweight",20,"right-handed",12,39,4,55,0.254545454545455
0.049,"cruiserweight",NA,"right-handed",2,3,0,5,0.4
0.049,"super welterweight",12,"right-handed",1,1,1,3,0.5
0.049,"middleweight",11,"right-handed",11,2,0,13,0.846153846153846
0.049,"super bantamweight",7,"right-handed",5,2,2,9,0.666666666666667
0.049,"light heavyweight",31,"right-handed",1,2,1,4,0.375
0.049,"super middleweight",25,"right-handed",31,27,0,58,0.53448275862069
0.049,"lightweight",25,"right-handed",5,28,2,35,0.171428571428571
0.049,"super featherweight",8,"right-handed",19,3,0,22,0.863636363636364
0.049,"super bantamweight",9,"right-handed",4,4,0,8,0.5
0.049,"heavyweight",15,"right-handed",5,2,0,7,0.714285714285714
0.049,"super lightweight",5,"right-handed",1,2,0,3,0.333333333333333
0.049,"bantamweight",22,"right-handed",4,3,1,8,0.5625
0.049,"super middleweight",18,"right-handed",18,22,2,42,0.452380952380952
0.049,"super welterweight",15,"right-handed",8,2,0,10,0.8
0.049,"lightweight",9,"right-handed",1,2,0,3,0.333333333333333
0.049,"super flyweight",12,"right-handed",3,6,3,12,0.375
0.049,"super featherweight",8,"right-handed",2,2,0,4,0.5
0.049,"super middleweight",14,"right-handed",13,5,0,18,0.722222222222222
0.049,"super featherweight",11,"right-handed",7,1,1,9,0.833333333333333
0.049,"heavyweight",13,"right-handed",4,2,0,6,0.666666666666667
0.049,"lightweight",NA,"right-handed",5,3,1,9,0.611111111111111
0.049,"super middleweight",15,"right-handed",7,2,0,9,0.777777777777778
0.049,"lightweight",11,"right-handed",3,2,0,5,0.6
0.049,"heavyweight",23,"right-handed",6,2,0,8,0.75
0.049,"featherweight",24,"right-handed",10,29,0,39,0.256410256410256
0.049,"lightweight",20,"right-handed",10,3,0,13,0.769230769230769
0.049,"super middleweight",22,"right-handed",10,6,0,16,0.625
0.049,"heavyweight",16,"right-handed",7,3,0,10,0.7
0.049,"super featherweight",12,"right-handed",1,3,1,5,0.3
0.049,"super bantamweight",9,"right-handed",4,5,0,9,0.444444444444444
0.048,"super featherweight",13,"right-handed",5,3,3,11,0.590909090909091
0.048,"lightweight",12,"right-handed",1,8,0,9,0.111111111111111
0.048,"super lightweight",17,"right-handed",8,8,0,16,0.5
0.048,"lightweight",5,"right-handed",4,1,0,5,0.8
0.048,"heavyweight",19,"right-handed",7,6,0,13,0.538461538461538
0.048,"heavyweight",15,"right-handed",9,8,1,18,0.527777777777778
0.048,"middleweight",NA,"right-handed",6,4,0,10,0.6
0.048,"super lightweight",12,"right-handed",6,3,1,10,0.65
0.048,"cruiserweight",12,"right-handed",8,10,0,18,0.444444444444444
0.048,"lightweight",16,"right-handed",3,2,0,5,0.6
0.048,"light heavyweight",16,"right-handed",1,2,0,3,0.333333333333333
0.048,"super featherweight",16,"right-handed",5,2,0,7,0.714285714285714
0.048,"middleweight",8,"right-handed",8,8,0,16,0.5
0.048,"super featherweight",10,"right-handed",6,7,0,13,0.461538461538462
0.048,"super welterweight",9,"right-handed",5,6,1,12,0.458333333333333
0.048,"super bantamweight",22,"right-handed",3,2,1,6,0.583333333333333
0.048,"super bantamweight",8,"right-handed",9,8,0,17,0.529411764705882
0.048,"cruiserweight",19,"right-handed",6,1,0,7,0.857142857142857
0.048,"super featherweight",11,"right-handed",4,2,1,7,0.642857142857143
0.048,"super featherweight",11,"right-handed",2,24,1,27,0.0925925925925926
0.048,"light heavyweight",17,"right-handed",2,2,0,4,0.5
0.048,"super welterweight",10,"right-handed",4,2,0,6,0.666666666666667
0.048,"light flyweight",9,"right-handed",4,2,1,7,0.642857142857143
0.048,"flyweight",5,"right-handed",2,2,0,4,0.5
0.048,"heavyweight",21,"right-handed",4,1,0,5,0.8
0.048,"super featherweight",14,"right-handed",5,2,0,7,0.714285714285714
0.048,"super welterweight",17,"right-handed",5,2,0,7,0.714285714285714
0.048,"cruiserweight",NA,"right-handed",2,5,0,7,0.285714285714286
0.048,"super featherweight",7,"right-handed",4,5,0,9,0.444444444444444
0.048,"bantamweight",9,"right-handed",5,3,0,8,0.625
0.048,"flyweight",10,"right-handed",4,3,0,7,0.571428571428571
0.048,"super flyweight",13,"right-handed",3,2,0,5,0.6
0.048,"super lightweight",11,"right-handed",5,5,0,10,0.5
0.048,"super welterweight",19,"right-handed",5,12,1,18,0.305555555555556
0.048,"super featherweight",6,"right-handed",3,2,2,7,0.571428571428571
0.048,"heavyweight",17,"right-handed",4,2,0,6,0.666666666666667
0.048,"flyweight",12,"right-handed",3,3,1,7,0.5
0.048,"bantamweight",5,"right-handed",4,3,0,7,0.571428571428571
0.048,"bantamweight",11,"right-handed",6,4,0,10,0.6
0.048,"super middleweight",12,"right-handed",4,2,1,7,0.642857142857143
0.048,"flyweight",4,"right-handed",3,2,0,5,0.6
0.048,"super welterweight",25,"right-handed",7,24,0,31,0.225806451612903
0.048,"super welterweight",20,"right-handed",3,2,0,5,0.6
0.048,"super welterweight",11,"right-handed",4,3,0,7,0.571428571428571
0.048,"super flyweight",12,"right-handed",4,6,2,12,0.416666666666667
0.048,"super featherweight",21,"right-handed",4,3,1,8,0.5625
0.048,"bantamweight",5,"right-handed",4,7,2,13,0.384615384615385
0.048,"super featherweight",18,"right-handed",4,6,0,10,0.4
0.048,"super featherweight",6,"right-handed",5,2,1,8,0.6875
0.048,"minimumweight",7,"right-handed",4,4,0,8,0.5
0.048,"heavyweight",12,"right-handed",4,2,0,6,0.666666666666667
0.048,"light heavyweight",20,"right-handed",5,2,0,7,0.714285714285714
0.048,"super bantamweight",14,"right-handed",3,1,1,5,0.7
0.048,"featherweight",11,"right-handed",5,6,0,11,0.454545454545455
0.048,"heavyweight",13,"right-handed",1,5,0,6,0.166666666666667
0.048,"welterweight",15,"right-handed",3,2,1,6,0.583333333333333
0.048,"heavyweight",11,"right-handed",5,11,1,17,0.323529411764706
0.048,"lightweight",11,"right-handed",2,2,1,5,0.5
0.048,"minimumweight",20,"right-handed",2,4,0,6,0.333333333333333
0.048,"minimumweight",8,"right-handed",3,3,0,6,0.5
0.048,"super lightweight",17,"right-handed",2,2,0,4,0.5
0.048,"super lightweight",13,"right-handed",1,2,2,5,0.4
0.048,"super lightweight",20,"right-handed",2,4,0,6,0.333333333333333
0.048,"super middleweight",23,"right-handed",4,14,2,20,0.25
0.048,"cruiserweight",16,"right-handed",3,2,0,5,0.6
0.048,"super welterweight",14,"right-handed",5,6,1,12,0.458333333333333
0.048,"super welterweight",12,"right-handed",2,3,0,5,0.4
0.048,"super lightweight",23,"right-handed",3,2,0,5,0.6
0.048,"lightweight",9,"right-handed",3,4,0,7,0.428571428571429
0.048,"cruiserweight",19,"right-handed",3,2,1,6,0.583333333333333
0.048,"welterweight",13,"right-handed",2,2,0,4,0.5
0.048,"heavyweight",9,"right-handed",2,2,0,4,0.5
0.048,"lightweight",16,"right-handed",2,2,1,5,0.5
0.048,"featherweight",18,"right-handed",2,3,0,5,0.4
0.048,"heavyweight",23,"right-handed",8,21,1,30,0.283333333333333
0.048,"super flyweight",10,"right-handed",2,3,0,5,0.4
0.048,"super lightweight",3,"right-handed",3,10,0,13,0.230769230769231
0.048,"lightweight",13,"right-handed",2,3,0,5,0.4
0.048,"light heavyweight",NA,"right-handed",3,5,0,8,0.375
0.048,"welterweight",10,"right-handed",5,8,0,13,0.384615384615385
0.048,"super middleweight",15,"right-handed",3,4,0,7,0.428571428571429
0.048,"minimumweight",11,"right-handed",2,2,0,4,0.5
0.048,"featherweight",22,"right-handed",2,3,1,6,0.416666666666667
0.048,"middleweight",16,"right-handed",2,4,1,7,0.357142857142857
0.048,"light flyweight",10,"right-handed",2,4,0,6,0.333333333333333
0.048,"super welterweight",11,"right-handed",2,2,0,4,0.5
0.048,"super welterweight",10,"right-handed",3,2,1,6,0.583333333333333
0.048,"super flyweight",21,"right-handed",2,4,0,6,0.333333333333333
0.048,"heavyweight",9,"right-handed",3,2,0,5,0.6
0.048,"bantamweight",18,"right-handed",4,7,0,11,0.363636363636364
0.048,"featherweight",9,"right-handed",2,2,1,5,0.5
0.048,"super featherweight",17,"right-handed",2,3,0,5,0.4
0.048,"super welterweight",5,"right-handed",3,5,0,8,0.375
0.048,"super featherweight",5,"right-handed",2,2,0,4,0.5
0.048,"featherweight",8,"right-handed",2,2,0,4,0.5
0.048,"super welterweight",24,"right-handed",16,64,1,81,0.203703703703704
0.048,"super flyweight",6,"right-handed",2,2,2,6,0.5
0.048,"super lightweight",3,"right-handed",3,2,0,5,0.6
0.048,"bantamweight",15,"right-handed",2,2,1,5,0.5
0.048,"welterweight",23,"right-handed",2,3,0,5,0.4
0.048,"super welterweight",6,"right-handed",2,4,0,6,0.333333333333333
0.048,"super lightweight",12,"right-handed",2,3,0,5,0.4
0.048,"super bantamweight",7,"right-handed",2,2,0,4,0.5
0.048,"super lightweight",19,"right-handed",9,60,2,71,0.140845070422535
0.048,"featherweight",11,"right-handed",3,2,0,5,0.6
0.048,"super bantamweight",8,"right-handed",2,2,0,4,0.5
0.048,"super lightweight",4,"right-handed",2,2,0,4,0.5
0.048,"super lightweight",14,"right-handed",3,2,0,5,0.6
0.048,"bantamweight",12,"right-handed",3,4,0,7,0.428571428571429
0.048,"super featherweight",20,"right-handed",4,6,0,10,0.4
0.048,"bantamweight",8,"right-handed",2,3,0,5,0.4
0.048,"super featherweight",18,"right-handed",3,3,0,6,0.5
0.048,"heavyweight",NA,"right-handed",2,2,1,5,0.5
0.048,"heavyweight",NA,"right-handed",3,4,1,8,0.4375
0.048,"cruiserweight",15,"right-handed",2,2,0,4,0.5
0.048,"super bantamweight",10,"right-handed",4,11,0,15,0.266666666666667
0.048,"featherweight",12,"right-handed",2,3,0,5,0.4
0.048,"super middleweight",17,"right-handed",4,10,0,14,0.285714285714286
0.048,"welterweight",13,"right-handed",3,7,0,10,0.3
0.048,"bantamweight",8,"right-handed",2,1,0,3,0.666666666666667
0.048,"lightweight",15,"right-handed",3,4,1,8,0.4375
0.048,"featherweight",21,"right-handed",3,2,0,5,0.6
0.048,"light flyweight",14,"right-handed",2,2,0,4,0.5
0.048,"featherweight",12,"right-handed",3,3,0,6,0.5
0.048,"middleweight",16,"right-handed",2,4,0,6,0.333333333333333
0.048,"heavyweight",10,"right-handed",3,2,0,5,0.6
0.048,"light heavyweight",16,"right-handed",2,4,2,8,0.375
0.048,"welterweight",13,"right-handed",3,2,0,5,0.6
0.048,"lightweight",11,"right-handed",2,2,0,4,0.5
0.048,"super bantamweight",12,"right-handed",2,7,0,9,0.222222222222222
0.048,"middleweight",7,"right-handed",1,3,2,6,0.333333333333333
0.048,"welterweight",14,"right-handed",10,14,2,26,0.423076923076923
0.048,"super welterweight",14,"right-handed",3,16,0,19,0.157894736842105
0.048,"flyweight",12,"right-handed",2,2,2,6,0.5
0.048,"heavyweight",32,"right-handed",12,13,1,26,0.480769230769231
0.048,"super lightweight",22,"right-handed",2,8,2,12,0.25
0.048,"super bantamweight",13,"right-handed",3,6,2,11,0.363636363636364
0.048,"super welterweight",9,"right-handed",3,3,2,8,0.5
0.048,"super welterweight",8,"right-handed",1,3,0,4,0.25
0.048,"middleweight",12,"right-handed",1,2,0,3,0.333333333333333
0.048,"super bantamweight",17,"right-handed",1,2,0,3,0.333333333333333
0.048,"light heavyweight",7,"right-handed",1,3,1,5,0.3
0.048,"super lightweight",11,"right-handed",2,3,0,5,0.4
0.048,"light flyweight",12,"right-handed",0,2,1,3,0.166666666666667
0.048,"minimumweight",6,"right-handed",1,2,1,4,0.375
0.048,"lightweight",15,"right-handed",0,2,3,5,0.3
0.048,"lightweight",12,"right-handed",1,2,0,3,0.333333333333333
0.048,"light heavyweight",15,"right-handed",1,2,0,3,0.333333333333333
0.048,"light heavyweight",21,"right-handed",2,17,2,21,0.142857142857143
0.048,"super featherweight",14,"right-handed",1,9,0,10,0.1
0.048,"super middleweight",20,"right-handed",8,27,1,36,0.236111111111111
0.048,"super bantamweight",11,"right-handed",1,2,0,3,0.333333333333333
0.048,"super flyweight",10,"right-handed",2,7,0,9,0.222222222222222
0.048,"super welterweight",17,"right-handed",1,2,0,3,0.333333333333333
0.048,"heavyweight",20,"right-handed",2,34,0,36,0.0555555555555556
0.048,"lightweight",9,"right-handed",1,2,0,3,0.333333333333333
0.048,"featherweight",7,"right-handed",1,2,0,3,0.333333333333333
0.048,"super flyweight",6,"right-handed",1,3,1,5,0.3
0.048,"super flyweight",8,"right-handed",1,2,0,3,0.333333333333333
0.048,"minimumweight",NA,"right-handed",1,3,1,5,0.3
0.048,"super bantamweight",10,"right-handed",1,2,0,3,0.333333333333333
0.048,"super welterweight",15,"right-handed",1,3,1,5,0.3
0.048,"super lightweight",10,"right-handed",0,2,1,3,0.166666666666667
0.048,"super bantamweight",8,"right-handed",7,3,0,10,0.7
0.048,"cruiserweight",29,"right-handed",1,3,0,4,0.25
0.048,"bantamweight",11,"right-handed",2,4,0,6,0.333333333333333
0.048,"super bantamweight",22,"right-handed",1,4,0,5,0.2
0.048,"welterweight",19,"right-handed",16,8,0,24,0.666666666666667
0.048,"super bantamweight",5,"right-handed",1,2,0,3,0.333333333333333
0.048,"super lightweight",8,"right-handed",1,2,0,3,0.333333333333333
0.048,"minimumweight",7,"right-handed",1,2,0,3,0.333333333333333
0.048,"super lightweight",12,"right-handed",1,2,0,3,0.333333333333333
0.048,"super flyweight",11,"right-handed",2,4,0,6,0.333333333333333
0.048,"welterweight",9,"right-handed",1,2,0,3,0.333333333333333
0.048,"super lightweight",16,"right-handed",1,8,0,9,0.111111111111111
0.048,"super featherweight",7,"right-handed",1,2,0,3,0.333333333333333
0.048,"super lightweight",15,"right-handed",1,4,0,5,0.2
0.048,"super featherweight",13,"right-handed",1,3,1,5,0.3
0.048,"bantamweight",14,"right-handed",0,2,1,3,0.166666666666667
0.048,"lightweight",7,"right-handed",1,2,0,3,0.333333333333333
0.048,"lightweight",21,"right-handed",1,2,0,3,0.333333333333333
0.048,"light flyweight",6,"right-handed",1,2,1,4,0.375
0.048,"super featherweight",NA,"right-handed",2,3,0,5,0.4
0.048,"super welterweight",9,"right-handed",1,2,0,3,0.333333333333333
0.048,"welterweight",14,"right-handed",1,8,0,9,0.111111111111111
0.048,"super welterweight",6,"right-handed",1,2,1,4,0.375
0.048,"light heavyweight",18,"right-handed",1,1,0,2,0.5
0.048,"super bantamweight",6,"right-handed",1,2,0,3,0.333333333333333
0.048,"super lightweight",15,"right-handed",1,2,0,3,0.333333333333333
0.048,"middleweight",14,"right-handed",1,2,0,3,0.333333333333333
0.048,"super flyweight",7,"right-handed",1,2,0,3,0.333333333333333
0.048,"super flyweight",20,"right-handed",1,3,0,4,0.25
0.048,"welterweight",11,"right-handed",0,2,2,4,0.25
0.048,"super middleweight",16,"right-handed",1,2,0,3,0.333333333333333
0.048,"featherweight",10,"right-handed",1,3,0,4,0.25
0.048,"super welterweight",NA,"right-handed",1,2,0,3,0.333333333333333
0.048,"flyweight",13,"right-handed",2,15,0,17,0.117647058823529
0.048,"super bantamweight",17,"right-handed",1,2,0,3,0.333333333333333
0.048,"lightweight",13,"right-handed",1,5,0,6,0.166666666666667
0.048,"middleweight",19,"right-handed",1,2,0,3,0.333333333333333
0.048,"bantamweight",10,"right-handed",1,5,1,7,0.214285714285714
0.048,"heavyweight",16,"right-handed",1,2,1,4,0.375
0.048,"super flyweight",9,"right-handed",1,3,0,4,0.25
0.048,"super lightweight",5,"right-handed",1,4,0,5,0.2
0.048,"super flyweight",13,"right-handed",1,2,0,3,0.333333333333333
0.048,"super lightweight",12,"right-handed",1,2,0,3,0.333333333333333
0.048,"super flyweight",4,"right-handed",1,2,0,3,0.333333333333333
0.048,"heavyweight",23,"right-handed",1,2,1,4,0.375
0.048,"heavyweight",14,"right-handed",1,10,0,11,0.0909090909090909
0.048,"super bantamweight",12,"right-handed",1,2,1,4,0.375
0.048,"super featherweight",6,"right-handed",1,2,0,3,0.333333333333333
0.048,"featherweight",9,"right-handed",1,3,1,5,0.3
0.048,"flyweight",18,"right-handed",1,2,0,3,0.333333333333333
0.048,"super lightweight",26,"right-handed",1,2,0,3,0.333333333333333
0.048,"super lightweight",13,"right-handed",1,3,0,4,0.25
0.048,"super lightweight",8,"right-handed",1,2,0,3,0.333333333333333
0.048,"middleweight",36,"right-handed",1,2,0,3,0.333333333333333
0.048,"middleweight",10,"right-handed",1,4,0,5,0.2
0.048,"super lightweight",7,"right-handed",1,3,0,4,0.25
0.048,"super lightweight",NA,"right-handed",2,4,0,6,0.333333333333333
0.048,"super lightweight",16,"right-handed",1,2,0,3,0.333333333333333
0.048,"super lightweight",16,"right-handed",1,2,0,3,0.333333333333333
0.048,"lightweight",11,"right-handed",1,2,0,3,0.333333333333333
0.048,"super flyweight",NA,"right-handed",1,2,0,3,0.333333333333333
0.048,"super flyweight",8,"right-handed",1,2,0,3,0.333333333333333
0.048,"featherweight",13,"right-handed",1,4,1,6,0.25
0.048,"super featherweight",15,"right-handed",1,2,0,3,0.333333333333333
0.048,"heavyweight",14,"right-handed",1,1,1,3,0.5
0.048,"lightweight",14,"right-handed",1,2,0,3,0.333333333333333
0.048,"bantamweight",9,"right-handed",1,2,1,4,0.375
0.048,"super lightweight",5,"right-handed",1,2,0,3,0.333333333333333
0.048,"middleweight",13,"right-handed",1,2,1,4,0.375
0.048,"super welterweight",12,"right-handed",1,2,0,3,0.333333333333333
0.048,"super bantamweight",6,"right-handed",1,2,1,4,0.375
0.048,"super flyweight",6,"right-handed",1,2,0,3,0.333333333333333
0.048,"minimumweight",17,"right-handed",1,3,0,4,0.25
0.048,"super featherweight",4,"right-handed",1,2,0,3,0.333333333333333
0.048,"super bantamweight",5,"right-handed",1,4,1,6,0.25
0.048,"super bantamweight",9,"right-handed",1,2,0,3,0.333333333333333
0.048,"super welterweight",12,"right-handed",1,2,0,3,0.333333333333333
0.048,"bantamweight",8,"right-handed",0,2,1,3,0.166666666666667
0.048,"super lightweight",5,"right-handed",1,2,0,3,0.333333333333333
0.048,"flyweight",7,"right-handed",1,3,0,4,0.25
0.048,"super bantamweight",6,"right-handed",1,2,0,3,0.333333333333333
0.048,"featherweight",17,"right-handed",1,2,1,4,0.375
0.048,"super welterweight",18,"right-handed",1,7,1,9,0.166666666666667
0.048,"light heavyweight",10,"right-handed",1,2,0,3,0.333333333333333
0.048,"featherweight",20,"right-handed",1,2,0,3,0.333333333333333
0.048,"super flyweight",8,"right-handed",1,2,0,3,0.333333333333333
0.048,"super featherweight",11,"right-handed",1,3,0,4,0.25
0.048,"lightweight",13,"right-handed",1,2,0,3,0.333333333333333
0.048,"flyweight",10,"right-handed",1,2,0,3,0.333333333333333
0.048,"super flyweight",9,"right-handed",1,2,0,3,0.333333333333333
0.048,"heavyweight",9,"right-handed",0,2,0,2,0
0.048,"super lightweight",7,"right-handed",0,2,1,3,0.166666666666667
0.048,"super welterweight",16,"right-handed",0,2,0,2,0
0.048,"welterweight",23,"right-handed",0,2,0,2,0
0.048,"super lightweight",11,"right-handed",0,2,0,2,0
0.048,"light flyweight",NA,"right-handed",0,2,0,2,0
0.048,"featherweight",10,"right-handed",0,2,0,2,0
0.048,"super middleweight",17,"right-handed",0,2,0,2,0
0.048,"super middleweight",15,"right-handed",0,2,0,2,0
0.048,"cruiserweight",17,"right-handed",0,2,0,2,0
0.048,"lightweight",20,"right-handed",0,2,0,2,0
0.048,"heavyweight",16,"right-handed",0,2,0,2,0
0.048,"light heavyweight",22,"right-handed",0,2,0,2,0
0.048,"super lightweight",20,"right-handed",0,2,0,2,0
0.048,"heavyweight",4,"right-handed",0,1,0,1,0
0.048,"cruiserweight",21,"right-handed",0,2,0,2,0
0.048,"super lightweight",5,"right-handed",0,2,0,2,0
0.048,"lightweight",13,"right-handed",0,2,0,2,0
0.048,"super featherweight",10,"right-handed",0,2,0,2,0
0.048,"featherweight",26,"right-handed",0,2,0,2,0
0.048,"middleweight",23,"right-handed",0,2,0,2,0
0.048,"super flyweight",17,"right-handed",0,2,0,2,0
0.048,"middleweight",12,"right-handed",0,2,0,2,0
0.048,"welterweight",14,"right-handed",0,2,0,2,0
0.048,"bantamweight",NA,"right-handed",0,2,0,2,0
0.048,"welterweight",15,"right-handed",0,2,0,2,0
0.048,"super middleweight",6,"right-handed",0,2,0,2,0
0.048,"heavyweight",23,"right-handed",0,2,0,2,0
0.048,"cruiserweight",17,"right-handed",0,2,0,2,0
0.048,"super lightweight",13,"right-handed",0,2,0,2,0
0.048,"heavyweight",9,"right-handed",0,2,0,2,0
0.048,"featherweight",7,"right-handed",0,2,0,2,0
0.048,"super middleweight",NA,"right-handed",0,2,0,2,0
0.048,"super bantamweight",7,"right-handed",0,2,0,2,0
0.048,"middleweight",8,"right-handed",0,2,0,2,0
0.048,"super welterweight",11,"right-handed",0,2,0,2,0
0.048,"super lightweight",15,"right-handed",0,2,0,2,0
0.048,"light heavyweight",11,"right-handed",0,2,0,2,0
0.048,"light heavyweight",17,"right-handed",0,2,0,2,0
0.048,"lightweight",20,"right-handed",0,2,0,2,0
0.048,"super flyweight",12,"right-handed",0,2,0,2,0
0.048,"cruiserweight",15,"right-handed",0,2,0,2,0
0.048,"heavyweight",NA,"right-handed",0,2,0,2,0
0.048,"middleweight",14,"right-handed",0,2,0,2,0
0.048,"middleweight",11,"right-handed",0,2,0,2,0
0.048,"super welterweight",15,"right-handed",0,2,1,3,0.166666666666667
0.048,"super featherweight",16,"right-handed",0,2,0,2,0
0.048,"welterweight",7,"right-handed",0,2,0,2,0
0.048,"super lightweight",4,"right-handed",0,2,0,2,0
0.048,"middleweight",NA,"right-handed",0,2,1,3,0.166666666666667
0.048,"light flyweight",9,"right-handed",0,2,0,2,0
0.048,"super flyweight",6,"right-handed",0,2,0,2,0
0.048,"welterweight",17,"right-handed",0,2,0,2,0
0.048,"lightweight",15,"right-handed",0,2,0,2,0
0.048,"minimumweight",10,"right-handed",0,2,1,3,0.166666666666667
0.048,"lightweight",21,"right-handed",0,2,0,2,0
0.048,"lightweight",4,"right-handed",0,2,0,2,0
0.048,"middleweight",13,"right-handed",0,2,1,3,0.166666666666667
0.048,"featherweight",NA,"right-handed",0,2,0,2,0
0.048,"featherweight",7,"right-handed",0,2,1,3,0.166666666666667
0.048,"cruiserweight",NA,"right-handed",0,2,0,2,0
0.048,"bantamweight",14,"right-handed",0,2,0,2,0
0.048,"super featherweight",16,"right-handed",0,2,0,2,0
0.048,"super lightweight",13,"right-handed",0,2,0,2,0
0.048,"welterweight",7,"right-handed",0,2,0,2,0
0.048,"super welterweight",8,"right-handed",0,2,0,2,0
0.048,"welterweight",10,"right-handed",0,2,0,2,0
0.048,"bantamweight",3,"right-handed",0,2,0,2,0
0.048,"welterweight",15,"right-handed",0,2,0,2,0
0.048,"bantamweight",16,"right-handed",0,2,0,2,0
0.048,"super flyweight",17,"right-handed",0,2,1,3,0.166666666666667
0.048,"super featherweight",3,"right-handed",0,2,0,2,0
0.048,"cruiserweight",23,"right-handed",0,2,0,2,0
0.048,"middleweight",26,"right-handed",0,2,0,2,0
0.048,"heavyweight",28,"right-handed",0,2,0,2,0
0.048,"featherweight",5,"right-handed",0,2,0,2,0
0.048,"welterweight",4,"right-handed",0,2,0,2,0
0.048,"lightweight",6,"right-handed",0,2,0,2,0
0.048,"light heavyweight",4,"right-handed",0,2,0,2,0
0.048,"super bantamweight",7,"right-handed",0,2,0,2,0
0.048,"super featherweight",16,"right-handed",0,2,0,2,0
0.048,"cruiserweight",21,"right-handed",0,2,0,2,0
0.048,"heavyweight",26,"right-handed",0,2,0,2,0
0.048,"super lightweight",16,"right-handed",0,2,0,2,0
0.048,"super middleweight",24,"right-handed",0,2,0,2,0
0.048,"featherweight",8,"right-handed",0,2,0,2,0
0.048,"bantamweight",6,"right-handed",0,2,0,2,0
0.048,"cruiserweight",NA,"right-handed",0,2,0,2,0
0.048,"welterweight",8,"right-handed",0,2,0,2,0
0.048,"super flyweight",7,"right-handed",0,2,0,2,0
0.048,"super bantamweight",4,"right-handed",0,2,0,2,0
0.048,"lightweight",6,"right-handed",0,2,0,2,0
0.048,"light heavyweight",17,"right-handed",0,1,0,1,0
0.048,"super featherweight",17,"right-handed",0,2,0,2,0
0.048,"super lightweight",11,"right-handed",0,2,0,2,0
0.048,"middleweight",NA,"right-handed",0,2,0,2,0
0.048,"lightweight",10,"right-handed",0,2,0,2,0
0.048,"cruiserweight",25,"right-handed",0,2,0,2,0
0.048,"bantamweight",NA,"right-handed",0,2,0,2,0
0.048,"flyweight",6,"right-handed",0,2,0,2,0
0.048,"featherweight",4,"right-handed",0,2,0,2,0
0.048,"lightweight",4,"right-handed",0,2,1,3,0.166666666666667
0.048,"super bantamweight",6,"right-handed",0,2,0,2,0
0.048,"super welterweight",8,"right-handed",0,2,0,2,0
0.048,"welterweight",17,"right-handed",0,2,0,2,0
0.048,"super lightweight",8,"right-handed",0,2,0,2,0
0.048,"super flyweight",5,"right-handed",0,2,0,2,0
0.048,"lightweight",27,"right-handed",0,2,0,2,0
0.048,"middleweight",NA,"right-handed",0,2,0,2,0
0.048,"lightweight",16,"right-handed",0,2,0,2,0
0.048,"cruiserweight",12,"right-handed",0,2,0,2,0
0.048,"super bantamweight",NA,"right-handed",0,2,0,2,0
0.048,"lightweight",NA,"right-handed",0,2,0,2,0
0.048,"lightweight",12,"right-handed",0,2,0,2,0
0.048,"cruiserweight",10,"right-handed",0,2,0,2,0
0.048,"lightweight",4,"right-handed",0,2,0,2,0
0.048,"lightweight",14,"right-handed",0,2,0,2,0
0.048,"super middleweight",8,"right-handed",0,2,0,2,0
0.048,"super featherweight",18,"right-handed",0,2,0,2,0
0.048,"super featherweight",9,"right-handed",0,2,0,2,0
0.048,"super bantamweight",8,"right-handed",0,2,0,2,0
0.048,"welterweight",21,"right-handed",0,2,0,2,0
0.048,"bantamweight",NA,"right-handed",0,2,0,2,0
0.048,"light heavyweight",23,"right-handed",0,2,0,2,0
0.048,"super featherweight",12,"right-handed",0,2,1,3,0.166666666666667
0.048,"heavyweight",11,"right-handed",0,2,0,2,0
0.048,"middleweight",20,"right-handed",0,2,0,2,0
0.048,"light flyweight",8,"right-handed",0,2,0,2,0
0.048,"super bantamweight",19,"right-handed",0,2,0,2,0
0.048,"super lightweight",8,"right-handed",0,2,0,2,0
0.048,"light heavyweight",17,"right-handed",0,2,0,2,0
