First_name,Surname,Height,Weight,Armspan,Wins,Losses,Draws,Total_Fights,Win_Percentage
Shamil,Abdurakhimov,75,235,76,20,5,0,25,0.8
Daichi,Abe,71,170,71,6,2,0,8,0.75
Papy,Abedi,71,185,74,9,3,0,12,0.75
Ricardo,Abreu,71,185,73,5,3,0,8,0.625
Klidson,Abreu,72,205,74,15,3,0,18,0.833333333
Juan,Adams,77,265,80,5,2,0,7,0.714285714
Anthony,Adams,72,185,77,7,1,0,8,0.875
Israel,Adesanya,76,185,80,18,0,0,18,1
Jessica,Aguilar,63,115,63,20,8,0,28,0.714285714
Kevin,Aguilar,67,145,73,17,2,0,19,0.894736842
Omari,Akhmedov,72,185,73,19,4,1,24,0.8125
Yoshihiro,Akiyama,70,170,73,14,6,0,20,0.7
Rostem,Akman,70,170,72,6,2,0,8,0.75
Mostapha,Al-Turk,74,245,77,6,6,0,12,0.5
Herdem,Alacabek,74,205,75,5,1,0,6,0.833333333
Heili,Alateng,65,135,66,13,7,1,21,0.642857143
John,Albert,68,135,68,7,5,0,12,0.583333333
Junior,Albini,75,264,74,14,6,0,20,0.7
Alexandra,Albu,62,115,63,7,1,0,8,0.875
Iuri,Alcantara,69,135,71,35,10,0,45,0.777777778
Ildemar,Alcantara,74,185,78,21,8,0,29,0.724137931
Irene,Aldana,69,135,68,11,5,0,16,0.6875
Hector,Aldana,71,170,72,4,4,0,8,0.5
Jose,Aldo,67,145,70,28,5,0,33,0.848484848
JJ,Aldrich,65,125,67,8,3,0,11,0.727272727
Jim,Alers,69,145,71,13,3,0,16,0.8125
John,Alessio,70,155,72,34,16,0,50,0.68
Houston,Alexander,72,205,72,13,8,1,22,0.613636364
Marcio,Alexandre Junior,72,185,75,17,4,0,21,0.80952381
Bill,Algeo,72,145,73,12,3,0,15,0.8
Sultan,Aliev,71,170,74,15,3,0,18,0.833333333
John,Allan,75,205,75,13,5,0,18,0.722222222
Arnold,Allen,68,145,70,15,1,0,16,0.9375
Brendan,Allen,74,185,75,13,3,0,16,0.8125
Benny,Alloway,71,170,75,13,6,0,19,0.684210526
Ricardo,Almeida,72,170,74,13,5,0,18,0.722222222
Thomas,Almeida,67,135,70,22,3,0,25,0.88
Ericka,Almeida,66,115,68,7,2,0,9,0.777777778
Eddie,Alvarez,69,155,69,29,6,0,35,0.828571429
Jaime,Alvarez,68,125,69,6,1,0,7,0.857142857
Joel,Alvarez,75,155,77,16,2,0,18,0.888888889
Thiago,Alves,69,170,70,28,14,0,42,0.666666667
Warlley,Alves,71,170,72,14,3,0,17,0.823529412
Sam,Alvey,74,205,75,33,13,0,46,0.717391304
Adlan,Amagov,74,170,76,13,2,1,16,0.84375
Alen,Amedovski,70,185,74,8,2,0,10,0.8
Makwan,Amirkhani,70,145,72,15,3,0,18,0.833333333
Eryk,Anders,73,205,75,13,4,0,17,0.764705882
Corey,Anderson,75,205,79,13,4,0,17,0.764705882
Megan,Anderson,72,145,72,10,4,0,14,0.714285714
Jessica,Andrade,61,115,62,20,7,0,27,0.740740741
Viscardi,Andrade,71,170,75,19,7,0,26,0.730769231
Dylan,Andrews,73,185,73,18,8,0,26,0.692307692
Magomed,Ankalaev,75,205,75,11,1,0,12,0.916666667
Nina,Ansaroff,65,115,64,10,6,0,16,0.625
Gadzhimurad,Antigulov,71,205,70,20,6,0,26,0.769230769
Adam,Antolin,65,125,63,12,3,0,15,0.8
Zu,Anyanwu,73,251,77,14,5,0,19,0.736842105
Shinsho,Anzai,67,170,70,10,3,0,13,0.769230769
Josh,Appelt,70,255,73,15,6,0,21,0.714285714
Felipe,Arantes,68,135,73,18,10,1,29,0.637931034
Igor,Araujo,73,170,77,25,8,0,33,0.757575758
Viviane,Araujo,64,125,68,8,1,0,9,0.888888889
Julio,Arce,67,145,70,16,3,0,19,0.842105263
Andrei,Arlovski,75,240,77,28,18,0,46,0.608695652
Austin,Arnett,72,145,72,16,6,0,22,0.727272727
Akbarh,Arreola,70,155,71,23,10,1,34,0.691176471
Matt,Arroyo,70,170,72,3,3,0,6,0.5
Antonio,Arroyo,75,185,73,8,2,0,10,0.8
Cesar,Arzamendia,71,155,71,7,4,0,11,0.636363636
Teddy,Ash,73,185,73,14,4,0,18,0.777777778
Askar,Askarov,66,125,67,10,0,1,11,0.954545455
Cyril,Asker,72,247,74,9,4,0,13,0.692307692
Scott,Askham,75,185,75,14,4,0,18,0.777777778
Ben,Askren,71,170,73,19,1,0,20,0.95
Junior,Assuncao,69,145,72,13,4,0,17,0.764705882
Raphael,Assuncao,65,135,66,27,7,0,34,0.794117647
Rich,Attonito,70,170,72,10,5,0,15,0.666666667
Olivier,Aubin-Mercier,69,155,70,12,5,0,17,0.705882353
Marcus,Aurelio,70,155,74,21,10,0,31,0.677419355
Blas,Avena,72,170,74,7,6,0,13,0.538461538
Chris,Avila,70,145,72,5,4,0,9,0.555555556
Julia,Avila,67,135,68,7,1,0,8,0.875
Jessin,Ayari,72,155,73,16,5,0,21,0.761904762
Abu,Azaitar,69,185,76,14,1,1,16,0.90625
Ottman,Azaitar,68,155,71,12,0,0,12,1
Hunter,Azure,68,135,69,8,0,0,8,1
Niklas,Backstrom,73,145,74,8,2,0,10,0.8
Seth,Baczynski,75,170,74,18,11,0,29,0.620689655
Ryan,Bader,74,205,74,23,5,0,28,0.821428571
Miguel,Baeza,74,170,74,8,0,0,8,1
Ali,Bagautinov,64,125,65,14,5,0,19,0.736842105
Mehdi,Baghdad,73,155,75,11,4,0,15,0.733333333
Siyar,Bahadurzada,71,170,73,24,8,1,33,0.742424242
Shamar,Bailey,69,155,75,12,5,0,17,0.705882353
Oluwale,Bamgbose,71,185,78,6,4,0,10,0.6
Marcin,Bandel,70,155,70,13,4,0,17,0.764705882
Humberto,Bandenay,71,145,71,14,7,0,21,0.666666667
Tae Hyun,Bang,69,155,71,18,10,0,28,0.642857143
Antonio,Banuelos,65,135,63,19,7,1,27,0.722222222
Renan,Barao,66,135,70,36,8,0,44,0.818181818
Maycee,Barber,65,125,65,8,0,0,8,1
Bryan,Barberena,72,170,72,14,7,0,21,0.666666667
Edson,Barboza,71,155,75,20,8,0,28,0.714285714
Raoni,Barcelos,67,135,67,14,1,0,15,0.933333333
Luke,Barnatt,78,185,77,8,3,0,11,0.727272727
Josh,Barnett,75,250,78,35,8,0,43,0.813953488
Phil,Baroni,69,170,72,14,15,0,29,0.482758621
Peter,Barrett,70,155,73,8,2,0,10,0.8
Marc-Andre,Barriault,73,185,74,11,3,0,14,0.785714286
Francimar,Barroso,73,205,75,19,7,0,26,0.730769231
Pat,Barry,71,235,74,8,7,0,15,0.533333333
Enrique,Barzola,67,145,70,17,4,1,22,0.795454545
Shayna,Baszler,67,135,67,15,10,0,25,0.6
Danaa,Batgerel,67,135,70,6,2,0,8,0.75
Mario,Bautista,69,135,69,7,1,0,8,0.875
Chris,Beal,67,125,69,10,3,0,13,0.769230769
Ariel,Beck,66,125,66,4,5,0,9,0.444444444
Johnny,Bedford,70,135,71,19,13,1,33,0.590909091
Chase,Beebe,67,135,67,19,8,1,28,0.696428571
Mirsad,Bektic,68,145,70,13,2,0,15,0.866666667
Diana,Belbita,67,125,68,13,5,0,18,0.722222222
Alan,Belcher,74,185,73,17,7,0,24,0.708333333
Vitor,Belfort,72,185,74,26,14,0,40,0.65
Danilo,Belluardo,72,155,74,12,5,0,17,0.705882353
Joey,Beltran,73,185,75,15,9,0,24,0.625
Marco,Beltran,68,125,69,8,7,0,15,0.533333333
Joseph,Benavidez,64,125,65,28,5,0,33,0.848484848
Gabriel,Benitez,68,145,71,21,8,0,29,0.724137931
DeAnna,Bennett,64,125,68,8,3,1,12,0.708333333
Lance,Benoist,71,170,73,7,2,0,9,0.777777778
Ryan,Benoit,65,125,68,10,5,0,15,0.666666667
Kenneth,Bergh,74,205,76,6,0,0,6,1
Keith,Berish,72,205,73,5,1,0,6,0.833333333
Dennis,Bermudez,66,155,66,18,9,0,27,0.666666667
Manny,Bermudez,70,145,71,14,2,0,16,0.875
Talita,Bernardo,64,135,68,6,4,0,10,0.6
Matt,Bessette,70,145,70,22,9,0,31,0.709677419
Arjan,Bhullar,73,245,75,9,1,0,10,0.9
Magomed,Bibulatov,65,125,65,14,2,0,16,0.875
David,Bielkheden,70,155,71,16,9,0,25,0.64
Anthony,Birchak,68,135,69,13,3,0,16,0.8125
Chris,Birchler,75,205,79,7,3,0,10,0.7
Michael,Bisping,73,185,75,31,9,0,40,0.775
Jan,Blachowicz,74,205,78,24,8,0,32,0.75
Brad,Blackburn,70,170,73,18,13,1,32,0.578125
Maximo,Blanco,68,145,71,12,8,1,21,0.595238095
Curtis,Blaydes,76,265,80,12,2,0,14,0.857142857
Byron,Bloodworth,68,135,69,6,3,0,9,0.666666667
Mark,Bocek,68,155,75,12,5,0,17,0.705882353
Kyle,Bochniak,67,145,70,8,5,0,13,0.615384615
James,Bochnovic,76,205,81,8,3,0,11,0.727272727
Tim,Boetsch,72,185,74,21,13,0,34,0.617647059
Galore,Bofando,71,170,72,5,3,0,8,0.625
Stephan,Bonnar,76,205,78,17,8,0,25,0.68
Rogerio,Bontorin,65,125,67,16,1,0,17,0.941176471
Ray,Borg,64,135,63,12,4,0,16,0.75
Tanner,Boser,74,255,75,17,5,1,23,0.760869565
Steve,Bosse,71,205,72,12,2,0,14,0.857142857
Poliana,Botelho,68,115,67,8,2,0,10,0.8
Brian,Bowles,67,135,70,10,3,0,13,0.769230769
Roger,Bowling,69,155,68,11,5,0,16,0.6875
Kyle,Bradley,69,155,71,15,8,0,23,0.652173913
Sean,Brady,70,170,72,11,0,0,11,1
Ramiz,Brahimaj,70,170,73,8,2,0,10,0.8
David,Branch,73,185,78,22,6,0,28,0.785714286
Diego,Brandao,67,145,68,24,11,0,35,0.685714286
Martin,Bravo,68,145,71,12,3,0,15,0.8
Tom,Breese,75,185,73,11,1,0,12,0.916666667
Charlie,Brenneman,70,155,72,19,8,0,27,0.703703704
Marcos,Brigagao,75,205,76,11,1,0,12,0.916666667
Jason,Brilz,71,205,71,18,5,1,24,0.770833333
Marcus,Brimage,64,135,71,7,5,0,12,0.583333333
Henry,Briones,68,135,69,19,8,1,28,0.696428571
Antwain,Britt,73,205,77,11,5,0,16,0.6875
Jonathan,Brookins,72,145,73,14,6,0,20,0.7
Will,Brooks,70,155,72,18,4,0,22,0.818181818
CM,Punk,73,170,73,0,2,0,2,0
Jarred,Brooks,63,125,62,14,2,0,16,0.875
Rob,Broughton,74,265,74,15,7,1,23,0.673913043
Matt,Brown,72,170,75,23,16,0,39,0.58974359
Mike,Brown,66,145,70,26,9,0,35,0.742857143
Randy,Brown,75,170,78,11,3,0,14,0.785714286
Damien,Brown,70,155,68,17,12,0,29,0.586206897
TJ,Brown,69,145,72,13,6,0,19,0.684210526
Humberto,Brown,70,145,71,4,5,0,9,0.444444444
Travis,Browne,78,255,79,18,7,1,26,0.711538462
Fernando,Bruno,66,145,70,16,4,0,20,0.8
Derek,Brunson,73,185,77,20,7,0,27,0.740740741
Dennis,Bryant,72,205,72,5,1,0,6,0.833333333
Justin,Buchholz,72,155,73,12,6,0,18,0.666666667
Julia,Budd,67,145,67,3,1,0,4,0.75
Mike,Budnik,69,145,68,11,4,0,15,0.733333333
Paul,Buentello,74,245,77,29,14,0,43,0.674418605
Wuliji,Buren,69,135,69,10,7,0,17,0.588235294
Shane,Burgos,71,145,75,12,1,0,13,0.923076923
Joshua,Burkman,70,170,72,29,17,0,46,0.630434783
Mads,Burnell,68,145,69,9,3,0,12,0.75
Kevin,Burns,70,170,74,9,5,0,14,0.642857143
Gilbert,Burns,70,155,71,17,3,0,20,0.85
Herbert,Burns,69,145,74,8,2,0,10,0.8
Nah-Shon,Burrell,71,170,73,9,3,0,12,0.75
Martin,Buschkamp,69,145,70,9,0,0,9,1
Bubba,Bush,72,185,73,8,3,0,11,0.727272727
JP,Buys,66,125,66,4,1,0,5,0.8
Charles,Byrd,70,185,73,10,6,0,16,0.625
Yan,Cabral,71,155,73,12,3,0,15,0.8
Alex,Caceres,70,145,73,15,12,0,27,0.555555556
Priscila,Cachoeira,67,125,65,8,3,0,11,0.727272727
Joanne,Calderwood,66,125,65,14,4,0,18,0.777777778
Cynthia,Calvillo,64,115,64,8,1,0,9,0.888888889
Frank,Camacho,70,170,73,22,7,0,29,0.75862069
Fabricio,Camoes,70,155,73,14,9,1,24,0.604166667
Chris,Camozzi,74,185,76,24,13,0,37,0.648648649
Brian,Camozzi,74,170,78,7,5,0,12,0.583333333
Shane,Campbell,72,155,71,12,6,0,18,0.666666667
Will,Campuzano,69,125,70,13,6,0,19,0.684210526
Aleksa,Camur,73,205,75,4,0,0,4,1
Chico,Camus,66,125,66,14,7,0,21,0.666666667
Carlos,Candelario,68,125,67,6,0,0,6,1
Luiz,Cane,74,185,77,12,5,0,17,0.705882353
Guido,Cannetti,66,135,68,8,5,0,13,0.615384615
Jared,Cannonier,71,185,77,13,4,0,17,0.764705882
Steve,Cantwell,74,185,75,7,6,0,13,0.538461538
Phil,Caracappa,68,135,70,8,1,0,9,0.888888889
Bryan,Caraway,68,135,68,21,10,0,31,0.677419355
Chris,Cariaso,63,125,63,17,8,0,25,0.68
Antonio,Carlos Junior,74,185,79,11,4,0,15,0.733333333
Francis,Carmont,75,205,78,23,10,0,33,0.696969697
Liz,Carmouche,66,125,66,13,7,0,20,0.65
Roan,Carneiro,71,170,74,21,11,0,32,0.65625
Renato,Moicano,71,145,72,13,3,1,17,0.794117647
Ariane,Carnelossi,62,115,61,12,2,0,14,0.857142857
Luana,Carolina,66,125,69,6,1,0,7,0.857142857
Cain,Carrizosa,68,155,74,6,2,0,8,0.75
Antonio,Carvalho,69,145,68,15,6,0,21,0.714285714
Shane,Carwin,74,265,80,12,2,0,14,0.857142857
Johnny,Case,70,155,72,22,6,0,28,0.785714286
Kevin,Casey,71,185,77,9,5,1,15,0.633333333
Cortney,Casey,67,115,67,8,7,0,15,0.533333333
John,Castaneda,67,135,70,13,2,0,15,0.866666667
Danny,Castillo,69,155,71,17,10,0,27,0.62962963
Nick,Catone,72,185,72,10,4,0,14,0.714285714
Gesias,Cavalcante,68,155,71,16,5,1,22,0.75
Rafael,Feijao,73,205,73,12,7,0,19,0.631578947
Magnus,Cedenblad,77,185,79,14,5,0,19,0.736842105
Yosdenis,Cedeno,68,155,69,10,5,1,16,0.65625
Henry,Cejudo,64,135,64,15,2,0,17,0.882352941
Adam,Cella,74,170,78,4,2,0,6,0.666666667
Donald,Cerrone,73,155,73,36,13,0,49,0.734693878
Luan,Chagas,72,170,75,15,3,1,19,0.815789474
Alex,Chambers,63,115,63,5,5,0,10,0.5
Ernest,Chavez,68,145,70,8,2,0,10,0.8
Mark,Cherico,67,145,69,11,1,0,12,0.916666667
Macy,Chiasson,71,135,72,6,1,0,7,0.857142857
Michael,Chiesa,73,170,75,16,4,0,20,0.8
Giga,Chikadze,72,145,74,8,1,1,10,0.85
Dooho,Choi,70,145,70,14,3,0,17,0.823529412
SeungWoo,Choi,72,145,74,7,3,0,10,0.7
John,Cholish,71,155,72,8,3,0,11,0.727272727
Ryo,Chonan,69,170,70,20,12,0,32,0.625
Katlyn,Chookagian,69,125,68,12,2,0,14,0.857142857
Will,Chope,76,145,76,19,6,0,25,0.76
Joachim,Christensen,75,205,76,14,6,0,20,0.7
Anthony,Christodoulou,69,155,72,12,6,0,18,0.666666667
Hannah,Cifers,61,115,62,10,3,0,13,0.769230769
Misha,Cirkunov,75,205,77,15,5,0,20,0.75
Heather Jo,Clark,66,115,64,7,6,0,13,0.538461538
Devin,Clark,72,205,75,10,4,0,14,0.714285714
Jessica-Rose,Clark,65,125,64,9,5,0,14,0.642857143
Mitch,Clarke,70,155,73,11,5,0,16,0.6875
Rich,Clementi,69,155,72,40,20,1,61,0.663934426
Chris,Clements,70,170,70,12,6,0,18,0.666666667
Josh,Clopton,66,145,68,6,2,1,9,0.722222222
Marloes,Coenen,69,145,67,21,5,0,26,0.807692308
John,Cofer,69,155,73,7,4,0,11,0.636363636
Felipe,Colares,68,135,69,9,1,0,10,0.9
Mark,Coleman,73,205,75,16,10,0,26,0.615384615
Clay,Collard,71,145,73,14,7,0,21,0.666666667
Jamie,Colleen,63,115,65,4,1,0,5,0.8
Jake,Collier,75,205,78,11,4,0,15,0.733333333
Christian,Colombo,77,265,80,8,3,1,12,0.708333333
Carlos,Condit,74,170,75,30,13,0,43,0.697674419
Tristan,Connelly,70,170,68,14,6,0,20,0.7
Amanda,Cooper,63,115,64,4,5,0,9,0.444444444
Chris,Cope,72,170,72,5,4,0,9,0.555555556
Josh,Copeland,73,265,75,9,2,0,11,0.818181818
Michael,Cora,73,170,77,4,1,0,5,0.8
Akira,Corassani,68,145,68,14,7,0,21,0.666666667
Daniel,Cormier,71,235,72,22,2,0,24,0.916666667
Bethe,Correia,65,135,64,11,4,1,16,0.71875
Randy,Costa,69,135,73,5,1,0,6,0.833333333
Patrick,Cote,71,170,71,24,11,0,35,0.685714286
JC,Cottrell,69,155,71,17,5,0,22,0.772727273
JR,Coughran,66,145,71,6,1,0,7,0.857142857
Rashad,Coulter,71,205,76,9,4,0,13,0.692307692
Randy,Couture,73,205,75,19,11,0,30,0.633333333
Ryan,Couture,70,155,75,7,3,0,10,0.7
Colby,Covington,71,170,72,15,1,0,16,0.9375
Nathan,Coy,70,170,69,15,7,0,22,0.681818182
Andrew,Craig,73,170,76,9,4,0,13,0.692307692
Paul,Craig,75,205,76,12,4,0,16,0.75
Tim,Credeur,75,185,75,12,4,0,16,0.75
Allen,Crowder,75,245,76,10,4,0,14,0.714285714
Daron,Cruickshank,68,155,72,16,8,0,24,0.666666667
Jimmy,Crute,74,205,74,10,1,0,11,0.909090909
Dominick,Cruz,68,135,68,22,2,0,24,0.916666667
Aalon,Cruz,72,145,78,7,2,0,9,0.777777778
Zak,Cummings,72,185,75,23,7,0,30,0.766666667
Patrick,Cummins,74,205,76,10,7,0,17,0.588235294
Luke,Cummo,72,170,74,6,6,0,12,0.5
Alton,Cunningham,74,205,77,7,1,0,8,0.875
Jeff,Curran,66,135,69,35,15,1,51,0.696078431
Kailin,Curran,64,115,65,4,6,0,10,0.4
Ion,Cutelaba,73,205,75,15,4,0,19,0.789473684
Jussier,Formiga,65,125,67,23,6,0,29,0.793103448
Claudio,Silva,71,170,71,14,1,0,15,0.933333333
Henrique,da Silva,75,205,76,14,5,0,19,0.736842105
Alex,Da Silva,68,155,73,21,2,0,23,0.913043478
Nicolas,Dalby,71,170,74,18,3,1,22,0.840909091
Paul,Daley,69,170,76,31,11,2,44,0.727272727
Aisling,Daly,62,115,64,16,6,0,22,0.727272727
Rodrigo,Damm,67,155,71,12,9,0,21,0.571428571
Cindy,Dandois,67,135,68,8,3,0,11,0.727272727
Jarjis,Danho,75,265,74,6,1,1,8,0.8125
Mac,Danzig,68,155,70,22,12,1,35,0.642857143
Karen,Darabedyan,67,155,68,9,4,0,13,0.692307692
Beneil,Dariush,70,155,72,16,4,1,21,0.785714286
Kyle,Daukaus,75,185,76,6,0,0,6,1
Marcus,Davis,70,170,70,20,9,0,29,0.689655172
LC,Davis,68,135,69,17,4,0,21,0.80952381
Phil,Davis,74,205,79,13,3,0,16,0.8125
Alexis,Davis,66,125,68,19,10,0,29,0.655172414
Brandon,Davis,70,135,72,10,8,0,18,0.555555556
Mike,Davis,72,155,72,8,2,0,10,0.8
Hakeem,Dawodu,68,145,73,10,1,1,12,0.875
Grant,Dawson,70,145,72,14,1,0,15,0.933333333
Jason,Day,72,185,72,19,12,0,31,0.612903226
Martin,Day,70,135,73,8,3,0,11,0.727272727
Yorgan,De Castro,72,250,74,6,0,0,6,1
Geraldo,de Freitas,67,135,72,12,5,0,17,0.705882353
Philip,De Fries,77,250,82,9,3,0,12,0.75
Chris,de la Rocha,75,250,80,5,3,0,8,0.625
Montana,De La Rosa,67,125,68,10,5,0,15,0.666666667
Mark,De La Rosa,66,135,65,11,3,0,14,0.785714286
Mike,de la Torre,71,145,71,14,7,0,21,0.666666667
Rodrigo,de Lima,67,155,75,8,3,1,12,0.708333333
Jorge,de Oliveira,68,155,71,7,2,0,9,0.777777778
Germaine,de Randamie,69,135,71,9,3,0,12,0.75
Tom,DeBlass,72,185,75,7,2,0,9,0.777777778
Shane,del Rosario,76,250,79,11,2,0,13,0.846153846
Rolando,Delgado,75,155,77,11,5,1,17,0.676470588
Roland,Delorme,69,135,71,9,4,0,13,0.692307692
Jon,Delos Reyes,66,125,67,8,5,0,13,0.615384615
Chris,Dempsey,70,185,72,11,4,0,15,0.733333333
Jason,Dent,70,155,71,21,12,0,33,0.636363636
Mackenzie,Dern,64,115,63,7,1,0,8,0.875
Tony,DeSouza,72,170,70,10,4,0,14,0.714285714
Alessio,Di Chirico,72,185,74,12,4,0,16,0.75
Micol,Di Segni,63,115,60,7,2,0,9,0.777777778
Cyrille,Diabate,78,205,81,20,10,3,33,0.651515152
Marc,Diakiese,70,155,73,14,3,0,17,0.823529412
Tyler,Diamond,67,145,69,9,2,0,11,0.818181818
Hacran,Dias,68,155,69,23,6,1,30,0.783333333
Nick,Diaz,73,185,76,26,9,0,35,0.742857143
Nate,Diaz,72,170,76,21,11,0,32,0.65625
Seth,Dikun,70,135,69,7,4,0,11,0.636363636
TJ,Dillashaw,66,125,67,17,4,0,21,0.80952381
Rico,DiSciullo,68,135,71,9,1,0,10,0.9
Russell,Doane,67,135,70,15,8,0,23,0.652173913
Drew,Dober,68,155,70,21,9,0,30,0.7
Shana,Dobson,66,125,69,3,3,0,6,0.5
John,Dodson,63,135,66,21,11,0,32,0.65625
Joe,Doerksen,72,185,75,47,16,0,63,0.746031746
CB,Dollaway,74,185,76,18,10,0,28,0.642857143
Cody,Donovan,75,205,74,8,5,0,13,0.615384615
Rafael,Dos Anjos,68,170,70,29,12,0,41,0.707317073
Junior,Dos Santos,76,238,77,21,6,0,27,0.777777778
Antonio,Dos Santos,70,185,72,6,3,0,9,0.666666667
Anderson,Dos Santos,65,135,70,20,8,0,28,0.714285714
Tiago,Trator,69,145,70,20,6,2,28,0.75
Danny,Downes,72,155,72,8,3,0,11,0.727272727
Tomasz,Drwal,73,205,76,19,4,1,24,0.8125
Robert,Drysdale,75,205,78,6,0,0,6,1
Milana,Dudieva,63,135,61,11,5,0,16,0.6875
Todd,Duffee,75,260,78,9,3,0,12,0.75
Joe,Duffy,70,155,73,16,4,0,20,0.8
Alexis,Dufresne,69,135,68,5,4,0,9,0.555555556
Jessamyn,Duke,71,135,73,3,3,0,6,0.5
Evan,Dunham,70,155,70,18,8,1,27,0.685185185
Tom,Duquesnoy,67,135,68,16,2,0,18,0.888888889
Reuben,Duran,67,135,69,8,5,1,14,0.607142857
Luiz,Dutra,71,170,71,11,4,1,16,0.71875
Rilley,Dutro,68,125,70,14,3,0,17,0.823529412
Merab,Dvalishvili,66,135,68,9,4,0,13,0.692307692
Matt,Dwyer,76,170,76,8,4,0,12,0.666666667
Rolando,Dy,68,145,69,9,7,1,17,0.558823529
Cody,East,75,245,74,12,3,0,15,0.8
Marvin,Eastman,69,185,73,17,14,1,32,0.546875
Mike,Easton,66,135,70,13,5,0,18,0.722222222
Brian,Ebersole,72,170,73,51,17,1,69,0.746376812
Mark,Eddiva,68,145,68,6,3,0,9,0.666666667
Frankie,Edgar,66,145,68,22,7,1,30,0.75
Abdul-Kerim,Edilov,74,205,78,17,4,0,21,0.80952381
Johnny,Eduardo,67,135,71,28,12,0,40,0.7
Yves,Edwards,69,155,73,42,22,1,65,0.653846154
Justin,Edwards,70,155,70,9,5,0,14,0.642857143
Leon,Edwards,74,170,74,18,3,0,21,0.857142857
Te,Edwards,68,155,72,6,3,0,9,0.666666667
Per,Eklund,70,155,72,14,5,1,20,0.725
Darren,Elkins,70,145,71,25,8,0,33,0.757575758
Jake,Ellenberger,69,170,71,31,15,0,46,0.673913043
Joe,Ellenberger,69,155,72,15,2,0,17,0.882352941
Tim,Elliott,67,135,66,16,9,1,26,0.634615385
Lisa,Ellis,64,115,62,15,10,0,25,0.6
Anna,Elmose,63,115,65,3,2,0,5,0.6
Ramazan,Emeev,70,170,76,18,3,0,21,0.857142857
Fedor,Emelianenko,72,230,74,34,4,0,38,0.894736842
Rob,Emerson,69,155,70,11,10,0,21,0.523809524
Jamall,Emmers,70,145,74,13,3,0,16,0.8125
Josh,Emmett,66,145,70,15,2,0,17,0.882352941
Oliver,Enkamp,72,170,77,7,2,0,9,0.777777778
Alex,Enlund,70,145,73,14,2,0,16,0.875
Ian,Entwistle,65,135,64,9,3,0,12,0.75
Andy,Enz,75,185,78,8,3,0,11,0.727272727
Konstantin,Erokhin,71,230,73,9,3,0,12,0.75
Julian,Erosa,73,145,74,22,9,0,31,0.709677419
Cole,Escovedo,67,135,72,17,8,0,25,0.68
Efrain,Escudero,69,155,70,25,11,0,36,0.694444444
Carla,Esparza,61,115,63,16,6,0,22,0.727272727
Juan,Espino,76,250,82,10,1,0,11,0.909090909
Jordan,Espinosa,66,125,69,14,6,0,20,0.7
Jodie,Esquibel,61,115,64,6,6,0,12,0.5
Terry,Etim,73,155,73,15,5,0,20,0.75
Sijara,Eubanks,64,135,67,5,4,0,9,0.555555556
Billy,Evangelista,68,155,68,11,2,0,13,0.846153846
Rashad,Evans,72,205,75,24,8,1,33,0.742424242
Ashlee,Evans-Smith,68,125,67,6,4,0,10,0.6
Tonya,Evinger,67,135,70,19,8,0,27,0.703703704
Movsar,Evloev,67,145,72,11,0,0,11,1
Andre,Ewell,68,135,75,15,6,0,21,0.714285714
Jessica,Eye,66,125,66,14,7,0,21,0.666666667
Urijah,Faber,66,135,67,35,10,0,45,0.777777778
Melinda,Fabian,66,125,66,4,4,2,10,0.5
Wagnney,Fabiano,66,145,69,14,3,0,17,0.823529412
Bartosz,Fabinski,72,170,75,14,3,0,17,0.823529412
Zarah,Fairn,68,145,72,6,3,0,9,0.666666667
Rico,Farrington,76,170,79,7,2,0,9,0.777777778
Kelly,Faszholz,68,135,67,3,2,0,5,0.6
Paul,Felder,71,155,70,17,4,0,21,0.80952381
Tony,Ferguson,71,155,76,26,3,0,29,0.896551724
Josh,Ferguson,65,125,66,7,5,0,12,0.583333333
Cezar,Ferreira,73,185,78,14,8,0,22,0.636363636
Diego,Ferreira,69,155,74,16,2,0,18,0.888888889
Drew,Fickett,70,155,70,41,16,0,57,0.719298246
Deiveson,Figueiredo,65,125,68,17,1,0,18,0.944444444
Edwin,Figueroa,67,135,69,9,4,0,13,0.692307692
Andre,Fili,71,145,74,20,6,0,26,0.769230769
Mirko,Cro Cop,74,230,73,31,11,2,44,0.727272727
Luigi,Fioravanti,68,170,70,22,11,0,33,0.666666667
Spencer,Fisher,67,155,70,25,9,0,34,0.735294118
Chris,Fishgold,68,145,68,18,3,1,22,0.840909091
Jon,Fitch,72,170,76,27,5,1,33,0.833333333
Rafael,Fiziev,68,155,71,6,1,0,7,0.857142857
Colin,Fletcher,74,155,78,9,3,0,12,0.75
Kenny,Florian,70,145,74,14,6,0,20,0.7
Caros,Fodor,69,155,76,7,3,0,10,0.7
Rob,Font,68,135,71,16,4,0,20,0.8
Jesse,Forbes,74,185,75,15,5,0,20,0.75
Renee,Forte,67,155,71,8,4,0,12,0.666666667
Marcel,Fortuna,73,205,74,9,3,0,12,0.75
Brian,Foster,69,170,71,18,5,0,23,0.782608696
Hermes,Franca,66,155,71,22,12,0,34,0.647058824
Glaico,Franca,72,155,77,14,5,0,19,0.736842105
John,Franchi,66,145,67,6,2,0,8,0.75
Rich,Franklin,73,185,75,29,7,0,36,0.805555556
Justin,Frazier,72,265,75,11,3,0,14,0.785714286
Matt,Frevola,69,155,71,8,1,1,10,0.85
Sarah,Frota,66,125,69,9,2,0,11,0.818181818
Riki,Fukuda,72,185,73,19,7,0,26,0.730769231
Masio,Fullen,70,145,70,10,6,0,16,0.625
Ricardo,Funch,70,170,76,8,4,0,12,0.666666667
Claudia,Gadelha,64,115,63,17,4,0,21,0.80952381
Justin,Gaethje,71,155,70,21,2,0,23,0.913043478
Sheila,Gaff,65,135,62,10,6,1,17,0.617647059
Mitch,Gagnon,65,135,65,12,5,0,17,0.705882353
Mickey,Gall,74,170,74,6,2,0,8,0.75
Tom,Gallicchio,70,170,73,19,11,0,30,0.633333333
Manvel,Gamburyan,65,135,67,18,11,0,29,0.620689655
Ciryl,Gane,76,245,81,4,0,0,4,1
Eduardo,Garagorri,69,145,70,13,0,0,13,1
Cody,Garbrandt,68,135,65,11,3,0,14,0.785714286
Leonard,Garcia,70,145,69,19,11,1,31,0.629032258
Edgar,Garcia,70,170,71,14,5,0,19,0.736842105
Alex,Garcia,69,170,72,15,6,0,21,0.714285714
Steve,Garcia,72,135,75,9,3,0,12,0.75
Elias,Garcia,65,125,67,6,2,0,8,0.75
Pablo,Garza,73,145,73,13,4,0,17,0.764705882
Azamat,Gashimov,66,125,66,10,3,0,13,0.769230769
Kelvin,Gastelum,69,185,71,16,4,0,20,0.8
Willie,Gates,68,125,70,12,7,0,19,0.631578947
Louis,Gaudinot,63,125,63,6,4,0,10,0.6
Chad,George,66,135,68,13,6,0,19,0.684210526
Karine,Gevorgyan,64,125,63,3,3,0,6,0.5
Christos,Giagos,70,155,71,17,8,0,25,0.68
Joe,Giannetti,72,155,74,7,1,0,8,0.875
Cody,Gibson,70,135,71,12,6,0,18,0.666666667
Thomas,Gifford,73,155,75,17,9,0,26,0.653846154
Joe,Gigliotti,71,185,69,7,2,0,9,0.777777778
Trevin,Giles,72,185,74,11,2,0,13,0.846153846
Gregor,Gillespie,67,155,71,13,0,0,13,1
Alex,Gilpin,67,145,72,11,1,0,12,0.916666667
Rick,Glenn,72,145,70,21,6,1,28,0.767857143
Mark,Godbeer,76,240,77,13,4,0,17,0.764705882
Hannah,Goldy,64,125,61,5,1,0,6,0.833333333
Marcelo,Golm,75,249,75,6,3,0,9,0.666666667
Frank,Gomez,70,135,67,10,4,0,14,0.714285714
Ulysses,Gomez,66,125,66,9,4,0,13,0.692307692
Joey,Gomez,70,155,71,7,1,0,8,0.875
Luis,Gomez,67,145,68,4,1,0,5,0.8
Takanori,Gomi,67,155,70,35,14,0,49,0.714285714
Akihiro,Gono,67,170,68,32,16,7,55,0.645454545
Gabriel,Gonzaga,74,242,76,17,11,0,28,0.607142857
Justin,Gonzales,69,145,72,9,0,0,9,1
Fernando,Gonzalez,69,170,68,19,11,0,30,0.633333333
Lewis,Gonzalez,70,170,73,10,2,0,12,0.833333333
Jason,Gonzalez,74,155,74,11,5,0,16,0.6875
Pearl,Gonzalez,64,115,68,6,3,0,9,0.666666667
Lyman,Good,72,170,74,20,5,0,25,0.8
Eddie,Gordon,72,185,76,8,4,0,12,0.666666667
Jared,Gordon,69,155,68,15,3,0,18,0.833333333
Tebaris,Gordon,73,265,78,3,1,0,4,0.75
Alex,Gorgees,74,155,74,7,1,0,8,0.875
Tim,Gorman,65,135,68,9,4,0,13,0.692307692
Jonathan,Goulet,72,170,73,23,12,0,35,0.657142857
Thibault,Gouti,70,155,72,12,5,0,17,0.705882353
Wilson,Gouveia,73,185,76,12,8,0,20,0.6
Damian,Grabowski,73,241,75,20,5,0,25,0.8
Roger,Gracie,76,185,79,6,2,0,8,0.75
Kron,Gracie,69,145,70,5,1,0,6,0.833333333
Miranda,Granger,67,125,68,7,0,0,7,1
TJ,Grant,70,155,72,21,5,0,26,0.807692308
Davey,Grant,68,135,69,10,4,0,14,0.714285714
Dwight,Grant,73,170,76,10,2,0,12,0.833333333
Alexa,Grasso,65,115,66,11,3,0,14,0.785714286
Michael,Graves,70,170,71,6,0,1,7,0.928571429
Shelton,Graves,74,255,76,7,3,0,10,0.7
Kevin,Gray,64,125,67,9,4,0,13,0.692307692
Bobby,Green,70,155,71,24,9,1,34,0.720588235
Desmond,Green,70,155,73,23,8,0,31,0.741935484
Maurice,Greene,79,258,80,8,3,0,11,0.727272727
Matt,Grice,68,145,70,15,5,0,20,0.75
Forrest,Griffin,75,205,77,19,7,0,26,0.730769231
Tyson,Griffin,66,145,68,15,6,0,21,0.714285714
Max,Griffin,71,170,76,15,7,0,22,0.681818182
Jordan,Griffin,70,145,73,17,7,0,24,0.708333333
Chad,Griggs,73,205,73,11,3,0,14,0.785714286
Josh,Grispi,71,145,74,14,5,0,19,0.736842105
Garrett,Gross,69,155,69,11,6,0,17,0.647058824
Kendall,Grove,78,185,79,13,10,0,23,0.565217391
Chris,Gruetzemacher,68,155,68,14,3,0,17,0.823529412
Vik,Grujic,71,170,73,7,6,0,13,0.538461538
Mike,Grundy,67,145,72,12,1,0,13,0.923076923
Wang,Guan,69,145,71,20,1,1,22,0.931818182
Nandor,Guelmino,75,230,76,11,5,1,17,0.676470588
Shannon,Gugerty,70,155,71,14,6,0,20,0.7
Clay,Guida,67,155,70,35,16,0,51,0.68627451
Melvin,Guillard,69,155,68,48,15,3,66,0.75
Marcelo,Guimaraes,72,185,73,9,2,1,12,0.791666667
Leonardo,Augusto Leleco,72,185,73,11,3,0,14,0.785714286
John,Gunderson,69,155,69,32,12,2,46,0.717391304
John,Gunther,69,155,72,7,2,0,9,0.777777778
Jorge,Gurgel,67,155,69,14,9,0,23,0.608695652
Alexander,Gustafsson,77,205,79,18,6,0,24,0.75
Horacio,Gutierrez,70,145,69,3,3,0,6,0.5
Chris,Gutierrez,69,135,67,14,3,0,17,0.823529412
Mike,Guymon,72,170,74,12,5,1,18,0.694444444
Damir,Hadzovic,69,155,70,13,5,0,18,0.722222222
Tim,Hague,76,260,76,13,5,0,18,0.722222222
Yazan,Hajeh,69,145,73,6,1,0,7,0.857142857
Uriah,Hall,72,185,79,16,9,0,25,0.64
Ryan,Hall,70,145,70,8,1,0,9,0.888888889
Dennis,Hallman,69,155,72,67,14,2,83,0.819277108
Piotr,Hallmann,69,155,71,15,5,0,20,0.75
Seohee,Ham,62,115,62,16,8,0,24,0.666666667
Matt,Hamill,73,205,76,12,5,0,17,0.705882353
Anthony,Hamilton,77,260,76,15,9,0,24,0.625
CJ,Hamilton,67,125,68,11,4,0,15,0.733333333
Jared,Hamman,75,185,75,13,6,0,19,0.684210526
Nasrat,Haqparast,70,155,72,11,2,0,13,0.846153846
Antoni,Hardonk,76,245,78,8,6,0,14,0.571428571
Dan,Hardy,72,170,74,25,10,0,35,0.714285714
Greg,Hardy,77,265,80,5,1,0,6,0.833333333
Gerald,Harris,71,185,77,19,4,0,23,0.826086957
Phil,Harris,64,125,64,22,12,0,34,0.647058824
Walt,Harris,77,250,77,13,7,0,20,0.65
Collin,Hart,73,185,76,4,2,1,7,0.642857143
Dale,Hartt,70,155,69,6,3,0,9,0.666666667
Clay,Harvison,73,170,74,9,3,0,12,0.75
Hayder,Hassan,70,170,70,6,3,0,9,0.666666667
John,Hathaway,73,170,75,17,2,0,19,0.894736842
Phil,Hawes,73,185,70,4,1,0,5,0.8
Tommy,Hayden,69,145,72,8,2,0,10,0.8
Dustin,Hazelett,73,170,76,12,7,0,19,0.631578947
James,Head,73,170,73,9,4,0,13,0.692307692
Pat,Healy,72,155,74,31,19,0,50,0.62
David,Heath,71,205,72,16,7,0,23,0.695652174
Chris,Heatherly,69,155,68,9,3,0,12,0.75
Jake,Hecht,72,170,76,11,4,0,15,0.733333333
Nick,Hein,66,155,66,14,5,0,19,0.736842105
Ian,Heinisch,71,185,72,13,2,0,15,0.866666667
Marcin,Held,69,155,71,23,7,0,30,0.766666667
Dan,Henderson,71,185,74,32,15,0,47,0.680851064
Benson,Henderson,69,170,70,23,5,0,28,0.821428571
Johny,Hendricks,69,185,69,18,8,0,26,0.692307692
Luis,Henrique,74,243,74,10,5,0,15,0.666666667
Paulo,Costa,73,185,72,13,0,0,13,1
Danny,Henry,72,145,73,12,3,0,15,0.8
Ed,Herman,73,205,77,25,14,0,39,0.641025641
Dave,Herman,76,242,76,21,6,0,27,0.777777778
Jack,Hermansson,73,185,77,20,5,0,25,0.8
Junior,Hernandez,69,135,69,14,6,0,20,0.7
Alexander,Hernandez,69,155,72,11,2,0,13,0.846153846
Anthony,Hernandez,72,185,75,8,1,0,9,0.888888889
Nohelin,Hernandez,70,135,71,10,4,0,14,0.714285714
Geane,Herrera,65,125,66,9,3,0,12,0.75
Alvaro,Herrera,72,155,74,9,6,0,15,0.6
Felice,Herrig,64,115,65,14,8,0,22,0.636363636
Heath,Herring,76,250,78,28,14,0,42,0.666666667
Clint,Hester,74,205,77,11,6,0,17,0.647058824
Jimy,Hettes,69,145,71,11,3,0,14,0.785714286
Marcus,Hicks,66,155,64,9,3,0,12,0.75
Jay,Hieron,72,170,75,23,7,0,30,0.766666667
Jason,High,68,155,71,19,5,0,24,0.791666667
Corey,Hill,76,155,80,4,4,0,8,0.5
Angela,Hill,63,115,64,10,7,0,17,0.588235294
Tyler,Hill,75,170,78,8,1,0,9,0.888888889
Jamahal,Hill,76,205,79,5,0,0,5,1
Kailan,Hill,73,185,77,4,1,0,5,0.8
Hatsu,Hioki,71,145,70,27,9,2,38,0.736842105
Kuniyoshi,Hironaka,70,168,70,19,8,0,27,0.703703704
Mizuto,Hirota,67,155,67,19,10,2,31,0.64516129
Kwan,Ho Kwak,65,135,70,9,2,0,11,0.818181818
Matt,Hobar,70,135,70,9,3,0,12,0.75
Andrew,Holbrook,71,155,70,12,3,0,15,0.8
Chris,Holdsworth,71,135,71,7,0,0,7,1
Kevin,Holland,75,185,81,16,5,0,21,0.761904762
Roger,Hollett,71,205,70,13,5,0,18,0.722222222
Max,Holloway,71,145,69,21,4,0,25,0.84
Holly,Holm,68,135,69,12,5,0,17,0.705882353
Kurt,Holobaugh,71,155,70,17,7,0,24,0.708333333
Paddy,Holohan,70,125,69,12,2,1,15,0.833333333
Scott,Holtzman,69,155,69,13,3,0,16,0.8125
Sabah,Homasi,72,170,72,11,8,0,19,0.578947368
Mark,Hominick,68,145,68,20,12,0,32,0.625
Barb,Honchak,64,125,65,10,5,0,15,0.666666667
Dan,Hooker,72,155,75,20,8,0,28,0.714285714
Darrell,Horcher,70,155,70,13,4,0,17,0.764705882
Yoshinori,Horie,68,145,70,8,2,0,10,0.8
Kyoji,Horiguchi,65,125,66,18,2,0,20,0.9
Jeremy,Horn,73,185,74,88,21,5,114,0.793859649
Chris,Horodecki,69,155,69,18,3,1,22,0.840909091
Jeff,Hougland,67,135,68,10,6,0,16,0.625
Brian,Houston,74,185,78,4,2,0,6,0.666666667
John,Howard,67,170,71,23,12,0,35,0.657142857
Shane,Howell,68,125,69,13,9,0,22,0.590909091
Carlos,Huachin,64,135,67,10,5,1,16,0.65625
Austin,Hubbard,70,155,71,11,3,0,14,0.785714286
Roger,Huerta,69,155,70,21,5,1,27,0.796296296
Matt,Hughes,69,170,73,45,9,0,54,0.833333333
Jeff,Hughes,74,250,77,10,2,0,12,0.833333333
Mark,Hunt,70,265,72,13,14,1,28,0.482142857
Adam,Hunter,73,185,73,7,1,0,8,0.875
Al,Iaquinta,70,155,70,14,6,1,21,0.69047619
Khadis,Ibragimov,75,205,78,8,1,0,9,0.888888889
Dan,Ige,67,145,71,12,2,0,14,0.857142857
Zelim,Imadaev,72,170,76,8,1,0,9,0.888888889
Chris,Indich,70,170,73,5,3,0,8,0.625
Guto,Inocente,75,205,77,6,4,0,10,0.6
Naoki,Inoue,69,125,71,11,1,0,12,0.916666667
Mizuki,Inoue,63,125,65,14,5,0,19,0.736842105
James,Irvin,74,205,75,15,9,0,24,0.625
Yves,Jabouin,67,135,68,20,11,0,31,0.64516129
Rampage,Jackson,73,205,73,36,11,0,47,0.765957447
Damon,Jackson,71,145,71,9,1,1,11,0.863636364
Jason,Jackson,73,170,78,7,2,0,9,0.777777778
Montel,Jackson,70,135,75,8,1,0,9,0.888888889
Dustin,Jacoby,76,185,78,6,3,0,9,0.666666667
Virna,Jandiroba,63,115,64,14,1,0,15,0.933333333
Ryan,Janes,75,185,76,10,3,0,13,0.769230769
Josh,Janousek,71,185,73,8,1,0,9,0.888888889
Dave,Jansen,69,155,73,15,3,0,18,0.833333333
Keith,Jardine,74,185,76,17,10,2,29,0.620689655
Brock,Jardine,71,170,73,9,3,0,12,0.75
Rony,Jason,67,145,70,15,7,0,22,0.681818182
Joanna,Jedrzejczyk,66,125,65,16,3,0,19,0.842105263
Aaron,Jeffery,74,185,74,6,1,0,7,0.857142857
Ryan,Jensen,73,185,76,15,8,0,23,0.652173913
Chanmi,Jeon,65,115,67,5,2,0,7,0.714285714
Ryan,Jimmo,73,205,73,19,5,0,24,0.791666667
Sung Bin,Jo,72,145,72,9,1,0,10,0.9
Carls,John De Tomas,65,125,71,8,2,0,10,0.8
Brett,Johns,67,135,71,15,2,0,17,0.882352941
Miles,Johns,67,135,66,10,0,0,10,1
Anthony,Johnson,74,205,78,22,6,0,28,0.785714286
DaMarques,Johnson,73,170,75,18,12,0,30,0.6
Tony,Johnson,74,205,76,7,2,0,9,0.777777778
Lavar,Johnson,76,240,82,17,7,0,24,0.708333333
Demetrious,Johnson,63,125,66,27,3,1,31,0.887096774
Michael,Johnson,70,155,73,20,14,0,34,0.588235294
Kajan,Johnson,71,155,75,23,14,1,38,0.618421053
Dashon,Johnson,67,145,70,9,2,0,11,0.818181818
Tim,Johnson,75,265,77,12,4,0,16,0.75
Jordan,Johnson,74,205,79,10,0,0,10,1
Taylor,Johnson,72,185,74,5,1,0,6,0.833333333
Liana,Jojua,64,135,62,7,3,0,10,0.7
Daniel,Jolly,73,205,75,5,2,0,7,0.714285714
Jon,Jones,76,205,84,25,1,0,26,0.961538462
Justin,Jones,71,185,78,9,2,0,11,0.818181818
Jamelle,Jones,72,205,75,7,5,0,12,0.583333333
Jocelyn,Jones-Lybarger,67,115,64,6,4,0,10,0.6
Shawn,Jordan,72,260,75,18,7,0,25,0.72
Ivan,Jorge,69,155,73,26,5,0,31,0.838709677
Scott,Jorgensen,65,135,66,15,12,0,27,0.555555556
Krzysztof,Jotko,73,185,77,21,4,0,25,0.84
Alan,Jouban,72,170,73,16,7,0,23,0.695652174
Charles,Jourdain,69,155,69,9,2,0,11,0.818181818
Dustin,Joynson,78,244,78,5,0,0,5,1
Luke,Jumeau,71,170,72,13,5,0,18,0.722222222
Chan Sung,Jung,67,145,72,15,5,0,20,0.75
Da Un,Jung,76,205,78,12,2,0,14,0.857142857
Myles,Jury,70,145,73,17,4,0,21,0.80952381
Cris,Cyborg,68,145,68,21,2,0,23,0.913043478
Emily,Peters Kagan,63,115,66,3,3,0,6,0.5
Sirwan,Kakai,65,135,66,12,3,0,15,0.8
Martin,Kampmann,72,170,72,20,7,0,27,0.740740741
Bharat,Kandare,67,135,72,5,3,0,8,0.625
Masanori,Kanehara,67,135,67,25,13,5,43,0.639534884
Denis,Kang,71,185,77,34,15,2,51,0.68627451
Kyung Ho,Kang,69,135,73,16,8,0,24,0.666666667
Kai,Kara-France,64,125,69,20,7,0,27,0.740740741
Alex,Karalexis,68,155,66,10,6,0,16,0.625
Impa,Kasanganay,71,185,75,5,0,0,5,1
Nadia,Kassem,65,125,66,5,2,0,7,0.714285714
Yusuke,Kasuya,67,155,67,9,3,2,14,0.714285714
Brad,Katona,66,135,64,9,2,0,11,0.818181818
Calvin,Kattar,71,145,72,20,3,0,23,0.869565217
Sarah,Kaufman,65,135,67,17,4,0,21,0.80952381
Tatsuya,Kawajiri,67,145,69,35,10,2,47,0.765957447
Julie,Kedzie,65,135,64,16,13,0,29,0.551724138
Chris,Kelades,67,125,68,9,3,0,12,0.75
Brian,Kelleher,66,135,66,19,10,0,29,0.655172414
Paul,Kelly,69,155,70,12,4,0,16,0.75
Daniel,Kelly,72,185,70,13,4,0,17,0.764705882
Tim,Kennedy,71,185,74,18,6,0,24,0.75
Steve,Kennedy,71,170,71,22,8,0,30,0.733333333
Jeremy,Kennedy,71,145,71,11,1,0,12,0.916666667
Casey,Kenney,67,135,68,13,1,1,15,0.9
Will,Kerr,70,155,69,9,3,0,12,0.75
Rustam,Khabilov,68,155,73,23,4,0,27,0.851851852
Sergey,Khandozhko,73,170,74,27,5,1,33,0.833333333
Alfred,Khashakyan,68,135,70,8,3,0,11,0.727272727
Pannie,Kianzad,67,135,66,12,5,0,17,0.705882353
Katsunori,Kikuno,68,145,66,23,8,2,33,0.727272727
Jacob,Kilburn,69,145,71,6,1,0,7,0.857142857
Dong Hyun,Kim,74,170,76,22,4,1,27,0.833333333
Ji Yeon,Kim,67,125,72,9,2,2,13,0.769230769
Jeremy,Kimball,72,205,72,15,8,0,23,0.652173913
Rob,Kimmons,70,185,73,24,8,0,32,0.75
Dustin,Kimura,67,135,71,12,3,0,15,0.8
Mike,King,75,185,75,5,1,0,6,0.833333333
Kyle,Kingsbury,76,205,76,11,6,0,17,0.647058824
Kamuela,Kirk,70,145,75,9,2,0,11,0.818181818
Justine,Kish,65,125,64,6,2,0,8,0.75
Drakkar,Klose,69,155,70,11,1,1,13,0.884615385
Jason,Knight,70,145,71,20,6,0,26,0.769230769
Erik,Koch,70,170,71,16,6,0,22,0.727272727
Syuri,Kondo,64,115,66,6,3,0,9,0.666666667
Cheick,Kongo,76,240,82,29,9,2,40,0.75
Josh,Koscheck,70,170,73,19,10,0,29,0.655172414
Naoyuki,Kotani,68,155,66,33,13,7,53,0.688679245
Karolina,Kowalkiewicz,63,115,64,13,5,0,18,0.722222222
Derrick,Krantz,70,170,72,24,12,0,36,0.666666667
James,Krause,74,170,73,25,8,0,33,0.757575758
Pascal,Krauss,73,170,72,11,2,0,13,0.846153846
Nikita,Krylov,75,205,77,26,7,0,33,0.787878788
Michael,Kuiper,72,185,73,12,3,0,15,0.8
Anton,Kuivanen,68,155,72,17,6,0,23,0.739130435
Aleksei,Kunchenko,68,170,70,20,1,0,21,0.952380952
Kiichi,Kunimoto,70,170,71,18,7,2,27,0.703703704
Yana,Kunitskaya,66,135,68,12,4,0,16,0.75
Leo,Kuntz,70,155,74,17,3,1,21,0.833333333
Mike,Kyle,76,205,77,19,9,1,29,0.672413793
Aspen,Ladd,66,135,66,8,1,0,9,0.888888889
Ryan,LaFlare,73,170,74,14,3,0,17,0.823529412
Noad,Lahat,69,145,69,9,2,0,11,0.818181818
Tina,Lahdemaki,62,115,62,5,1,0,6,0.833333333
Sean,Lally,72,170,74,8,2,0,10,0.8
Ricardo,Lamas,68,145,71,19,8,0,27,0.703703704
Jason,Lambert,75,185,75,25,12,0,37,0.675675676
Austen,Lane,78,245,80,4,1,0,5,0.8
Lina,Lansberg,67,135,65,10,4,0,14,0.714285714
Taylor,Lapilus,66,135,73,11,2,0,13,0.846153846
Chad,Laprise,70,170,71,14,4,0,18,0.777777778
Anthony,Lapsley,69,170,71,25,7,0,32,0.78125
Lorenz,Larkin,71,170,72,18,5,0,23,0.782608696
Jeremy,Larsen,70,145,70,8,5,0,13,0.615384615
Brock,Larson,71,170,71,33,6,0,39,0.846153846
Bobby,Lashley,75,255,78,7,1,0,8,0.875
Ilir,Latifi,70,205,73,15,7,0,22,0.681818182
Jenel,Lausa,65,125,68,7,5,0,12,0.583333333
Joe,Lauzon,70,155,71,28,16,0,44,0.636363636
Muhammed,Lawal,72,205,78,9,1,0,10,0.9
Robbie,Lawler,71,170,74,28,14,0,42,0.666666667
Tom,Lawlor,72,205,74,10,6,0,16,0.625
Justin,Lawrence,68,145,67,5,2,0,7,0.714285714
Lance,Lawrence,73,145,74,5,1,0,6,0.833333333
Valmir,Lazaro,72,155,73,13,4,0,17,0.764705882
Cung,Le,69,185,69,9,3,0,12,0.75
Thanh,Le,69,145,74,6,1,0,7,0.857142857
Chris,Leben,71,185,74,22,11,0,33,0.666666667
Mickael,Lebout,71,155,73,14,5,1,20,0.725
Justin,Ledet,76,205,80,9,2,0,11,0.818181818
Vaughan,Lee,66,125,66,14,11,1,26,0.557692308
Kevin,Lee,69,170,77,17,5,0,22,0.772727273
Rocky,Lee,69,145,68,3,2,0,5,0.6
Andrea,Lee,66,125,69,11,3,0,14,0.785714286
Cheyden,Leialoha,68,135,73,6,0,0,6,1
Thales,Leites,73,185,78,28,9,0,37,0.756756757
Amanda,Lemos,64,135,65,6,1,1,8,0.8125
Giacomo,Lemos,75,247,75,6,0,0,6,1
Jesse,Lennox,69,170,72,15,3,0,18,0.833333333
Nik,Lentz,68,155,68,30,10,2,42,0.738095238
Brock,Lesnar,75,265,81,5,3,0,8,0.625
Valerie,Letourneau,67,115,68,8,6,0,14,0.571428571
Leah,Letson,67,145,71,5,2,0,7,0.714285714
Marcus,LeVesseur,69,155,70,22,7,0,29,0.75862069
Derrick,Lewis,75,260,79,21,7,0,28,0.75
Bevon,Lewis,75,185,79,6,2,0,8,0.75
Jingliang,Li,72,170,71,17,5,0,22,0.772727273
Jess,Liaudin,69,170,72,19,11,0,30,0.633333333
Chuck,Liddell,74,205,76,21,8,0,29,0.724137931
Hyun Gyu,Lim,75,170,77,13,7,1,21,0.642857143
Juliana,Lima,65,115,65,9,5,0,14,0.642857143
Dhiego,Lima,74,170,75,17,7,0,24,0.708333333
Matt,Lindland,72,185,74,22,9,0,31,0.709677419
Jake,Lindsey,71,155,71,9,3,0,12,0.75
John,Lineker,63,135,67,31,9,0,40,0.775
Ariane,Lipski,63,125,67,11,5,0,16,0.6875
Dean,Lister,73,185,75,11,7,0,18,0.611111111
Abner,Lloveras,71,155,71,19,8,1,28,0.696428571
Artem,Lobov,69,145,65,14,15,1,30,0.483333333
Dylan,Lockard,69,145,72,6,1,0,7,0.857142857
Christian,Lohsen,74,155,77,7,1,0,8,0.875
David,Loiseau,72,185,76,20,10,0,30,0.666666667
Hector,Lombard,69,185,71,34,10,1,45,0.766666667
Michael,Lombardo,72,185,72,8,1,0,9,0.888888889
Dileno,Lopes,65,135,65,19,3,0,22,0.863636364
Matthew,Lopez,67,135,69,10,4,0,14,0.714285714
Benito,Lopez,70,135,73,10,1,0,11,0.909090909
Brendan,Loughnane,70,145,70,16,4,0,20,0.8
Joe,Lowry,70,155,72,8,1,0,9,0.888888889
Duane,Ludwig,70,170,70,29,14,0,43,0.674418605
Dalcha,Lungiambula,68,205,76,10,1,0,11,0.909090909
Vicente,Luque,71,170,75,17,6,1,24,0.729166667
Travis,Lutter,71,185,75,10,6,0,16,0.625
Zhenhong,Lv,68,145,67,18,6,0,24,0.75
Chris,Lytle,71,170,68,31,18,5,54,0.62037037
Dong Hyun,Ma,71,155,70,16,10,3,29,0.603448276
William,Patolino,71,170,75,8,3,0,11,0.727272727
Jason,MacDonald,75,185,80,26,16,0,42,0.619047619
Rob,MacDonald,75,205,78,5,4,0,9,0.555555556
Rory,MacDonald,72,170,76,18,4,0,22,0.818181818
Ryan,MacDonald,71,135,71,10,2,0,12,0.833333333
Veronica,Macedo,64,125,64,6,3,1,10,0.65
Lyoto,Machida,73,185,74,24,8,0,32,0.75
Reza,Madadi,71,155,72,14,6,0,20,0.7
Don,Madge,72,155,72,9,3,1,13,0.730769231
Jon,Madsen,72,240,72,7,1,0,8,0.875
Mark,Madsen,68,155,72,9,0,0,9,1
Yoshiro,Maeda,67,139,68,28,12,2,42,0.69047619
Leonardo,Mafra,70,155,70,12,3,0,15,0.8
Vinny,Magalhaes,75,205,79,11,7,0,18,0.611111111
Caio,Magalhaes,73,185,73,9,3,0,12,0.75
Bernardo,Magalhaes,69,155,65,11,3,0,14,0.785714286
Angela,Magana,61,115,65,11,9,0,20,0.55
Neil,Magny,75,170,80,21,8,0,29,0.724137931
Rashid,Magomedov,69,155,70,20,2,0,22,0.909090909
Ruslan,Magomedov,75,242,78,14,1,0,15,0.933333333
Zabit,Magomedsharipov,73,145,73,17,1,0,18,0.944444444
John,Maguire,69,155,69,18,6,0,24,0.75
Demian,Maia,73,170,72,27,9,0,36,0.75
Jennifer,Maia,64,125,64,17,5,1,23,0.760869565
Levan,Makashvili,68,145,68,10,2,1,13,0.807692308
John,Makdessi,68,155,68,17,6,0,23,0.739130435
Islam,Makhachev,70,155,70,18,1,0,19,0.947368421
Zach,Makovsky,64,125,64,19,8,0,27,0.703703704
Fabio,Maldonado,73,205,75,22,9,0,31,0.709677419
Bea,Malecki,69,135,74,3,0,0,3,1
Nazareno,Malegarie,68,155,70,28,5,0,33,0.848484848
Jon,Manley,73,170,75,7,3,0,10,0.7
Jimi,Manuwa,73,205,79,17,6,0,23,0.739130435
Cristiano,Marcello,69,155,72,13,6,0,19,0.684210526
Marcos,Mariano,73,155,76,6,6,0,12,0.5
Enrique,Marin,70,170,74,9,4,0,13,0.692307692
Ronny,Markes,73,185,75,14,3,0,17,0.823529412
Rory,Markham,72,170,71,16,6,0,22,0.727272727
Randa,Markos,64,115,63,9,8,1,18,0.527777778
Christina,Marks,67,125,69,8,9,0,17,0.470588235
Nate,Marquardt,72,185,74,38,19,2,59,0.661016949
Julian,Marquez,74,185,75,7,2,0,9,0.777777778
Carmelo,Marrero,72,205,73,14,5,0,19,0.736842105
Eliot,Marshall,74,205,77,10,4,0,14,0.714285714
Jack,Marshman,72,185,73,23,9,0,32,0.71875
Terry,Martin,68,185,71,22,9,0,31,0.709677419
Anthony Rocco,Martin,72,170,73,16,5,0,21,0.761904762
Mallory,Martin,64,115,63,4,2,0,6,0.666666667
Danny,Martinez,66,125,67,18,7,0,25,0.72
Henry,Martinez,67,155,68,9,3,0,12,0.75
Jonathan,Martinez,68,135,70,11,2,0,13,0.846153846
Adriano,Martins,70,155,72,28,9,0,37,0.756756757
Lucas,Martins,72,145,72,16,3,0,19,0.842105263
Bristol,Marunde,73,170,71,12,9,0,21,0.571428571
Mike,Massenzio,74,185,73,13,6,0,19,0.684210526
Jameel,Massouh,70,145,72,26,9,0,35,0.742857143
Tiffany,Masters,63,115,65,2,1,0,3,0.666666667
Jorge,Masvidal,71,170,74,34,13,0,47,0.723404255
Tateki,Matsuda,67,125,65,10,7,0,17,0.588235294
Jake,Matthews,71,170,73,15,4,0,19,0.789473684
Vladimir,Matyushenko,72,205,74,26,7,0,33,0.787878788
Jack,May,80,255,79,7,2,0,9,0.777777778
Don'Tale,Mayes,78,260,81,7,2,0,9,0.777777778
Gray,Maynard,69,155,70,14,8,1,23,0.630434783
Gina,Mazany,66,135,68,5,3,0,8,0.625
Sabina,Mazo,67,125,70,7,1,0,8,0.875
Michael,McBride,73,155,75,8,3,0,11,0.727272727
Ian,McCall,65,125,64,13,5,1,19,0.710526316
Molly,McCann,64,125,62,10,2,0,12,0.833333333
Charles,McCarthy,70,185,71,10,5,0,15,0.666666667
Sean,McCorkle,79,265,81,13,2,0,15,0.866666667
Kris,McCray,72,170,76,6,3,0,9,0.666666667
Tamdan,McCrory,76,185,78,14,5,0,19,0.736842105
Rob,McCullough,69,155,69,19,8,0,27,0.703703704
Justin,McCully,73,225,73,10,5,2,17,0.647058824
Bubba,McDaniel,75,185,75,21,8,0,29,0.724137931
Michael,McDonald,69,135,70,17,4,0,21,0.80952381
Drew,McFedries,72,185,72,10,6,0,16,0.625
Court,McGee,71,170,75,20,9,0,29,0.689655172
Conor,McGregor,69,155,74,21,4,0,25,0.84
Tim,McKenzie,72,185,74,13,8,0,21,0.619047619
Cody,McKenzie,72,155,72,14,4,0,18,0.777777778
Terrance,McKinney,71,145,74,7,1,0,8,0.875
Garreth,McLellan,73,185,72,13,6,0,19,0.684210526
Sara,McMann,66,135,66,11,5,0,16,0.6875
James,McSweeney,76,230,77,6,9,0,15,0.4
Tim,Means,74,170,75,28,11,1,40,0.7125
Yancy,Medeiros,70,155,75,15,6,0,21,0.714285714
Alton,Meeks,77,265,75,3,1,0,4,0.75
Gerald,Meerschaert,73,185,77,29,12,0,41,0.707317073
Jordan,Mein,72,170,73,31,12,0,43,0.720930233
Brian,Melancon,68,170,72,7,3,0,10,0.7
Gilbert,Melendez,69,145,73,22,8,0,30,0.733333333
Vanessa,Melo,65,135,65,9,6,0,15,0.6
Antonio,Mendes,75,205,77,17,10,0,27,0.62962963
Chad,Mendes,66,145,66,18,5,0,23,0.782608696
Augusto,Mendes,66,135,65,6,2,0,8,0.75
Eddie,Mendez,70,185,76,7,2,1,10,0.75
Pietro,Menga,67,125,68,13,0,0,13,1
Alonzo,Menifield,72,205,76,9,0,0,9,1
Ivan,Menjivar,66,145,64,25,12,0,37,0.675675676
Joe,Merritt,72,170,73,6,1,0,7,0.857142857
Jonathan,Meunier,75,170,75,8,1,0,9,0.888888889
Yaotzin,Meza,69,145,74,21,11,0,32,0.65625
David,Michaud,69,155,72,8,2,0,10,0.8
Zachary,Micklewright,72,155,74,11,3,0,14,0.785714286
Bojan,Mihajlovic,71,205,73,10,6,0,16,0.625
Curtis,Millender,74,170,76,17,5,0,22,0.772727273
Jason,Miller,73,185,72,34,10,0,44,0.772727273
Dan,Miller,73,185,74,14,8,0,22,0.636363636
Jim,Miller,68,155,71,31,13,0,44,0.704545455
Cole,Miller,73,145,74,21,11,0,32,0.65625
Che,Mills,73,170,76,15,5,0,20,0.75
Adam,Milstead,75,205,76,8,3,0,11,0.727272727
Alberto,Mina,72,170,77,13,1,0,14,0.928571429
Darrick,Minner,67,145,70,22,9,0,31,0.709677419
Stipe,Miocic,76,240,80,19,3,0,22,0.863636364
Frank,Mir,75,264,79,18,11,0,29,0.620689655
Mario,Miranda,75,185,74,12,3,0,15,0.8
Vitor,Miranda,73,185,77,13,7,0,20,0.65
David,Mitchell,72,170,76,12,4,0,16,0.75
Danny,Mitchell,74,170,74,14,6,1,21,0.69047619
Matt,Mitrione,75,265,79,9,5,0,14,0.642857143
Hiromitsu,Miura,69,170,71,9,6,0,15,0.6
Takeya,Mizugaki,67,135,68,21,11,2,34,0.647058824
Roxanne,Modafferi,67,125,69,23,17,0,40,0.575
Bobby,Moffett,70,145,73,14,5,0,19,0.736842105
Nate,Mohr,69,155,72,9,7,0,16,0.5625
Thiago,Moises,69,155,70,12,4,0,16,0.75
Ashkan,Mokhtarian,66,125,67,13,3,0,16,0.8125
Suman,Mokhtarian,70,145,67,8,1,0,9,0.888888889
Jeff,Monson,69,247,74,43,12,1,56,0.776785714
Darrell,Montague,66,125,67,13,5,0,18,0.722222222
Augusto,Montano,73,170,73,15,3,0,18,0.833333333
Erick,Montano,72,170,73,8,5,0,13,0.615384615
Nicco,Montano,65,135,65,5,3,0,8,0.625
Steve,Montgomery,76,185,75,8,4,0,12,0.666666667
James,Moontasri,70,170,71,9,5,0,14,0.642857143
Todd,Moore,69,170,71,14,5,0,19,0.736842105
Sergio,Moraes,72,170,72,14,6,1,21,0.69047619
Marlon,Moraes,66,135,67,22,6,1,29,0.775862069
Sheymon,Moraes,68,145,72,11,4,0,15,0.733333333
John,Moraga,66,125,66,19,7,0,26,0.730769231
Leonardo,Morales,68,135,68,5,2,0,7,0.714285714
Albert,Morales,69,135,72,7,4,1,12,0.625
Joseph,Morales,66,125,69,9,2,0,11,0.818181818
Vince,Morales,67,135,70,9,4,0,13,0.692307692
Sarah,Moras,67,135,67,6,6,0,12,0.5
Christian,Morecraft,78,260,81,7,3,0,10,0.7
Richardson,Moreira,74,185,72,7,4,0,11,0.636363636
Vinicius,Moreira,76,205,76,9,4,0,13,0.692307692
Brandon,Moreno,67,125,70,15,5,1,21,0.738095238
Dan,Moret,72,155,73,13,6,0,19,0.684210526
Peggy,Morgan,73,135,70,2,1,0,3,0.666666667
Alex,Morono,71,170,72,17,5,0,22,0.772727273
Maryna,Moroz,67,125,67,9,3,0,12,0.75
Gegard,Mousasi,74,185,76,42,6,2,50,0.86
Jamie,Moyle,61,115,65,4,3,0,7,0.571428571
Su,Mudaerji,68,135,72,11,4,0,15,0.733333333
Lauren,Mueller,65,125,67,5,3,0,8,0.625
Belal,Muhammad,71,170,72,16,3,0,19,0.842105263
Quinn,Mulhern,75,155,76,18,4,0,22,0.818181818
James,Mulheron,70,243,73,11,2,0,13,0.846153846
Jamie,Mullarkey,72,155,74,12,3,0,15,0.8
Pedro,Munhoz,66,135,65,18,4,0,22,0.818181818
Mark,Munoz,72,185,72,14,6,0,20,0.7
Makhmud,Muradov,74,185,75,23,6,0,29,0.793103448
Vince,Murdock,66,145,66,12,3,0,15,0.8
Lauren,Murphy,65,125,67,11,4,0,15,0.733333333
Lerone,Murphy,69,145,73,8,0,1,9,0.944444444
Khalid,Murtazaliev,72,185,76,14,2,0,16,0.875
Nico,Musoke,72,170,75,13,5,0,18,0.722222222
Magomed,Mustafaev,68,155,71,14,2,0,16,0.875
Elvis,Mutapcic,72,185,72,15,5,1,21,0.738095238
Rin,Nakai,61,135,60,16,2,1,19,0.868421053
Kazuhiro,Nakamura,71,205,70,15,11,0,26,0.576923077
Keita,Nakamura,71,170,73,34,10,2,46,0.760869565
Yui Chul,Nam,69,145,69,18,6,1,25,0.74
Tyson,Nam,67,125,68,18,10,1,29,0.637931034
Rose,Namajunas,65,115,65,9,4,0,13,0.692307692
Nad,Narimani,68,145,70,12,3,0,15,0.8
Roger,Narvaez,75,185,79,7,2,0,9,0.777777778
Bobby,Nash,72,170,74,8,4,0,12,0.666666667
Rafael,Natal,72,185,76,21,9,1,31,0.693548387
Ismail,Naurdiev,70,170,74,19,3,0,22,0.863636364
Geoff,Neal,71,170,75,12,2,0,14,0.857142857
Stanislav,Nedkov,71,205,71,12,2,0,14,0.857142857
Josh,Neer,71,170,72,33,13,1,47,0.712765957
Nicolae,Negumereanu,72,205,78,9,1,0,10,0.9
Shane,Nelson,69,155,70,15,5,0,20,0.75
Roy,Nelson,72,263,72,23,14,0,37,0.621621622
Gunnar,Nelson,71,170,72,17,5,1,23,0.760869565
Kyle,Nelson,71,155,71,13,3,0,16,0.8125
Antonio Braga,Neto,75,185,77,9,3,0,12,0.75
Nick,Newell,70,155,74,14,1,0,15,0.933333333
Journey,Newson,65,135,67,9,2,0,11,0.818181818
Francis,Ngannou,76,250,83,14,3,0,17,0.823529412
Ben,Nguyen,65,125,65,17,8,0,25,0.68
Alex,Nicholson,76,185,81,7,4,0,11,0.636363636
Matheus,Nicolau,66,125,66,13,3,1,17,0.794117647
Tom,Niinimaki,69,145,69,21,8,1,30,0.716666667
Ramsey,Nijem,71,155,75,10,6,0,16,0.625
Mats,Nilsson,73,170,74,11,4,1,16,0.71875
Ning,Guangyou,64,145,64,6,4,1,11,0.590909091
Anthony,Njokuani,73,155,75,16,9,0,25,0.64
Minotauro,Nogueira,75,240,77,34,10,1,45,0.766666667
Rogerio,Nogueira,74,205,75,23,9,0,32,0.71875
Kyle,Noke,73,170,76,22,10,1,33,0.681818182
KJ,Noons,70,155,72,12,8,0,20,0.6
Sage,Northcutt,72,170,71,11,2,0,13,0.846153846
Jason,Novelli,72,155,75,11,3,1,15,0.766666667
Phillipe,Nover,69,145,72,12,8,1,21,0.595238095
Diego,Nunes,66,145,67,18,4,0,22,0.818181818
Amanda,Nunes,68,135,69,18,4,0,22,0.818181818
Khabib,Nurmagomedov,70,155,70,28,0,0,28,1
Said,Nurmagomedov,68,135,70,13,1,0,14,0.928571429
Kennedy,Nzechukwu,77,205,83,7,1,0,8,0.875
Jake,O'Brien,75,205,76,13,4,0,17,0.764705882
Sean,O'Connell,73,205,74,17,9,0,26,0.653846154
Sean,O'Malley,71,135,72,10,0,0,10,1
Brendan,O'Reilly,67,170,69,6,3,0,9,0.666666667
Christian,Ocon,68,135,69,4,1,0,5,0.8
Richard,Odoms,77,265,82,8,1,0,9,0.888888889
Volkan,Oezdemir,74,205,75,16,4,0,20,0.8
Andy,Ogle,68,145,69,9,6,0,15,0.6
Yushin,Okami,74,170,75,35,12,0,47,0.744680851
JJ,Okanovich,71,155,76,6,1,0,7,0.857142857
Aleksei,Oleinik,74,240,80,57,13,1,71,0.809859155
Michal,Oleksiejczuk,72,205,74,14,3,0,17,0.823529412
Rafaello,Oliveira,68,155,71,15,7,0,22,0.681818182
Charles,Oliveira,70,155,74,27,8,0,35,0.771428571
Ednaldo,Oliveira,77,205,79,13,2,1,16,0.84375
Alex,Oliveira,71,170,76,19,8,1,28,0.696428571
Wendell,Oliveira,70,170,72,24,9,0,33,0.727272727
Felipe,Olivieri,69,155,72,14,5,0,19,0.736842105
Cameron,Olson,73,205,75,7,3,0,10,0.7
Alan,Omer,70,145,71,18,5,0,23,0.782608696
Daniel,Omielanczuk,72,247,74,19,8,1,28,0.696428571
Michihiro,Omigawa,66,145,68,13,13,1,27,0.5
Chibwikem,Onyenegecha-Palmer,75,185,76,6,0,0,6,1
Brian,Ortega,68,145,69,14,1,0,15,0.933333333
Tito,Ortiz,75,205,74,17,11,1,29,0.603448276
Dustin,Ortiz,65,125,65,19,8,0,27,0.703703704
Kenji,Osawa,67,135,66,18,10,2,30,0.633333333
Ode,Osbourne,67,135,73,7,2,0,9,0.777777778
Nick,Osipczak,74,170,76,5,3,0,8,0.625
Rachael,Ostovich,63,125,62,4,5,0,9,0.444444444
Zak,Ottow,71,170,72,17,7,0,24,0.708333333
Sidney,Outlaw,68,170,74,8,4,0,12,0.666666667
Alistair,Overeem,76,265,80,45,17,0,62,0.725806452
Alptekin,Ozkilic,65,125,65,9,4,0,13,0.692307692
Nick,Pace,67,135,68,6,3,0,9,0.666666667
Larissa,Pacheco,67,135,69,10,2,0,12,0.833333333
Teemu,Packalen,73,155,75,8,3,0,11,0.727272727
Damacio,Page,66,135,66,12,8,0,20,0.6
Dustin,Pague,69,135,74,11,10,0,21,0.523809524
Raulian,Paiva,68,125,69,18,3,0,21,0.857142857
Fredson,Paixao,66,145,66,10,4,0,14,0.714285714
Bart,Palaszewski,69,145,70,35,17,0,52,0.673076923
Soa,Palelei,76,265,81,22,5,0,27,0.814814815
Rousimar,Palhares,68,170,71,24,5,0,29,0.827586207
Alexandre,Pantoja,65,125,67,21,4,0,25,0.84
Jared,Papazian,68,135,67,14,9,0,23,0.608695652
Karo,Parisyan,70,170,72,19,8,0,27,0.703703704
Jun Yong,Park,70,185,73,10,4,0,14,0.714285714
Harvey,Park,72,155,70,12,2,0,14,0.857142857
Norman,Parke,71,155,70,22,5,1,28,0.803571429
Claude,Patrick,71,170,75,14,2,0,16,0.875
Alan,Patrick,71,155,74,15,2,0,17,0.882352941
Sergei,Pavlovich,75,257,84,13,1,0,14,0.928571429
Pawel,Pawlak,72,170,73,11,2,0,13,0.846153846
Estevan,Payan,70,145,72,14,6,0,20,0.7
Jonathan,Pearce,72,155,71,9,4,0,13,0.692307692
Ross,Pearson,68,155,69,22,16,0,38,0.578947368
Carlo,Pedersoli,71,170,75,11,3,0,14,0.785714286
Tyson,Pedro,75,205,79,7,3,0,10,0.7
Filip,Pejic,68,135,70,10,2,1,13,0.807692308
Kurt,Pellegrino,68,155,70,16,6,0,22,0.727272727
Julianna,Pena,66,135,69,10,3,0,13,0.769230769
Luis,Pena,75,155,75,7,2,0,9,0.777777778
Cathal,Pendred,73,170,75,17,5,1,23,0.760869565
BJ,Penn,69,155,70,16,14,2,32,0.53125
Jessica,Penne,65,115,67,12,6,0,18,0.666666667
Nick,Penner,76,205,77,12,3,0,15,0.8
Raquel,Pennington,67,135,67,10,8,0,18,0.555555556
Godofredo,Pepey,67,145,73,14,6,0,20,0.7
Robert,Peralta,68,145,71,18,6,0,24,0.75
Viviane,Pereira,61,115,63,13,2,0,15,0.866666667
Michel,Pereira,73,170,73,23,10,0,33,0.696969697
Erik,Perez,68,135,68,17,6,0,23,0.739130435
Alejandro,Perez,66,135,67,22,8,1,31,0.725806452
Frankie,Perez,71,155,73,10,4,0,14,0.714285714
Alex,Perez,66,135,65,22,5,0,27,0.814814815
Markus,Perez,73,185,73,11,2,0,13,0.846153846
Anthony,Perosh,75,205,75,15,10,0,25,0.6
Thiago,Perpetuo,70,170,71,9,4,1,14,0.678571429
Hernani,Perpetuo,72,170,74,17,5,0,22,0.772727273
Jason,Perrin,67,135,69,8,3,0,11,0.727272727
Mike,Perry,70,170,71,13,5,0,18,0.722222222
Raphael,Pessoa,75,262,78,9,1,0,10,0.9
Viktor,Pesta,75,240,77,10,4,0,14,0.714285714
Steven,Peterson,70,145,70,18,9,0,27,0.666666667
Seth,Petruzelli,72,205,76,14,6,0,20,0.7
Peter,Petties,71,145,72,5,3,0,8,0.625
Anthony,Pettis,70,170,72,22,9,0,31,0.709677419
Sergio,Pettis,66,125,69,18,5,0,23,0.782608696
Forrest,Petz,69,170,71,24,9,0,33,0.727272727
Cody,Pfister,70,155,73,12,6,1,19,0.657894737
Nam,Phan,66,135,70,18,14,0,32,0.5625
Costas,Philippou,71,185,73,13,5,0,18,0.722222222
Aaron,Phillips,69,135,70,8,2,0,10,0.8
Elizabeth,Phillips,66,135,65,5,4,0,9,0.555555556
John,Phillips,71,185,75,22,9,0,31,0.709677419
Vinc,Pichel,70,155,72,12,2,0,14,0.857142857
Brad,Pickett,66,135,68,26,14,0,40,0.65
Jamie,Pickett,74,185,80,9,3,0,12,0.75
Oskar,Piechota,72,185,76,11,2,1,14,0.821428571
Mike,Pierce,68,170,70,17,7,0,24,0.708333333
Sean,Pierson,72,170,76,14,6,0,20,0.7
Domingo,Pilarte,72,135,73,8,2,0,10,0.8
Daniel,Pineda,67,145,69,18,11,0,29,0.620689655
Liu,Pingyuan,66,135,72,13,6,0,19,0.684210526
Maki,Pitolo,70,170,75,12,5,0,17,0.705882353
Jamal,Pogues,75,205,77,6,2,0,8,0.75
Dustin,Poirier,69,155,72,25,6,0,31,0.806451613
Igor,Pokrajac,72,205,76,28,13,0,41,0.682926829
Santiago,Ponzinibbio,72,170,73,28,3,0,31,0.903225806
Grigorii,Popov,67,135,68,13,2,0,15,0.866666667
Callan,Potter,72,170,72,18,8,0,26,0.692307692
Ruan,Potts,74,247,75,8,4,0,12,0.666666667
Devin,Powell,72,155,73,9,4,0,13,0.692307692
Marcin,Prachnio,75,205,74,13,4,0,17,0.764705882
Wagner,Prado,72,205,74,8,2,0,10,0.8
Trevor,Prangley,73,185,75,23,8,1,32,0.734375
Ricardo,Prasel,79,238,78,10,1,0,11,0.909090909
Carlo,Prater,71,155,72,30,12,1,43,0.709302326
Michel,Prazeres,66,170,67,26,3,0,29,0.896551724
Kyle,Prepolec,70,170,70,12,7,0,19,0.631578947
Niko,Price,72,170,76,14,3,0,17,0.823529412
Lara,Procopio,64,135,67,6,1,0,7,0.857142857
Joe,Proctor,70,155,72,11,5,0,16,0.6875
Cole,Province,69,145,68,6,2,0,8,0.75
Lucie,Pudilova,68,125,67,8,5,0,13,0.615384615
Claudio,Puelles,71,155,72,10,2,0,12,0.833333333
Juan,Puig,69,145,72,11,4,0,15,0.733333333
Jens,Pulver,67,145,70,25,15,1,41,0.62195122
Mike,Pyle,72,170,74,27,14,1,42,0.654761905
Nate,Quarry,72,185,72,12,4,0,16,0.75
Jimmy,Quinlan,72,185,72,3,1,1,5,0.7
Michel,Quinones,70,155,73,8,3,0,11,0.727272727
Jose,Quinonez,68,135,69,9,3,0,12,0.75
Ricky,Rainey,73,170,77,13,6,0,19,0.684210526
Aleksandar,Rakic,76,205,78,12,1,0,13,0.923076923
Jessica,Rakoczy,67,115,68,2,5,0,7,0.285714286
Ricardo,Ramos,66,135,69,13,2,0,15,0.866666667
Davi,Ramos,66,155,70,10,3,0,13,0.769230769
Vernon,Ramos,66,170,72,3,2,0,5,0.6
Ed,Ratcliff,70,155,71,7,3,0,10,0.7
Bec,Rawlings,66,125,64,7,8,0,15,0.466666667
Stevie,Ray,70,155,70,22,9,0,31,0.709677419
Abdul,Razak Alhassan,70,170,73,10,1,0,11,0.909090909
Rafael,Rebello,65,135,67,7,4,0,11,0.636363636
Greg,Rebello,72,240,73,24,8,0,32,0.75
Paul,Redmond,70,145,70,10,6,0,16,0.625
Karl,Reed,75,205,78,6,1,0,7,0.857142857
Stephen,Regman,71,185,76,9,3,0,12,0.75
Wilson,Reis,64,125,65,23,10,0,33,0.696969697
Goran,Reljic,75,205,81,9,3,0,12,0.75
Chance,Rencountre,74,170,75,14,3,0,17,0.823529412
Marion,Reneau,66,135,68,9,5,1,15,0.633333333
Polo,Reyes,71,155,71,8,8,0,16,0.5
Dominick,Reyes,76,205,77,12,0,0,12,1
Alex,Reyes,71,170,73,13,3,0,16,0.8125
Victor,Reyna,71,170,73,10,3,0,13,0.769230769
Mike,Rhodes,73,170,74,6,4,0,10,0.6
Amanda,Ribas,63,115,66,8,1,0,9,0.888888889
Mike,Ricci,72,155,77,9,4,0,13,0.692307692
Alessandro,Ricci,71,155,69,10,5,0,15,0.666666667
Brad,Riddell,67,155,71,7,1,0,8,0.875
Matthew,Riddle,73,170,74,7,3,0,10,0.7
Joe,Riggs,72,185,70,41,17,0,58,0.706896552
Aaron,Riley,68,155,69,29,14,1,44,0.670454545
Jordan,Rinaldi,70,145,72,14,7,0,21,0.666666667
Nick,Ring,72,185,74,13,3,0,16,0.8125
Mike,Rio,70,155,71,9,4,0,13,0.692307692
Diego,Rivas,68,145,69,7,2,0,9,0.777777778
Jorge,Rivera,73,185,73,19,9,0,28,0.678571429
Francisco,Rivera,68,135,68,11,7,0,18,0.611111111
Jimmie,Rivera,64,135,68,22,4,0,26,0.846153846
Kali,Robbins,63,115,63,6,2,0,8,0.75
Karl,Roberson,73,185,74,8,2,0,10,0.8
Daniel,Roberts,70,170,74,12,4,0,16,0.75
Danny,Roberts,73,170,74,16,5,0,21,0.761904762
Roosevelt,Roberts,73,155,74,8,1,0,9,0.888888889
Kenny,Robertson,70,170,74,15,5,0,20,0.75
Gillian,Robertson,65,125,63,7,4,0,11,0.636363636
Alvin,Robinson,69,155,68,12,6,0,18,0.666666667
Vagner,Rocha,70,155,73,11,4,0,15,0.733333333
Carlos Eduardo,Rocha,70,170,70,9,2,0,11,0.818181818
Luke,Rockhold,75,205,77,16,5,0,21,0.761904762
Bruno,Korea,66,135,65,4,2,0,6,0.666666667
Manuel,Rodriguez,69,170,68,10,4,0,14,0.714285714
Yair,Rodriguez,71,145,71,13,2,0,15,0.866666667
Mike,Rodriguez,76,205,82,10,3,0,13,0.769230769
Marina,Rodriguez,66,115,65,12,0,1,13,0.961538462
Daniel,Rodriguez,73,170,75,8,1,0,9,0.888888889
Ray,Rodriguez,67,135,69,15,5,0,20,0.75
Nick,Roehrick,74,205,75,7,1,0,8,0.875
Marcos,Rogerio de Lima,73,253,75,16,7,1,24,0.6875
Brett,Rogers,77,265,81,11,4,0,15,0.733333333
Shane,Roller,70,155,72,11,7,0,18,0.611111111
Ricardo,Romero,72,205,76,11,3,0,14,0.785714286
Yoel,Romero,72,185,73,13,4,0,17,0.764705882
Mara,Romero Borella,66,125,69,12,6,0,18,0.666666667
Jesse,Ronson,70,155,72,19,8,0,27,0.703703704
George,Roop,73,135,72,15,13,1,29,0.534482759
Aaron,Rosa,76,205,78,17,5,0,22,0.772727273
Charles,Rosa,69,145,69,12,3,0,15,0.8
Karol,Rosa,65,135,67,12,3,0,15,0.8
Jared,Rosholt,74,265,75,14,3,0,17,0.823529412
Ben,Rothwell,76,265,78,36,12,0,48,0.75
Khalil,Rountree Jr.,73,205,76,9,4,0,13,0.692307692
Ronda,Rousey,67,135,68,12,2,0,14,0.857142857
Philip,Rowe,75,170,80,6,2,0,8,0.75
Jairzinho,Rozenstruik,76,242,78,8,0,0,8,1
Mauricio,Rua,73,205,76,26,11,0,37,0.702702703
Rodolfo,Rubio,65,145,66,12,8,1,21,0.595238095
Mike,Russow,73,255,73,15,3,0,18,0.833333333
Amir,Sadollah,70,170,74,7,5,0,12,0.583333333
Frankie,Saenz,66,135,66,13,6,0,19,0.684210526
Saparbeg,Safarov,73,205,78,9,2,0,11,0.818181818
Tarec,Saffiedine,70,170,70,16,7,0,23,0.695652174
Jason,Saggo,71,155,71,12,4,0,16,0.75
Ovince,Saint Preux,75,205,80,24,13,0,37,0.648648649
Lukasz,Sajewski,68,155,71,13,3,0,16,0.8125
Augusto,Sakai,75,265,77,14,1,1,16,0.90625
Alessio,Sakara,72,185,72,19,11,0,30,0.633333333
Gokhan,Saki,72,205,73,1,2,0,3,0.333333333
Justin,Salas,68,155,70,12,7,0,19,0.631578947
Roman,Salazar,67,135,67,9,4,0,13,0.692307692
Muslim,Salikhov,71,170,70,15,2,0,17,0.882352941
Boston,Salmon,69,135,69,6,3,0,9,0.666666667
John,Salter,73,185,74,8,2,0,10,0.8
Josh,Samman,75,185,79,12,5,0,17,0.705882353
Joshua,Sampo,64,125,64,11,5,0,16,0.6875
Diego,Sanchez,70,170,72,31,12,0,43,0.720930233
Eddie,Sanchez,74,230,74,13,5,0,18,0.722222222
Joby,Sanchez,66,135,68,11,4,0,15,0.733333333
Andrew,Sanchez,73,185,74,12,5,0,17,0.705882353
Roberto,Sanchez,66,125,66,8,2,0,10,0.8
Luke,Sanders,66,135,67,13,3,0,16,0.8125
Jerrod,Sanders,68,135,72,15,3,0,18,0.833333333
Cory,Sandhagen,71,135,70,12,1,0,13,0.923076923
Hector,Sandoval,62,125,64,14,4,0,18,0.777777778
Roldan,Sangcha-an,64,125,65,4,2,0,6,0.666666667
Duda,Santana,67,145,73,3,1,0,4,0.75
Jorge,Santiago,73,170,74,25,11,0,36,0.694444444
Mike,Santiago,70,145,69,21,12,0,33,0.636363636
Richie,Santiago,67,135,67,7,1,0,8,0.875
Evangelista,Santos,70,170,76,18,15,0,33,0.545454545
Iliarde,Santos,65,125,66,27,9,1,37,0.743243243
Leonardo,Santos,72,155,75,17,4,1,22,0.795454545
Thiago,Santos,74,205,76,21,7,0,28,0.75
Bruno,Santos,69,185,69,14,2,0,16,0.875
Taila,Santos,65,125,68,15,1,0,16,0.9375
Daniel,Sarafian,69,185,73,10,6,0,16,0.625
Ulka,Sasaki,70,125,71,21,6,2,29,0.75862069
Paul,Sass,72,155,73,13,2,0,15,0.866666667
Takenori,Sato,70,170,71,17,10,7,34,0.602941176
Takashi,Sato,70,170,73,15,3,0,18,0.833333333
Ben,Saunders,74,170,77,22,12,2,36,0.638888889
Matt,Sayles,67,145,68,8,2,0,10,0.8
Eric,Schafer,75,185,75,14,7,2,23,0.652173913
Brendan,Schaub,76,245,78,11,5,0,16,0.6875
Pat,Schilling,68,145,69,5,2,0,7,0.714285714
Matt,Schnell,68,125,70,14,4,0,18,0.777777778
Justin,Scoggins,67,125,66,11,5,0,16,0.6875
Bradley,Scott,73,170,76,12,6,0,18,0.666666667
Neil,Seery,64,125,64,16,13,0,29,0.551724138
Stefan,Sekulic,72,170,75,12,3,0,15,0.8
Pete,Sell,71,170,75,9,5,0,14,0.642857143
Mackens,Semerzier,69,145,72,8,4,0,12,0.666666667
Alex,Serdyukov,74,170,74,8,5,0,13,0.615384615
Matt,Serra,66,170,68,11,7,0,18,0.611111111
Fredy,Serrano,63,125,65,3,2,0,5,0.6
Rosi,Sexton,63,135,63,13,4,0,17,0.764705882
Edmen,Shahbazyan,74,185,74,10,0,0,10,1
Leon,Shahbazyan,76,170,74,7,1,0,8,0.875
Kamal,Shalorus,68,155,68,7,3,2,12,0.666666667
Ken,Shamrock,73,205,72,28,16,2,46,0.630434783
Eric,Shelton,66,125,68,12,6,0,18,0.666666667
Sean,Sherk,66,155,67,36,4,1,41,0.890243902
Chase,Sherman,76,250,78,11,6,0,17,0.647058824
Valentina,Shevchenko,65,125,66,18,3,0,21,0.857142857
Antonina,Shevchenko,68,125,67,8,1,0,9,0.888888889
Jake,Shields,72,170,72,29,7,1,37,0.797297297
Shunichi,Shimizu,65,135,66,28,9,10,47,0.70212766
Josh,Shockley,73,155,74,11,4,0,15,0.733333333
Jack,Shore,68,135,71,12,0,0,12,1
Ivan,Shtyrkov,72,205,74,16,0,1,17,0.970588235
Sam,Sicilia,68,145,67,15,8,0,23,0.652173913
Steven,Siler,71,145,70,23,13,0,36,0.638888889
Anderson,Silva,74,185,77,34,10,0,44,0.772727273
Wanderlei,Silva,71,205,74,35,12,1,48,0.739583333
Thiago,Silva,74,205,74,16,3,0,19,0.842105263
Antonio,Silva,76,264,80,19,10,1,30,0.65
Erick,Silva,72,170,74,19,9,0,28,0.678571429
Leandro,Silva,69,155,72,19,4,1,24,0.8125
Wagner,Silva,72,170,71,3,3,0,6,0.5
Joaquim,Silva,68,155,69,11,3,0,14,0.785714286
Felipe,Silva,72,155,77,8,2,0,10,0.8
Bruno,Silva,64,135,65,11,4,1,16,0.71875
Gabriel,Silva,66,135,71,7,1,0,8,0.875
Douglas,Silva de Andrade,67,135,68,25,3,0,28,0.892857143
Elias,Silverio,71,155,73,11,2,0,13,0.846153846
Ricky,Simon,66,135,69,15,2,0,17,0.882352941
Aaron,Simpson,72,170,73,11,4,0,15,0.733333333
Tony,Sims,71,155,70,12,4,0,16,0.75
Everett,Sims,77,260,77,4,1,0,5,0.8
Rory,Singer,74,185,77,11,9,0,20,0.55
Elvis,Sinosic,75,205,77,7,11,2,20,0.4
Dennis,Siver,66,145,70,23,11,0,34,0.676470588
Chas,Skelly,71,145,72,18,4,0,22,0.818181818
Scott,Smith,72,185,70,17,9,0,26,0.653846154
Trevor,Smith,75,185,75,15,9,0,24,0.625
Anthony,Smith,76,205,76,32,14,0,46,0.695652174
Colton,Smith,72,155,71,6,4,0,10,0.6
Gilbert,Smith,69,185,75,5,2,0,7,0.714285714
Leslie,Smith,69,135,66,10,7,1,18,0.583333333
Devonte,Smith,69,155,76,10,2,0,12,0.833333333
Cole,Smith,71,135,67,7,1,0,8,0.875
Dmitrii,Smoliakov,74,253,74,9,3,0,12,0.75
Louis,Smolka,69,135,68,16,6,0,22,0.727272727
Richie,Smullen,69,155,68,3,1,1,5,0.7
Devin,Smyth,70,170,72,9,1,0,10,0.9
Peter,Sobotta,72,170,75,17,6,1,24,0.729166667
Renato,Sobral,73,205,75,36,9,0,45,0.8
Rameau Thierry,Sokoudjou,70,205,78,12,10,0,22,0.545454545
Joseph,Solecki,69,155,71,7,2,0,9,0.777777778
Kenan,Song,72,170,71,15,5,0,20,0.75
Chael,Sonnen,73,205,74,29,14,1,44,0.670454545
Jinsoo,Son,66,135,69,9,4,0,13,0.692307692
Sean,Soriano,69,145,70,8,3,0,11,0.727272727
Punahele,Soriano,71,185,72,5,0,0,5,1
Dmitry,Sosnovskiy,75,240,77,11,0,0,11,1
Ben,Sosoli,69,265,72,7,2,0,9,0.777777778
Krzysztof,Soszynski,73,205,77,26,12,1,39,0.679487179
George,Sotiropoulos,70,155,71,14,6,0,20,0.7
Greg,Soto,71,170,73,8,2,0,10,0.8
Alex,Soto,68,135,71,6,2,1,9,0.722222222
Joe,Soto,66,135,65,18,7,0,25,0.72
Andre,Soukhamthath,69,135,70,13,8,0,21,0.619047619
Jacare,Souza,73,185,72,26,7,0,33,0.787878788
Kevin,Souza,72,145,74,19,4,0,23,0.826086957
Livinha,Souza,63,115,63,13,2,0,15,0.866666667
Ryan,Spann,77,205,79,17,5,0,22,0.772727273
Tommy,Speer,70,170,71,19,5,0,24,0.791666667
Sean,Spencer,70,170,75,12,6,0,18,0.666666667
Felicia,Spencer,66,145,68,7,1,0,8,0.875
Eric,Spicely,73,185,73,12,6,0,18,0.666666667
Daniel,Spitz,79,245,82,6,3,0,9,0.666666667
Serghei,Spivac,75,260,78,10,1,0,11,0.909090909
Daniel,Spohn,76,205,79,15,6,0,21,0.714285714
Austin,Springer,68,145,71,10,3,0,13,0.769230769
Georges,St-Pierre,71,185,76,26,2,0,28,0.928571429
Andreas,Stahl,71,170,73,9,2,0,11,0.818181818
Ron,Stallings,74,170,75,13,8,0,21,0.619047619
Cody,Stamann,66,135,64,18,2,0,20,0.9
Cristina,Stanciu,63,115,64,5,2,0,7,0.714285714
Brian,Stann,73,205,74,12,6,0,18,0.666666667
Josh,Stansbury,74,205,74,8,5,0,13,0.615384615
Clifford,Starks,72,185,77,8,2,0,10,0.8
Kalib,Starnes,75,185,74,12,7,1,20,0.625
Laureano,Staropoli,73,170,71,9,1,0,10,0.9
Damian,Stasiak,65,135,70,10,6,0,16,0.625
Dominique,Steele,70,170,74,14,9,0,23,0.608695652
Ricky,Steele,69,135,74,5,0,0,5,1
Steve,Steinbeiss,75,185,75,7,4,0,11,0.636363636
Jeremy,Stephens,69,145,71,28,17,0,45,0.622222222
Aljamain,Sterling,67,135,71,18,3,0,21,0.857142857
Joe,Stevenson,67,145,70,31,14,0,45,0.688888889
Maia,Stevenson,64,115,62,6,5,0,11,0.545454545
Darren,Stewart,72,185,74,11,4,0,15,0.733333333
Kyle,Stewart,72,170,76,11,3,0,14,0.785714286
Lazar,Stojadinovic,67,145,68,12,5,0,17,0.705882353
Julija,Stoliarenko,67,145,66,4,4,1,9,0.5
Ken,Stone,68,135,71,11,4,0,15,0.733333333
Rick,Story,69,170,71,19,9,0,28,0.678571429
Darko,Stosic,72,205,76,13,3,0,16,0.8125
Sam,Stout,69,155,70,21,12,1,34,0.632352941
Sean,Strickland,73,170,76,20,3,0,23,0.869565217
Hans,Stringer,75,205,73,22,7,3,32,0.734375
Stefan,Struve,83,265,84,33,11,0,44,0.75
Mike,Stumpf,70,170,71,11,4,0,15,0.733333333
Tatiana,Suarez,65,115,66,9,0,0,9,1
George,Sullivan,72,170,73,17,7,0,24,0.708333333
Justin,Sumter,74,185,80,7,2,0,9,0.777777778
Martin,Svensson,73,155,72,14,6,0,20,0.7
Cub,Swanson,68,145,70,26,11,0,37,0.702702703
Mike,Swick,73,170,77,15,6,0,21,0.714285714
Bentley,Syler,64,125,68,5,1,0,6,0.833333333
Kevin,Syler,69,145,71,8,0,0,8,1
Tim,Sylvia,80,265,80,30,7,0,37,0.810810811
Justin,Tafa,72,264,74,3,1,0,4,0.75
Khalid,Taha,65,135,69,14,2,0,16,0.875
Mairbek,Taisumov,69,155,73,27,6,0,33,0.818181818
Nordine,Taleb,73,170,74,15,7,0,22,0.681818182
Akitoshi,Tamura,69,135,70,16,11,2,29,0.586206897
Issei,Tamura,65,135,63,7,4,0,11,0.636363636
Michinori,Tanaka,65,135,67,11,3,0,14,0.785714286
Evan,Tanner,72,185,74,32,8,0,40,0.8
Manny,Tapia,65,135,67,11,4,1,16,0.71875
Miesha,Tate,66,135,65,18,7,0,25,0.72
Deividas,Taurosevicius,69,145,68,13,5,0,18,0.722222222
Thiago,Tavares,67,145,68,24,7,1,32,0.765625
Brad,Tavares,73,185,74,17,6,0,23,0.739130435
Paul,Taylor,72,155,72,11,6,1,18,0.638888889
Jesse,Taylor,72,170,73,33,15,0,48,0.6875
Louis,Taylor,71,185,74,11,3,0,14,0.785714286
Danielle,Taylor,60,115,60,9,4,0,13,0.692307692
James,Te Huna,74,185,75,18,9,0,27,0.666666667
Shawn,Teed,77,265,79,5,1,0,6,0.833333333
Glover,Teixeira,74,205,76,30,7,0,37,0.810810811
David,Teymur,69,155,73,8,2,0,10,0.8
Daniel,Teymur,65,145,69,7,3,0,10,0.7
Motonobu,Tezuka,67,135,66,19,6,4,29,0.724137931
Brandon,Thatch,74,170,74,11,5,0,16,0.6875
Elias,Theodorou,73,185,75,17,3,0,20,0.85
Paulo,Thiago,71,170,73,15,8,0,23,0.652173913
Nick,Thompson,73,170,74,38,14,1,53,0.726415094
Oli,Thompson,73,242,75,9,4,0,13,0.692307692
Stephen,Thompson,72,170,75,14,4,1,19,0.763157895
Josh,Thomson,70,155,71,21,8,0,29,0.724137931
Simeon,Thoresen,73,170,79,17,4,1,22,0.795454545
Gleison,Tibau,70,155,71,40,14,0,54,0.740740741
Nolan,Ticman,66,125,69,4,3,0,7,0.571428571
Darren,Till,72,170,74,17,2,1,20,0.875
Andrew,Todhunter,72,185,72,8,0,0,8,1
Dusko,Todorovic,73,185,74,8,0,0,8,1
Kazuki,Tokudome,71,155,73,12,6,1,19,0.657894737
Tyler,Toner,68,145,70,12,3,0,15,0.8
Miguel,Torres,69,135,76,39,5,0,44,0.886363636
Tecia,Torres,61,115,60,10,5,0,15,0.666666667
Alex,Torres,70,145,70,2,2,0,4,0.5
Jose,Torres,64,125,65,8,1,0,9,0.888888889
Desmond,Torres,66,135,69,7,1,0,8,0.875
Salim,Touahri,70,170,72,10,4,0,14,0.714285714
Dequan,Townsend,75,205,79,21,9,0,30,0.7
Francisco,Trevino,69,155,70,12,2,0,14,0.857142857
Frank,Trigg,69,170,71,21,9,0,30,0.7
Francisco,Trinaldo,69,155,70,23,7,0,30,0.766666667
Michael,Trizano,71,155,71,9,1,0,10,0.9
Antonio,Trocoli,77,205,82,11,3,0,14,0.785714286
Tor,Troeng,74,185,77,16,7,1,24,0.6875
Abel,Trujillo,68,155,70,15,8,0,23,0.652173913
Arman,Tsarukyan,67,155,72,14,2,0,16,0.875
Chris,Tuchscherer,74,258,76,21,4,0,25,0.84
Jon,Tuck,71,155,73,10,5,0,15,0.666666667
Gavin,Tucker,66,145,66,11,1,0,12,0.916666667
Jumabieke,Tuerxun,67,135,67,17,3,1,21,0.833333333
Tai,Tuivasa,74,264,75,10,3,0,13,0.769230769
Zubaira,Tukhugov,68,145,68,18,4,1,23,0.804347826
Albert,Tumenov,71,170,73,17,4,0,21,0.80952381
Ricky,Turcios,69,135,71,8,1,0,9,0.888888889
Wellington,Turman,72,185,72,15,3,0,18,0.833333333
Jalin,Turner,75,155,77,8,5,0,13,0.615384615
Austin,Tweedy,69,155,68,10,1,0,11,0.909090909
Marcin,Tybura,75,249,78,17,6,0,23,0.739130435
Alberto,Uda,75,185,77,9,2,0,11,0.818181818
Gasan,Umalatov,71,170,71,15,5,1,21,0.738095238
Caol,Uno,67,155,70,26,15,5,46,0.619565217
Hector,Urbina,71,170,73,25,10,1,36,0.708333333
Elias,Urbina,75,185,77,3,1,0,4,0.75
Nick,Urso,66,125,66,10,3,0,13,0.769230769
Kamaru,Usman,72,170,76,15,1,0,16,0.9375
Darren,Uyenoyama,66,125,64,8,5,0,13,0.615384615
Richie,Vaculik,66,125,69,10,5,0,15,0.666666667
Charlie,Valencia,63,135,64,12,7,0,19,0.631578947
Isaac,Vallie-Flagg,68,155,68,14,6,1,21,0.69047619
Matt,Van Buren,77,205,76,7,4,0,11,0.636363636
Brianna,Van Buren,60,115,62,9,2,0,11,0.818181818
Austin,Vanderford,71,170,74,4,0,0,4,1
Lando,Vannata,69,155,71,10,4,2,16,0.6875
Paige,VanZant,64,115,65,8,4,0,12,0.666666667
Kazula,Vargas,68,155,71,10,3,0,13,0.769230769
Jamie,Varner,68,155,72,21,11,1,33,0.651515152
Guilherme,Vasconcelos,72,185,74,3,2,0,5,0.6
Javier,Vazquez,67,145,69,16,5,0,21,0.761904762
Manny,Vazquez,70,125,72,11,2,0,13,0.846153846
Cain,Velasquez,73,240,77,14,3,0,17,0.823529412
Bojan,Velickovic,72,170,76,15,6,1,22,0.704545455
Karlos,Vemola,72,185,75,10,4,0,14,0.714285714
Brandon,Vera,75,230,76,12,7,0,19,0.631578947
Marlon,Vera,68,135,70,15,5,1,21,0.738095238
Marvin,Vettori,72,185,74,14,4,1,19,0.763157895
Hugo,Viana,66,135,67,8,4,0,12,0.666666667
Polyana,Viana,65,115,67,10,4,0,14,0.714285714
James,Vick,75,155,76,13,5,0,18,0.722222222
Milton,Vieira,72,145,72,13,8,2,23,0.608695652
Reginaldo,Vieira,67,135,65,14,5,0,19,0.736842105
Ketlen,Vieira,68,135,68,10,0,0,10,1
Rodolfo,Vieira,72,185,73,6,0,0,6,1
Gian,Villante,75,205,76,17,11,0,28,0.607142857
Armando,Villarreal,67,135,66,5,1,0,6,0.833333333
Yuri,Villefort,72,170,73,6,3,0,9,0.666666667
Marcos,Vinicius,69,125,70,20,6,1,27,0.759259259
Brandon,Visher,66,135,68,13,3,0,16,0.8125
Bobby,Voelker,72,170,75,24,12,0,36,0.666666667
Alexander,Volkanovski,66,145,71,20,1,0,21,0.952380952
Jacob,Volkmann,69,155,71,15,4,0,19,0.789473684
Alexander,Volkov,79,250,80,30,7,0,37,0.810810811
Chris,Wade,70,155,70,12,3,0,15,0.8
TJ,Waldburger,71,170,75,16,9,0,25,0.64
Chase,Waldon,73,185,75,11,2,0,13,0.846153846
Johnny,Walker,77,205,82,17,3,0,20,0.85
Ben,Wall,70,155,73,7,2,1,10,0.75
Rodney,Wallace,69,205,72,11,4,1,16,0.71875
Randall,Wallace,71,185,73,15,6,0,21,0.714285714
James,Wallace,70,155,69,9,2,0,11,0.818181818
Jimmy,Wallhead,70,170,73,29,11,0,40,0.725
Richard,Walsh,72,170,73,9,6,0,15,0.6
Patrick,Walsh,71,185,71,5,3,0,8,0.625
Sai,Wang,72,170,72,8,5,1,14,0.607142857
Curt,Warburton,72,155,73,7,3,0,10,0.7
Charlie,Ward,71,170,73,3,3,0,6,0.5
Terrion,Ware,68,135,71,17,9,0,26,0.653846154
Dominic,Waters,73,170,79,9,5,0,14,0.642857143
Michelle,Waterson,63,115,62,17,7,0,24,0.708333333
Walel,Watson,71,135,69,9,5,0,14,0.642857143
Tom,Watson,73,185,73,17,9,0,26,0.653846154
Brok,Weaver,72,170,73,14,4,0,18,0.777777778
Jonavin,Webb,70,170,71,8,2,0,10,0.8
Emil,Meek,71,170,74,9,4,1,14,0.678571429
Royston,Wee,67,135,67,4,1,0,5,0.8
Chris,Weidman,74,205,78,14,5,0,19,0.736842105
Christian,Wellisch,74,234,77,8,5,0,13,0.615384615
Fabricio,Werdum,76,231,77,23,8,1,32,0.734375
Sheldon,Westcott,73,170,71,10,3,1,14,0.75
Coty,Wheeler,66,135,67,14,4,0,18,0.777777778
Alex,White,72,155,71,13,5,0,18,0.722222222
Craig,White,74,170,76,14,9,0,23,0.608695652
Rob,Whiteford,69,145,69,12,4,0,16,0.75
Garett,Whiteley,72,155,72,8,3,0,11,0.727272727
Emily,Whitmire,65,115,63,4,3,0,7,0.571428571
Robert,Whittaker,72,185,73,21,5,0,26,0.807692308
Adam,Wieczorek,77,250,81,10,2,0,12,0.833333333
Mike,Wilkinson,67,145,68,9,2,0,11,0.818181818
Rob,Wilkinson,75,185,80,11,2,0,13,0.846153846
James,Wilks,73,170,75,7,4,0,11,0.636363636
Patrick,Williams,68,135,73,8,6,0,14,0.571428571
Tim,Williams,74,185,76,15,5,0,20,0.75
Jordan,Williams,72,185,76,8,2,0,10,0.8
Cole,Williams,72,170,73,11,2,0,13,0.846153846
Justin,Willis,73,264,78,8,2,0,10,0.8
Chris,Wilson,73,170,75,16,8,0,24,0.666666667
Jonathan,Wilson,74,205,75,7,3,0,10,0.7
Matt,Wiman,70,155,68,16,8,0,24,0.666666667
Eddie,Wineland,67,135,69,24,13,1,38,0.644736842
Deron,Winn,66,185,70,6,1,0,7,0.857142857
Andre,Winner,71,155,73,13,6,1,20,0.675
Keith,Wisniewski,72,170,75,28,13,1,42,0.678571429
Nathaniel,Wood,66,135,69,16,3,0,19,0.842105263
Tyron,Woodley,69,170,74,19,4,1,24,0.8125
Sean,Woodson,74,145,78,7,0,0,7,1
Khama,Worthy,71,155,74,15,6,0,21,0.714285714
Jordan,Wright,74,185,77,9,0,0,9,1
Yanan,Wu,68,125,66,10,3,0,13,0.769230769
Song,Yadong,68,135,67,15,4,0,19,0.789473684
Rani,Yahya,66,135,67,26,10,0,36,0.722222222
Alexander,Yakovlev,75,155,74,24,8,1,33,0.742424242
Norifumi,Yamamoto,64,135,66,18,6,0,24,0.75
Xiaonan,Yan,65,115,63,11,1,0,12,0.916666667
Petr,Yan,67,135,67,13,1,0,14,0.928571429
Adam,Yandiev,69,185,74,9,1,0,10,0.9
Dongi,Yang,70,185,71,13,3,0,16,0.8125
Jianping,Yang,67,145,65,7,4,1,12,0.625
Hu,Yaozong,75,205,72,3,2,0,5,0.6
Luke,Zachrich,74,185,74,14,4,0,18,0.777777778
Anton,Zafir,71,170,72,7,3,0,10,0.7
Aiemann,Zahabi,68,135,68,7,2,0,9,0.777777778
Elizeu,Zaleski dos Santos,71,170,73,21,6,0,27,0.777777778
Zach,Zane,67,145,69,12,7,0,19,0.631578947
Roger,Zapata,71,170,74,4,3,0,7,0.571428571
David,Zawada,72,170,75,16,5,0,21,0.761904762
Joao,Zeferino,71,170,73,13,6,0,19,0.684210526
Tiequan,Zhang,68,155,70,18,4,0,22,0.818181818
Zhang,Lipeng,71,155,71,9,9,1,19,0.5
Weili,Zhang,64,115,63,20,1,0,21,0.952380952
Yao,Zhikui,65,125,64,2,5,0,7,0.285714286
Fares,Ziam,73,155,75,10,3,0,13,0.769230769
Cat,Zingano,66,145,68,10,4,0,14,0.714285714
